,id_distribuidor,fecha_consulta,folio,saldo_vencido_total,pagos_vencidos,creditos_totales,creditos_con_claves_prevencion,creditos_completados_con_atraso,creditos_completados_sin_atraso
0,154610.0,2023-06-07 17:25:26,1166269370,37981,72,10,5,3,7
4,154767.0,2023-06-07 21:38:05,1166502669,9573,36,2,2,2,0
6,154772.0,2023-06-07 22:41:56,1166549975,2253,73,37,23,5,32
7,154771.0,2023-06-07 22:52:35,1166557426,0,5,39,27,0,39
8,122546.0,2023-06-07 23:08:09,1166568805,51870,33,29,22,3,26
10,154792.0,2023-06-08 14:53:23,1166872944,16269,55,21,14,2,19
18,154806.0,2023-06-08 15:38:51,1166897001,9967,13,5,2,3,2
19,154810.0,2023-06-08 16:30:37,1166932901,32742,85,95,57,7,88
20,154811.0,2023-06-08 16:54:51,1166950138,0,0,3,2,0,3
27,154827.0,2023-06-08 18:27:18,1167022271,9384,24,42,1,1,41
29,154840.0,2023-06-08 19:45:33,1167083233,2002,2,16,5,1,15
30,154844.0,2023-06-08 20:45:28,1167128091,620,1,2,1,1,1
31,154845.0,2023-06-08 20:50:56,1167132165,189302,170,74,39,10,64
37,154859.0,2023-06-08 22:25:09,1167242975,0,0,35,0,0,35
43,154876.0,2023-06-09 15:01:07,1167568067,1720,10,5,2,2,3
44,154878.0,2023-06-09 15:07:55,1167571353,1413,44,8,4,3,5
45,154879.0,2023-06-09 15:15:17,1167575322,0,1,34,25,0,34
47,154892.0,2023-06-09 16:02:48,1167605043,0,0,32,0,0,32
48,154896.0,2023-06-09 16:32:22,1167625524,4340,190,28,20,1,27
49,154897.0,2023-06-09 16:50:59,1167638874,1127,351,40,17,6,34
50,154899.0,2023-06-09 17:39:35,1167675984,0,11,23,21,0,23
51,154900.0,2023-06-09 17:40:55,1167676992,0,44,27,19,0,27
52,154902.0,2023-06-09 17:41:59,1167677843,21024,32,43,36,1,42
53,154905.0,2023-06-09 17:43:08,1167678727,0,5,33,29,0,33
54,154906.0,2023-06-09 17:44:58,1167680183,4529,27,57,44,4,53
55,154927.0,2023-06-09 18:33:45,1167719533,5427,11,1,0,1,0
57,154932.0,2023-06-09 19:00:56,1167742774,3978,13,10,8,1,9
60,24321.0,2023-06-12 18:57:16,1169268233,5430,6,4,2,1,3
67,123173.0,2023-06-12 21:08:19,1169362431,45454,36,8,4,2,6
68,123158.0,2023-06-12 21:11:10,1169364410,202224,129,52,33,8,44
72,155094.0,2023-06-12 21:44:31,1169387646,54765,195,70,19,11,59
77,155114.0,2023-06-12 23:17:02,1169448198,4915,9,8,5,1,7
87,155387.0,2023-06-15 19:11:17,1171479277,87967,73,7,4,3,4
88,155388.0,2023-06-15 19:12:14,1171480023,96682,123,16,12,6,10
89,155389.0,2023-06-15 19:13:05,1171480703,2833,57,33,6,2,31
90,155390.0,2023-06-15 19:13:46,1171481243,5589,31,32,25,3,29
91,155394.0,2023-06-15 19:14:18,1171481663,51046,64,45,25,5,40
92,155395.0,2023-06-15 19:16:11,1171483221,51941,118,12,6,7,5
93,155398.0,2023-06-15 19:19:25,1171485948,47678,83,14,4,9,5
94,155399.0,2023-06-15 19:23:00,1171488665,9177,10,9,6,2,7
96,155403.0,2023-06-15 19:45:26,1171506034,20855,99,4,0,1,3
97,155404.0,2023-06-15 19:47:00,1171507065,6835,28,9,4,3,6
98,155407.0,2023-06-15 19:58:06,1171515493,0,0,1,0,0,1
99,155409.0,2023-06-15 20:06:50,1171521966,8363,52,14,4,3,11
100,155410.0,2023-06-15 20:08:00,1171522849,68980,133,19,8,6,13
101,155408.0,2023-06-15 20:20:28,1171532149,36395,25,22,20,2,20
105,155415.0,2023-06-15 20:32:30,1171540967,0,0,36,2,0,36
113,155433.0,2023-06-15 22:25:46,1171621419,2842,14,8,6,1,7
115,155452.0,2023-06-16 14:46:31,1172207263,0,8,7,1,0,7
119,75457.0,2023-06-16 15:49:43,1172263207,112432,99,142,94,8,134
121,116.0,2023-06-16 16:19:05,1172294613,5250,20,107,20,1,106
125,133918.0,2023-06-16 17:06:55,1172349382,0,109,22,3,0,22
129,143637.0,2023-06-16 17:17:52,1172361744,19101,277,78,35,23,55
130,143838.0,2023-06-16 17:20:09,1172364937,19558,13,26,9,2,24
131,143639.0,2023-06-16 17:20:58,1172366519,0,156,41,10,0,41
132,143638.0,2023-06-16 17:21:14,1172367057,609,96,48,13,1,47
136,155487.0,2023-06-16 17:40:18,1172402717,2162,4,10,9,1,9
137,155488.0,2023-06-16 17:53:17,1172426740,5493,24,6,4,1,5
138,120188.0,2023-06-16 17:57:35,1172434918,134470,233,35,15,8,27
141,155539.0,2023-06-16 22:23:11,1172874582,30813,110,41,15,9,32
142,111622.0,2023-06-16 22:46:58,1172922916,112734,67,81,58,5,76
145,155484.0,2023-06-16 22:47:57,1172925088,6552,35,38,17,2,36
148,155495.0,2023-06-16 22:49:03,1172927302,26007,118,87,34,8,79
149,155504.0,2023-06-16 22:49:13,1172927671,140834,238,120,43,12,108
151,155513.0,2023-06-16 22:49:37,1172928571,20382,67,76,31,5,71
154,155519.0,2023-06-16 22:50:05,1172929519,70854,71,58,20,4,54
155,111617.0,2023-06-16 22:51:40,1172932821,8677,15,55,48,2,53
164,101349.0,2023-06-16 23:14:23,1172972910,47123,56,31,19,4,27
176,125069.0,2023-06-16 23:17:27,1172979403,9231,85,29,13,6,23
181,155555.0,2023-06-17 15:13:56,1173758049,34354,148,54,19,11,43
183,155558.0,2023-06-17 16:45:12,1173828188,172410,118,61,47,9,52
201,155569.0,2023-06-17 17:48:48,1173883638,101973,530,93,42,9,84
205,59982.0,2023-06-19 15:18:10,1174969554,23962,179,13,5,3,10
208,155603.0,2023-06-19 15:48:09,1174988052,0,0,6,2,0,6
210,105814.0,2023-06-19 15:53:45,1174991464,62857,173,61,53,7,54
211,155607.0,2023-06-19 15:54:46,1174992097,6823,72,30,17,3,27
214,105401.0,2023-06-19 16:40:40,1175024854,2027,22,111,74,1,110
215,120973.0,2023-06-19 16:41:13,1175025325,16846,305,33,12,4,29
216,120893.0,2023-06-19 16:41:36,1175025641,40507,22,48,21,1,47
218,132704.0,2023-06-19 16:41:52,1175025846,11440,63,19,10,3,16
220,145067.0,2023-06-19 16:42:13,1175026169,7705,129,7,5,2,5
221,145099.0,2023-06-19 16:42:28,1175026375,0,0,12,11,0,12
223,155615.0,2023-06-19 16:49:13,1175031532,13880,11,11,4,5,6
225,154960.0,2023-06-19 17:12:16,1175049339,85212,81,57,25,4,53
227,155619.0,2023-06-19 17:31:27,1175063847,35604,149,76,59,6,70
232,155621.0,2023-06-19 17:47:42,1175075913,3541,277,92,62,5,87
234,155641.0,2023-06-19 19:21:05,1175147588,2730,8,8,6,1,7
239,155646.0,2023-06-19 19:32:13,1175156251,16522,92,5,3,3,2
245,135020.0,2023-06-19 20:20:11,1175192371,0,1,17,11,0,17
246,135039.0,2023-06-19 20:21:06,1175193026,17912,85,107,57,3,104
247,155668.0,2023-06-19 20:39:15,1175206597,5929,14,11,5,3,8
250,114566.0,2023-06-19 22:23:09,1175280956,30511,173,62,18,12,50
252,114564.0,2023-06-19 22:23:40,1175281350,0,3,51,7,0,51
253,114568.0,2023-06-19 22:24:00,1175281635,873,252,28,7,3,25
255,115084.0,2023-06-19 22:24:27,1175281957,2354,58,22,9,5,17
256,136857.0,2023-06-19 22:24:49,1175282162,2652,13,18,11,1,17
257,146052.0,2023-06-19 22:25:07,1175282398,18122,26,16,8,3,13
258,146323.0,2023-06-19 22:25:24,1175282641,25068,32,16,3,2,14
259,122987.0,2023-06-19 23:51:15,1175341078,74511,150,85,11,9,76
271,134575.0,2023-06-19 23:54:32,1175343507,19250,115,45,17,5,40
276,122909.0,2023-06-19 23:55:17,1175344011,19693,54,28,3,6,22
289,74111.0,2023-06-20 14:46:33,1175761337,20450,56,99,46,2,97
291,155763.0,2023-06-20 17:00:14,1175845693,34701,28,28,10,1,27
292,155762.0,2023-06-20 17:03:05,1175847695,84862,15,15,12,2,13
295,155783.0,2023-06-20 19:22:30,1175977789,25804,159,61,24,2,59
298,155767.0,2023-06-20 19:27:24,1175984426,48050,34,25,9,4,21
299,155779.0,2023-06-20 19:28:27,1175985827,127401,277,97,52,16,81
300,155780.0,2023-06-20 19:30:19,1175988400,116753,61,67,26,3,64
301,123364.0,2023-06-20 20:52:17,1176102507,1556,1,4,3,1,3
307,155805.0,2023-06-20 21:56:21,1176160641,100731,163,61,21,10,51
309,155755.0,2023-06-21 14:46:58,1176529550,34701,3,6,3,1,5
314,114445.0,2023-06-21 18:35:07,1176693211,6654,32,33,16,2,31
315,125015.0,2023-06-21 18:35:52,1176693776,21872,10,9,4,1,8
316,114442.0,2023-06-21 18:36:19,1176694130,3075,34,12,3,1,11
317,145846.0,2023-06-21 18:37:09,1176694786,3987,25,12,8,2,10
318,145842.0,2023-06-21 18:37:38,1176695121,0,0,11,9,0,11
319,114443.0,2023-06-21 18:38:11,1176695588,8677,12,9,4,1,8
320,145845.0,2023-06-21 18:38:43,1176695973,8968,156,10,3,2,8
328,147270.0,2023-06-21 19:41:32,1176742544,3064,28,14,7,1,13
331,155889.0,2023-06-21 20:35:23,1176779274,20360,421,73,15,6,67
333,155867.0,2023-06-21 20:39:32,1176782187,0,12,6,4,0,6
336,147095.0,2023-06-21 21:47:34,1176832818,19881,35,19,13,4,15
337,145181.0,2023-06-21 22:29:40,1176864233,1478,16,18,12,2,16
342,121665.0,2023-06-21 23:08:43,1176890293,33819,106,74,54,2,72
343,145177.0,2023-06-21 23:09:22,1176890726,6837,5,28,10,1,27
344,145176.0,2023-06-21 23:10:00,1176891149,50712,109,24,16,4,20
345,121663.0,2023-06-21 23:10:38,1176891521,31306,118,89,67,7,82
346,145647.0,2023-06-21 23:11:11,1176891880,4790,11,21,12,2,19
347,145179.0,2023-06-21 23:11:32,1176892104,0,0,5,3,0,5
349,75542.0,2023-06-22 14:33:07,1177101537,13054,99,62,4,2,60
352,155925.0,2023-06-22 15:00:30,1177111240,0,0,19,8,0,19
353,98597.0,2023-06-22 15:11:12,1177115923,0,2,6,0,0,6
354,122863.0,2023-06-22 15:48:01,1177141455,14516,232,21,8,4,17
355,85209.0,2023-06-22 15:54:54,1177148919,33254,27,10,1,3,7
358,33382.0,2023-06-22 16:14:00,1177172043,48116,118,131,63,7,124
361,155959.0,2023-06-22 16:43:36,1177208099,32840,181,47,31,8,39
366,155966.0,2023-06-22 17:18:37,1177250893,71195,185,79,49,9,70
367,155968.0,2023-06-22 17:53:02,1177292824,38971,76,22,10,5,17
372,155983.0,2023-06-22 18:42:57,1177351496,57505,100,57,28,6,51
374,155985.0,2023-06-22 18:57:48,1177370032,72450,115,30,15,7,23
406,143960.0,2023-06-22 22:27:38,1177569638,76074,99,31,12,7,24
409,156030.0,2023-06-22 22:45:02,1177588489,53575,111,62,42,5,57
418,156047.0,2023-06-23 15:01:19,1177911542,0,5,8,6,0,8
419,156050.0,2023-06-23 15:02:55,1177912113,35692,170,84,41,7,77
422,156053.0,2023-06-23 15:20:40,1177919944,6061,16,10,4,3,7
425,156038.0,2023-06-23 16:05:14,1177942817,0,23,16,12,0,16
426,156049.0,2023-06-23 16:06:13,1177943309,13957,119,24,16,3,21
427,156067.0,2023-06-23 16:29:01,1177956608,0,0,8,4,0,8
429,156048.0,2023-06-23 16:46:13,1177967385,25968,69,24,17,3,21
431,143347.0,2023-06-23 17:10:01,1177983496,6341,38,43,25,2,41
433,142683.0,2023-06-23 17:10:49,1177984036,14713,124,15,8,4,11
434,140991.0,2023-06-23 17:11:08,1177984232,7537,46,24,18,2,22
435,144021.0,2023-06-23 17:32:42,1177998812,186992,52,27,20,4,23
436,144098.0,2023-06-23 17:33:03,1177999064,35574,61,14,6,3,11
437,123021.0,2023-06-23 17:54:08,1178013517,0,0,13,7,0,13
440,123028.0,2023-06-23 17:58:51,1178016732,18365,39,24,12,1,23
443,156092.0,2023-06-23 19:11:59,1178065767,82466,151,104,36,7,97
447,156108.0,2023-06-23 21:23:26,1178146862,15083,55,25,7,2,23
449,156114.0,2023-06-23 22:16:06,1178243096,5931,27,3,1,2,1
458,156111.0,2023-06-23 22:26:43,1178259483,127932,228,44,32,8,36
459,151817.0,2023-06-23 22:28:43,1178262607,6024,225,15,4,3,12
465,156145.0,2023-06-24 16:05:37,1179831379,7754,34,9,3,1,8
466,123164.0,2023-06-24 16:05:51,1179831470,5644,48,191,25,2,189
469,156128.0,2023-06-24 16:13:56,1179834568,9933,8,18,8,2,16
470,156129.0,2023-06-24 16:19:17,1179836679,18263,20,55,12,4,51
472,156130.0,2023-06-24 16:22:44,1179838048,22340,263,22,11,6,16
473,156147.0,2023-06-24 16:23:48,1179838494,12245,12,10,7,3,7
474,156138.0,2023-06-24 16:24:59,1179839004,40351,44,30,19,6,24
476,156140.0,2023-06-24 16:31:16,1179841652,5176,13,7,2,2,5
478,156149.0,2023-06-24 17:49:18,1179880011,17770,40,23,16,1,22
479,156152.0,2023-06-24 17:50:51,1179880780,11377,77,16,12,3,13
480,156156.0,2023-06-24 17:52:17,1179881490,19885,232,19,11,3,16
481,154946.0,2023-06-24 18:17:26,1179894778,18597,28,19,12,2,17
490,156151.0,2023-06-24 18:54:12,1179914132,3960,15,3,3,2,1
491,156159.0,2023-06-24 18:56:05,1179915111,235364,124,38,20,12,26
492,156160.0,2023-06-24 19:01:04,1179917865,72593,36,18,15,4,14
493,156161.0,2023-06-24 19:07:21,1179921418,72130,13,28,4,4,24
494,156117.0,2023-06-24 19:18:47,1179927522,0,1,7,5,0,7
495,146231.0,2023-06-26 14:53:03,1180535673,12215,26,15,10,1,14
497,146273.0,2023-06-26 14:53:30,1180535863,27698,195,34,24,7,27
498,146386.0,2023-06-26 14:54:16,1180536241,21868,33,43,31,2,41
499,146384.0,2023-06-26 14:54:52,1180536487,6417,25,7,2,1,6
502,146677.0,2023-06-26 14:55:59,1180536903,14767,254,144,90,4,140
504,146675.0,2023-06-26 14:56:33,1180537092,4570,129,88,59,1,87
505,156202.0,2023-06-26 14:58:39,1180537919,39353,57,63,38,4,59
508,156205.0,2023-06-26 15:42:41,1180559256,2169,20,5,0,2,3
512,133088.0,2023-06-26 15:49:26,1180562919,2559,22,24,18,3,21
513,134559.0,2023-06-26 15:49:55,1180563157,13708,116,7,4,4,3
514,134558.0,2023-06-26 15:51:05,1180563823,41254,27,29,20,2,27
516,133897.0,2023-06-26 15:51:26,1180564032,582,5,3,0,1,2
517,144578.0,2023-06-26 15:53:40,1180565161,3101,77,84,33,3,81
518,156207.0,2023-06-26 16:09:46,1180574489,25861,65,29,24,4,25
520,133086.0,2023-06-26 16:17:30,1180579589,11263,54,55,32,5,50
523,133085.0,2023-06-26 16:17:56,1180579859,7195,43,37,25,2,35
530,156210.0,2023-06-26 16:53:08,1180603769,94504,249,42,26,6,36
533,156213.0,2023-06-26 16:54:09,1180604520,697,24,30,24,2,28
534,156216.0,2023-06-26 16:55:17,1180605259,116926,268,65,49,8,57
535,156219.0,2023-06-26 16:56:33,1180606100,2312,163,21,7,2,19
537,156222.0,2023-06-26 17:00:15,1180608609,28741,189,24,11,9,15
538,123029.0,2023-06-26 17:00:47,1180609007,4419,35,24,17,2,22
547,136251.0,2023-06-26 17:54:29,1180650621,26908,50,86,64,2,84
548,136427.0,2023-06-26 17:56:23,1180652040,14154,61,39,25,3,36
550,156247.0,2023-06-26 18:06:11,1180659702,167560,284,107,35,14,93
552,135968.0,2023-06-26 18:07:53,1180661112,3253,21,22,15,1,21
553,146551.0,2023-06-26 18:09:04,1180662126,28495,59,19,15,3,16
555,146400.0,2023-06-26 18:09:34,1180662545,1853,9,15,10,1,14
557,145850.0,2023-06-26 19:04:10,1180705423,17895,34,19,8,4,15
558,145701.0,2023-06-26 19:06:34,1180707300,11012,18,11,3,3,8
559,145708.0,2023-06-26 19:07:01,1180707618,11875,52,12,4,4,8
560,140340.0,2023-06-26 19:07:32,1180707999,10058,92,19,7,4,15
561,146747.0,2023-06-26 19:08:24,1180708685,6467,40,64,19,1,63
562,146210.0,2023-06-26 19:08:56,1180709067,13789,9,6,5,3,3
563,146845.0,2023-06-26 19:27:49,1180723757,17316,58,15,4,5,10
565,145944.0,2023-06-26 19:28:18,1180724143,12176,17,30,11,2,28
566,145922.0,2023-06-26 19:28:54,1180724576,2904,8,13,7,1,12
568,146051.0,2023-06-26 19:33:14,1180727832,0,0,1,0,0,1
569,145933.0,2023-06-26 19:34:56,1180729076,50212,47,37,22,6,31
571,156260.0,2023-06-26 19:50:49,1180740908,0,0,5,1,0,5
573,146390.0,2023-06-26 21:17:55,1180804189,0,0,1,0,0,1
575,95715.0,2023-06-26 22:16:26,1180845066,33644,39,48,23,1,47
576,95711.0,2023-06-26 22:32:46,1180865955,3000,248,79,34,1,78
577,95714.0,2023-06-26 22:34:08,1180867705,87751,50,45,22,2,43
579,156284.0,2023-06-26 22:54:06,1180895784,20514,183,93,60,4,89
582,156285.0,2023-06-26 23:14:17,1180911871,5038,17,63,44,4,59
583,72316.0,2023-06-27 14:32:41,1181134162,2376,14,77,33,1,76
596,156313.0,2023-06-27 15:36:04,1181161345,0,219,14,1,0,14
603,144318.0,2023-06-27 17:37:18,1181250877,16934,20,7,5,1,6
606,121900.0,2023-06-27 17:38:55,1181252164,0,4,69,37,0,69
607,121898.0,2023-06-27 17:44:30,1181259157,152211,192,104,59,5,99
608,122171.0,2023-06-27 17:45:04,1181260080,5348,63,40,16,2,38
609,121896.0,2023-06-27 17:46:27,1181262192,20857,19,113,68,2,111
614,156357.0,2023-06-27 18:22:15,1181316316,19329,15,15,5,2,13
617,95704.0,2023-06-27 18:34:14,1181332001,3895,52,54,19,2,52
618,156364.0,2023-06-27 18:45:56,1181346950,37961,107,20,13,2,18
622,95719.0,2023-06-27 19:14:47,1181383177,2723,49,39,26,1,38
627,156387.0,2023-06-27 19:36:08,1181408866,3851,24,2,0,1,1
639,156365.0,2023-06-27 20:08:00,1181438772,3426,19,31,16,1,30
640,156366.0,2023-06-27 20:10:48,1181440919,28940,57,42,13,3,39
650,145969.0,2023-06-27 20:39:04,1181463803,70709,163,119,65,8,111
653,123190.0,2023-06-27 21:46:47,1181521373,419,37,63,39,1,62
654,123186.0,2023-06-27 21:47:15,1181521821,1409,6,29,14,1,28
655,123193.0,2023-06-27 21:47:39,1181522138,14717,39,76,40,2,74
656,134553.0,2023-06-27 21:49:39,1181523792,16679,47,29,10,3,26
657,134695.0,2023-06-27 21:49:50,1181523980,20474,91,72,56,4,68
662,156418.0,2023-06-27 22:23:23,1181552589,39583,161,28,19,6,22
663,156419.0,2023-06-27 22:24:39,1181553676,15631,166,34,13,4,30
666,156422.0,2023-06-27 22:27:35,1181556182,7429,94,25,11,4,21
672,156439.0,2023-06-27 23:19:34,1181606092,3161,183,26,6,3,23
675,156330.0,2023-06-27 23:24:17,1181612590,50355,242,82,28,7,75
677,156332.0,2023-06-27 23:25:06,1181613799,13948,57,25,15,3,22
679,147339.0,2023-06-28 14:50:37,1181946611,22430,69,14,12,2,12
680,156462.0,2023-06-28 14:53:46,1181948432,35327,136,21,11,7,14
681,129690.0,2023-06-28 14:54:09,1181948638,22430,53,41,19,1,40
683,129697.0,2023-06-28 14:58:02,1181950762,19246,160,44,11,3,41
684,129893.0,2023-06-28 15:05:38,1181955038,7388,8,37,16,1,36
686,134932.0,2023-06-28 15:11:52,1181958880,16730,75,19,7,1,18
687,129862.0,2023-06-28 15:16:03,1181961625,6307,51,31,13,2,29
688,123540.0,2023-06-28 15:20:18,1181964496,0,14,116,65,0,116
689,109634.0,2023-06-28 16:14:18,1182005439,2829,23,11,4,2,9
709,122811.0,2023-06-28 19:13:12,1182170512,6754,85,31,23,2,29
723,156603.0,2023-06-28 23:00:14,1182366217,0,0,3,0,0,3
746,146261.0,2023-06-29 14:06:47,1182714508,4021,200,268,15,5,263
748,146260.0,2023-06-29 14:09:12,1182715209,0,0,24,12,0,24
749,145768.0,2023-06-29 14:09:55,1182715395,5969,71,59,47,4,55
750,146263.0,2023-06-29 14:10:39,1182715627,3626,25,11,6,2,9
752,146401.0,2023-06-29 14:12:53,1182716259,10125,104,58,28,7,51
760,146956.0,2023-06-29 15:52:13,1182765055,8068,24,32,14,2,30
761,146909.0,2023-06-29 15:52:49,1182765521,33577,30,44,24,1,43
762,147032.0,2023-06-29 15:53:24,1182765953,0,0,10,5,0,10
763,146988.0,2023-06-29 15:54:07,1182766447,0,2,6,0,0,6
764,146846.0,2023-06-29 15:55:13,1182767319,9132,119,53,20,3,50
765,146652.0,2023-06-29 15:55:43,1182767719,30842,31,23,20,1,22
773,147563.0,2023-06-29 16:39:48,1182802385,65162,215,83,61,9,74
774,147578.0,2023-06-29 16:41:12,1182803587,38383,46,38,28,3,35
775,156616.0,2023-06-29 16:41:22,1182803718,0,0,8,2,0,8
778,147559.0,2023-06-29 16:42:15,1182804414,23078,200,49,25,4,45
780,136777.0,2023-06-29 16:43:39,1182805496,96619,169,176,82,9,167
782,137528.0,2023-06-29 16:44:15,1182806050,19085,19,16,12,2,14
784,147915.0,2023-06-29 16:45:26,1182807013,22057,18,25,7,2,23
785,156721.0,2023-06-29 16:53:57,1182814133,370449,372,69,20,17,52
790,156731.0,2023-06-29 17:09:01,1182826640,0,33,34,22,0,34
792,156736.0,2023-06-29 17:29:30,1182844973,1141,121,34,15,1,33
793,156737.0,2023-06-29 17:31:03,1182846374,2083,43,5,2,1,4
794,156738.0,2023-06-29 17:32:51,1182847957,17689,136,62,36,5,57
801,64153.0,2023-06-29 17:48:26,1182861291,24073,67,49,33,2,47
803,156745.0,2023-06-29 18:07:24,1182877388,2904,16,2,1,1,1
804,156763.0,2023-06-29 18:20:19,1182889150,55050,70,6,3,2,4
805,156764.0,2023-06-29 18:24:43,1182892865,8113,55,77,47,3,74
820,156802.0,2023-06-29 20:21:00,1182994796,2804,38,60,35,1,59
833,156833.0,2023-06-29 21:27:46,1183050996,14656,65,31,19,4,27
834,156837.0,2023-06-29 21:37:11,1183058859,14466,210,59,39,7,52
836,156850.0,2023-06-29 22:10:13,1183085695,19779,78,64,40,5,59
839,156863.0,2023-06-29 22:31:31,1183102493,4951,26,21,6,3,18
841,156871.0,2023-06-29 22:37:46,1183107465,12684,75,27,15,6,21
842,156872.0,2023-06-29 22:39:59,1183109213,205323,61,60,31,4,56
844,156834.0,2023-06-29 22:53:35,1183119764,59170,63,66,49,5,61
847,156881.0,2023-06-29 23:00:43,1183125554,3875,1,2,0,1,1
849,156882.0,2023-06-29 23:06:48,1183131022,62186,98,21,16,1,20
850,156876.0,2023-06-29 23:22:28,1183142906,93634,266,42,29,8,34
851,156878.0,2023-06-29 23:22:33,1183142964,2462,17,31,16,1,30
853,156884.0,2023-06-29 23:57:38,1183169097,4746,28,11,4,4,7
864,156931.0,2023-06-30 16:07:12,1183575921,63175,248,16,13,6,10
867,128625.0,2023-06-30 17:15:04,1183626610,32274,27,64,46,2,62
868,128618.0,2023-06-30 17:16:02,1183627453,3776,200,16,4,5,11
872,128629.0,2023-06-30 17:18:23,1183629484,2799,9,16,12,1,15
873,128626.0,2023-06-30 17:18:45,1183629797,6604,205,62,17,2,60
875,128628.0,2023-06-30 17:19:32,1183630449,14191,275,62,42,4,58
876,156944.0,2023-06-30 17:26:40,1183636436,0,0,5,3,0,5
882,157013.0,2023-06-30 19:55:43,1183766545,148635,85,51,27,7,44
884,115775.0,2023-06-30 19:58:58,1183769483,99340,120,41,34,5,36
887,95165.0,2023-06-30 20:03:53,1183773709,12978,163,62,30,4,58
889,94886.0,2023-06-30 20:15:50,1183784267,4746,42,45,25,1,44
893,157011.0,2023-06-30 20:44:41,1183809928,36600,16,12,5,1,11
898,2174.0,2023-06-30 22:22:06,1183893152,62943,71,19,12,3,16
901,129030.0,2023-06-30 23:09:56,1183928695,68485,131,74,48,7,67
904,157057.0,2023-06-30 23:19:51,1183936477,25957,118,32,27,5,27
905,157058.0,2023-06-30 23:20:00,1183936577,31984,127,29,22,9,20
910,157110.0,2023-07-01 15:00:37,1184309674,42637,530,76,25,6,70
912,157115.0,2023-07-01 15:25:25,1184322473,32472,161,110,48,7,103
921,157132.0,2023-07-01 18:59:01,1184468149,20563,141,12,5,4,8
926,157171.0,2023-07-03 17:30:48,1185471820,36,22,29,0,1,28
928,157177.0,2023-07-03 18:02:38,1185497858,15026,244,23,5,6,17
933,157176.0,2023-07-03 18:14:03,1185507089,718,20,9,0,2,7
938,157188.0,2023-07-03 19:16:25,1185557936,6460,0,14,3,1,13
948,157205.0,2023-07-03 20:27:11,1185616082,858,12,77,33,1,76
962,104226.0,2023-07-04 17:19:06,1186117075,97691,88,41,6,3,38
963,93680.0,2023-07-04 17:22:51,1186120006,0,10,78,54,0,78
964,157178.0,2023-07-04 17:29:16,1186124885,0,18,33,4,0,33
966,157261.0,2023-07-04 17:30:19,1186125604,0,1,16,12,0,16
974,157270.0,2023-07-04 18:14:12,1186160274,3875,64,7,5,3,4
978,157185.0,2023-07-04 18:26:56,1186170284,57213,31,16,9,4,12
982,157189.0,2023-07-04 18:37:27,1186178344,0,0,1,0,0,1
985,157198.0,2023-07-04 18:39:24,1186179934,29420,140,42,29,2,40
986,157204.0,2023-07-04 18:51:40,1186189638,0,1,46,20,0,46
995,157194.0,2023-07-04 19:29:50,1186220127,6872,39,26,10,2,24
1004,157169.0,2023-07-04 19:58:54,1186242652,0,10,24,20,0,24
1005,157201.0,2023-07-04 20:00:41,1186243964,426241,338,67,31,15,52
1013,45740.0,2023-07-04 21:01:44,1186291904,54723,177,109,27,6,103
1014,157308.0,2023-07-04 21:06:43,1186295765,0,6,30,20,0,30
1015,157285.0,2023-07-04 21:07:22,1186296290,6240,53,28,10,2,26
1017,157310.0,2023-07-04 21:17:36,1186304363,0,1,26,18,0,26
1023,157320.0,2023-07-04 22:07:44,1186342701,86703,125,60,27,8,52
1030,157291.0,2023-07-05 15:18:07,1186680363,884,15,99,6,1,98
1031,157312.0,2023-07-05 15:19:12,1186680987,14110,9,23,1,2,21
1032,157363.0,2023-07-05 16:28:04,1186723003,55560,30,53,45,3,50
1033,157371.0,2023-07-05 16:47:05,1186737170,3074,105,16,6,1,15
1036,157375.0,2023-07-05 17:07:37,1186752298,73014,37,130,59,6,124
1040,157382.0,2023-07-05 17:19:57,1186761743,12627,86,13,6,4,9
1041,157386.0,2023-07-05 17:44:58,1186781250,390968,377,93,35,17,76
1043,157398.0,2023-07-05 17:46:28,1186782478,2024,39,22,7,5,17
1045,157406.0,2023-07-05 18:19:18,1186808182,21943,48,5,3,1,4
1046,157407.0,2023-07-05 18:26:30,1186813821,79148,166,27,17,6,21
1049,157383.0,2023-07-05 18:28:17,1186815213,14409,27,36,10,2,34
1053,157409.0,2023-07-05 18:39:30,1186824207,59488,67,17,10,10,7
1054,157412.0,2023-07-05 18:49:34,1186832523,28927,217,44,23,4,40
1055,157414.0,2023-07-05 18:59:17,1186840480,53652,75,27,15,5,22
1056,157415.0,2023-07-05 19:02:44,1186843416,24444,83,31,20,5,26
1059,104464.0,2023-07-05 19:02:49,1186843493,6326,80,28,18,5,23
1061,147227.0,2023-07-05 19:05:29,1186845737,43523,82,24,18,6,18
1062,147243.0,2023-07-05 19:06:09,1186846262,16466,9,35,21,2,33
1063,147239.0,2023-07-05 19:06:40,1186846691,34272,78,47,28,6,41
1064,147231.0,2023-07-05 19:07:03,1186847040,26342,184,31,14,12,19
1065,147225.0,2023-07-05 19:11:39,1186850933,26258,159,36,16,3,33
1066,147221.0,2023-07-05 19:11:58,1186851181,61572,206,81,30,6,75
1068,147206.0,2023-07-05 19:12:56,1186851951,12624,6,21,14,3,18
1069,157421.0,2023-07-05 19:31:52,1186867660,4483,44,44,31,3,41
1083,157441.0,2023-07-05 21:03:53,1186938519,14711,45,6,1,2,4
1086,157440.0,2023-07-05 21:06:57,1186940716,6693,59,17,8,2,15
1087,157439.0,2023-07-05 21:07:52,1186941377,8471,29,16,11,2,14
1088,142677.0,2023-07-05 22:54:55,1187041858,8628,35,56,32,2,54
1091,143274.0,2023-07-06 15:10:05,1187473287,92354,172,125,65,8,117
1093,143669.0,2023-07-06 15:35:07,1187502687,786,14,16,12,1,15
1096,157483.0,2023-07-06 15:57:50,1187532125,157913,38,17,15,2,15
1098,98105.0,2023-07-06 15:58:44,1187532891,3229,10,11,5,1,10
1099,98124.0,2023-07-06 15:59:57,1187534089,11815,55,58,50,4,54
1100,98131.0,2023-07-06 16:00:52,1187535048,30124,193,24,20,5,19
1102,157404.0,2023-07-06 16:04:32,1187540186,66376,99,20,13,6,14
1112,157487.0,2023-07-06 16:28:24,1187573783,0,4,47,19,0,47
1113,72585.0,2023-07-06 16:34:06,1187580340,154071,267,90,68,13,77
1121,157491.0,2023-07-06 16:45:02,1187592810,0,0,24,9,0,24
1125,113714.0,2023-07-06 17:29:17,1187641702,32626,128,20,3,3,17
1126,113722.0,2023-07-06 17:33:14,1187646090,29937,79,15,2,2,13
1127,113695.0,2023-07-06 17:33:36,1187646458,117823,428,69,15,13,56
1129,113728.0,2023-07-06 17:34:12,1187647196,57355,48,25,8,4,21
1130,130871.0,2023-07-06 17:43:02,1187657846,14337,48,22,16,3,19
1131,157509.0,2023-07-06 17:57:40,1187675157,288142,170,81,33,6,75
1133,157510.0,2023-07-06 18:10:04,1187689652,0,0,9,7,0,9
1135,157520.0,2023-07-06 18:40:55,1187725082,11010,16,18,6,2,16
1136,157522.0,2023-07-06 18:58:22,1187745760,137134,168,40,23,6,34
1137,157523.0,2023-07-06 19:01:21,1187749226,9217,129,43,26,8,35
1138,157525.0,2023-07-06 19:06:43,1187755283,2262,4,18,12,1,17
1139,157524.0,2023-07-06 19:10:40,1187760005,0,0,1,0,0,1
1140,157527.0,2023-07-06 19:10:49,1187760159,978,60,75,53,1,74
1142,157530.0,2023-07-06 19:29:20,1187781467,16265,50,7,1,3,4
1144,157534.0,2023-07-06 19:43:09,1187797519,0,5,21,11,0,21
1146,157537.0,2023-07-06 20:20:01,1187840846,7077,215,41,12,3,38
1147,157538.0,2023-07-06 20:20:25,1187841379,13953,9,11,9,1,10
1148,157541.0,2023-07-06 20:31:07,1187853802,0,0,2,1,0,2
1155,157557.0,2023-07-06 21:38:07,1187928840,2986,73,6,2,2,4
1157,157558.0,2023-07-06 22:03:08,1187956856,8272,25,20,15,2,18
1172,157586.0,2023-07-07 15:01:33,1188466182,94123,58,42,31,3,39
1173,157587.0,2023-07-07 15:10:45,1188470547,0,0,3,0,0,3
1184,146148.0,2023-07-07 15:42:33,1188488892,11502,92,26,17,3,23
1187,157591.0,2023-07-07 15:45:31,1188490702,88585,33,9,3,3,6
1191,145560.0,2023-07-07 16:04:27,1188501754,3324,18,3,2,2,1
1196,157598.0,2023-07-07 16:30:13,1188518334,5812,325,37,19,3,34
1203,157602.0,2023-07-07 17:18:34,1188551231,10348,77,9,6,2,7
1204,157608.0,2023-07-07 17:19:23,1188551795,10171,79,16,3,1,15
1206,157609.0,2023-07-07 17:28:44,1188558734,70113,60,93,48,3,90
1207,157611.0,2023-07-07 17:29:08,1188559030,76847,88,64,28,7,57
1208,157612.0,2023-07-07 17:29:23,1188559185,74346,59,15,7,4,11
1209,157613.0,2023-07-07 17:29:32,1188559278,115826,179,56,37,5,51
1210,114616.0,2023-07-07 17:49:15,1188575878,55229,71,45,23,6,39
1213,114612.0,2023-07-07 17:52:29,1188578333,136498,95,39,24,8,31
1216,127663.0,2023-07-07 17:53:20,1188578976,61882,133,23,14,7,16
1228,114670.0,2023-07-07 22:02:03,1188819617,5837,19,23,13,2,21
1231,93733.0,2023-07-07 22:17:44,1188831986,92424,87,43,27,4,39
1234,95473.0,2023-07-07 22:18:41,1188832725,66410,97,90,46,4,86
1236,95605.0,2023-07-07 22:19:42,1188833561,1549,13,40,6,1,39
1239,95748.0,2023-07-07 22:21:28,1188834958,63576,100,13,1,8,5
1240,147887.0,2023-07-07 22:22:16,1188835601,0,0,1,0,0,1
1242,157656.0,2023-07-07 22:48:09,1188856236,252888,91,56,32,7,49
1244,157658.0,2023-07-07 23:12:24,1188874320,0,0,5,0,0,5
1245,157659.0,2023-07-08 00:51:37,1188933548,11162,98,56,41,2,54
1247,157662.0,2023-07-08 00:52:33,1188934015,5494,58,59,41,2,57
1251,157673.0,2023-07-08 16:03:55,1189123923,52122,353,46,12,5,41
1256,119992.0,2023-07-08 16:43:39,1189142642,18478,101,42,11,4,38
1259,145997.0,2023-07-08 16:44:52,1189143233,3181,242,49,17,3,46
1260,119935.0,2023-07-08 16:45:28,1189143516,39359,149,179,17,5,174
1261,119780.0,2023-07-08 16:45:53,1189143702,1168,310,26,9,5,21
1262,119777.0,2023-07-08 16:46:33,1189144018,226966,140,46,17,9,37
1263,126742.0,2023-07-08 16:46:44,1189144103,20702,67,19,13,3,16
1264,126740.0,2023-07-08 16:47:13,1189144332,53883,109,41,14,3,38
1267,157675.0,2023-07-08 16:54:06,1189147745,7606,155,62,35,5,57
1268,157680.0,2023-07-08 16:55:20,1189148422,55854,127,56,26,6,50
1271,157676.0,2023-07-08 16:56:27,1189149052,33132,98,10,6,4,6
1274,119830.0,2023-07-08 17:02:18,1189152114,19277,434,70,41,6,64
1276,147223.0,2023-07-08 17:07:00,1189154535,3066,39,12,0,5,7
1277,126736.0,2023-07-08 17:07:37,1189154893,48789,23,43,34,1,42
1282,157706.0,2023-07-10 14:52:14,1189952905,0,4,10,8,0,10
1284,157707.0,2023-07-10 14:53:30,1189953383,126957,25,40,29,3,37
1285,157714.0,2023-07-10 15:35:22,1189973352,8127,103,47,12,8,39
1286,157711.0,2023-07-10 15:45:35,1189979380,0,0,7,5,0,7
1288,157718.0,2023-07-10 15:51:18,1189982745,54006,38,18,14,3,15
1289,157717.0,2023-07-10 15:52:25,1189983394,57112,64,36,23,3,33
1291,157719.0,2023-07-10 15:58:30,1189986772,21936,67,67,35,4,63
1292,157681.0,2023-07-10 16:08:57,1189993093,33494,134,50,33,6,44
1293,157661.0,2023-07-10 16:11:49,1189994842,33109,305,70,44,6,64
1294,157728.0,2023-07-10 16:22:04,1190001629,3224,100,159,61,5,154
1296,157745.0,2023-07-10 17:04:07,1190029590,0,1,5,2,0,5
1300,157764.0,2023-07-10 18:45:16,1190112460,322901,290,60,46,14,46
1301,157766.0,2023-07-10 18:45:32,1190112680,12301,57,28,15,3,25
1305,157791.0,2023-07-10 19:40:12,1190162244,0,1,33,9,0,33
1307,157789.0,2023-07-10 19:40:28,1190162450,5188,36,13,0,3,10
1308,157787.0,2023-07-10 19:40:42,1190162645,195317,265,38,9,12,26
1309,157786.0,2023-07-10 19:40:55,1190162842,0,0,3,1,0,3
1310,157785.0,2023-07-10 19:41:11,1190163078,12357,126,60,17,4,56
1313,157790.0,2023-07-10 20:10:04,1190191903,72914,203,99,36,14,85
1315,157794.0,2023-07-10 20:10:17,1190192214,8486,74,20,10,1,19
1316,157795.0,2023-07-10 20:10:27,1190192397,44952,178,88,27,11,77
1318,157803.0,2023-07-10 21:08:26,1190239919,0,5,29,20,0,29
1319,157818.0,2023-07-10 22:04:54,1190283709,0,0,4,1,0,4
1321,107998.0,2023-07-10 22:26:39,1190300237,64077,210,68,39,4,64
1322,108698.0,2023-07-10 22:26:53,1190300407,10398,11,6,4,1,5
1323,147198.0,2023-07-10 22:27:26,1190300839,48906,24,6,2,1,5
1326,90041.0,2023-07-10 22:43:30,1190312459,208576,258,126,70,11,115
1327,122613.0,2023-07-10 22:44:09,1190312913,0,0,3,0,0,3
1329,147515.0,2023-07-11 16:23:07,1190623497,0,0,12,2,0,12
1330,146804.0,2023-07-11 16:28:47,1190627175,5296,8,9,5,1,8
1331,147537.0,2023-07-11 16:32:12,1190629507,1030,3,5,1,1,4
1332,146616.0,2023-07-11 16:36:03,1190632476,0,72,17,10,0,17
1334,157912.0,2023-07-11 18:15:56,1190713661,41592,68,67,41,2,65
1336,157915.0,2023-07-11 18:30:20,1190725031,0,4,11,4,0,11
1337,157926.0,2023-07-11 18:55:46,1190745322,16347,24,2,1,1,1
1348,157928.0,2023-07-11 19:19:44,1190765141,0,0,2,1,0,2
1349,157929.0,2023-07-11 19:20:16,1190765592,0,0,2,1,0,2
1350,157931.0,2023-07-11 19:20:41,1190765913,1167,27,4,2,1,3
1352,157937.0,2023-07-11 19:45:15,1190785775,222540,251,55,22,7,48
1355,157945.0,2023-07-11 19:50:37,1190790242,15687,42,9,1,2,7
1356,157946.0,2023-07-11 19:52:40,1190791895,3668,10,7,5,1,6
1357,157948.0,2023-07-11 20:04:22,1190801042,87169,72,24,8,8,16
1360,157952.0,2023-07-11 20:17:22,1190811033,5701,11,49,40,2,47
1364,115652.0,2023-07-11 20:30:47,1190821024,14440,204,173,94,3,170
1366,147778.0,2023-07-11 20:31:55,1190821897,8504,280,40,11,2,38
1379,147801.0,2023-07-11 21:46:55,1190878170,59810,40,50,41,3,47
1380,147804.0,2023-07-11 21:47:25,1190878555,12671,49,31,24,4,27
1381,148070.0,2023-07-11 21:47:55,1190878882,0,2,18,17,0,18
1382,147826.0,2023-07-11 21:48:19,1190879191,1050,5,6,3,1,5
1394,157979.0,2023-07-11 21:58:01,1190886647,108020,299,72,47,9,63
1397,157982.0,2023-07-11 22:07:11,1190893466,8305,111,11,3,4,7
1400,157987.0,2023-07-11 22:29:28,1190909618,26803,35,18,9,3,15
1401,157986.0,2023-07-11 22:29:49,1190909853,33853,100,13,4,10,3
1404,136805.0,2023-07-11 22:36:05,1190914101,27670,58,24,21,2,22
1409,157993.0,2023-07-12 00:32:31,1190991520,0,0,7,0,0,7
1410,157995.0,2023-07-12 00:32:39,1190991578,38380,167,70,38,9,61
1411,157996.0,2023-07-12 00:32:47,1190991663,17322,180,27,16,9,18
1412,157997.0,2023-07-12 00:32:55,1190991720,36925,113,100,27,6,94
1414,157998.0,2023-07-12 00:33:33,1190992130,13347,24,21,8,1,20
1415,136804.0,2023-07-12 14:02:43,1191470356,239,20,12,4,1,11
1416,136264.0,2023-07-12 14:03:31,1191470586,19253,17,10,4,5,5
1417,136834.0,2023-07-12 14:04:23,1191470804,0,0,4,2,0,4
1419,147434.0,2023-07-12 14:05:34,1191471051,60226,48,32,5,12,20
1420,147436.0,2023-07-12 14:06:09,1191471195,17457,90,19,12,5,14
1421,89990.0,2023-07-12 14:08:46,1191471931,8189,26,8,4,3,5
1422,105326.0,2023-07-12 14:11:18,1191472619,20210,31,44,23,2,42
1423,105429.0,2023-07-12 14:11:41,1191472720,15764,43,11,3,2,9
1424,117789.0,2023-07-12 14:12:31,1191472972,46778,158,65,50,10,55
1427,148436.0,2023-07-12 14:13:58,1191473413,702,42,37,9,1,36
1428,158012.0,2023-07-12 14:27:24,1191477268,3405,7,10,7,1,9
1430,158022.0,2023-07-12 14:59:10,1191489154,1194,30,21,19,1,20
1436,49352.0,2023-07-12 17:06:38,1191568834,0,2,42,13,0,42
1437,119122.0,2023-07-12 17:10:00,1191571239,60158,34,15,6,6,9
1439,158050.0,2023-07-12 17:26:23,1191583306,43862,182,24,13,5,19
1442,116808.0,2023-07-12 17:28:35,1191585025,18967,60,86,38,6,80
1443,116809.0,2023-07-12 17:29:03,1191585416,28168,46,79,32,4,75
1444,116811.0,2023-07-12 17:29:46,1191585976,38448,205,49,15,6,43
1446,158056.0,2023-07-12 18:11:35,1191627518,5897,25,126,6,3,123
1450,158079.0,2023-07-12 20:09:04,1191762350,0,0,22,8,0,22
1452,158084.0,2023-07-12 20:46:30,1191790334,688,8,1,0,1,0
1456,158090.0,2023-07-12 21:56:20,1191842209,8670,3,30,26,1,29
1460,134875.0,2023-07-12 22:10:49,1191852249,14685,43,51,38,2,49
1461,135203.0,2023-07-12 22:15:13,1191855388,0,9,18,13,0,18
1462,134858.0,2023-07-12 22:17:40,1191857094,0,4,4,1,0,4
1471,111206.0,2023-07-13 15:13:50,1192136606,34154,116,82,60,9,73
1472,158125.0,2023-07-13 15:14:42,1192137052,63594,96,49,6,3,46
1474,158126.0,2023-07-13 15:20:33,1192139992,22562,40,32,23,3,29
1475,158131.0,2023-07-13 15:44:02,1192152466,7337,10,6,4,1,5
1478,158134.0,2023-07-13 15:59:22,1192161092,110126,101,34,27,6,28
1479,158143.0,2023-07-13 16:05:24,1192164713,125244,96,63,21,7,56
1482,158128.0,2023-07-13 16:23:37,1192175429,0,20,18,13,0,18
1486,122173.0,2023-07-13 16:50:25,1192193018,0,123,50,24,0,50
1487,145993.0,2023-07-13 16:51:04,1192193456,60263,80,50,38,5,45
1488,125986.0,2023-07-13 17:00:42,1192200136,13264,8,9,6,1,8
1489,126018.0,2023-07-13 17:01:23,1192200657,200979,256,55,28,9,46
1490,137297.0,2023-07-13 17:02:23,1192201377,0,1,25,18,0,25
1495,158164.0,2023-07-13 17:51:22,1192235358,4680,19,26,20,2,24
1497,158165.0,2023-07-13 17:52:53,1192236349,3120,18,45,38,1,44
1499,158166.0,2023-07-13 17:53:43,1192236957,6950,14,25,17,4,21
1501,158169.0,2023-07-13 17:54:40,1192237660,0,0,3,3,0,3
1504,147756.0,2023-07-13 18:13:34,1192251392,0,0,9,5,0,9
1505,131520.0,2023-07-13 18:33:17,1192265761,7532,24,38,21,1,37
1508,158209.0,2023-07-13 18:59:32,1192285842,8431,22,10,1,2,8
1510,112961.0,2023-07-13 19:29:27,1192308301,26725,46,92,74,2,90
1511,147603.0,2023-07-13 19:30:02,1192308683,12264,77,77,53,3,74
1512,147596.0,2023-07-13 19:30:33,1192309077,22640,41,16,12,5,11
1513,158216.0,2023-07-13 19:47:10,1192321212,142976,41,26,18,4,22
1514,158221.0,2023-07-13 20:39:27,1192357590,10405,20,12,4,3,9
1515,158227.0,2023-07-13 21:15:58,1192382526,0,1,3,2,0,3
1516,158228.0,2023-07-13 21:16:07,1192382636,56104,19,6,5,1,5
1517,158231.0,2023-07-13 21:47:35,1192402795,287028,144,50,16,5,45
1518,158226.0,2023-07-13 21:54:09,1192406979,153112,58,31,23,3,28
1525,158232.0,2023-07-13 22:32:32,1192431578,142368,67,19,7,5,14
1529,158240.0,2023-07-13 23:55:55,1192479852,77182,126,37,23,9,28
1533,158245.0,2023-07-14 00:34:30,1192499383,3870,116,83,44,1,82
1536,158238.0,2023-07-14 14:43:17,1192657992,45693,47,22,13,6,16
1544,158246.0,2023-07-14 14:56:44,1192663004,21206,11,13,1,1,12
1548,158265.0,2023-07-14 15:20:04,1192673165,24705,62,18,4,2,16
1549,158247.0,2023-07-14 15:51:02,1192689000,7256,173,95,58,2,93
1552,147757.0,2023-07-14 15:59:28,1192693536,76988,226,102,53,4,98
1553,147733.0,2023-07-14 16:00:02,1192693788,37572,77,74,41,6,68
1554,147760.0,2023-07-14 16:00:33,1192694062,1675,26,39,14,1,38
1555,158268.0,2023-07-14 16:06:29,1192697304,25160,93,83,60,5,78
1557,158292.0,2023-07-14 17:31:54,1192752629,0,0,34,8,0,34
1558,122184.0,2023-07-14 17:35:55,1192755483,4320,48,128,76,3,125
1559,122172.0,2023-07-14 17:43:50,1192761297,10540,33,121,79,5,116
1560,121222.0,2023-07-14 18:00:23,1192773066,30721,76,27,10,5,22
1575,158322.0,2023-07-14 18:37:25,1192799827,1223,12,22,19,1,21
1576,134877.0,2023-07-14 18:42:29,1192803591,39515,70,70,57,6,64
1577,158354.0,2023-07-14 19:19:18,1192829893,4270,45,14,3,2,12
1579,158356.0,2023-07-14 19:25:38,1192834284,5690,32,9,1,1,8
1581,158360.0,2023-07-14 19:45:42,1192848226,0,8,23,8,0,23
1586,158369.0,2023-07-14 22:35:45,1192961967,5187,50,21,9,2,19
1587,158367.0,2023-07-14 22:35:53,1192962099,0,0,2,2,0,2
1589,158377.0,2023-07-14 22:36:12,1192962362,29864,37,21,2,3,18
1591,158379.0,2023-07-14 22:47:54,1192972575,7165,204,35,20,2,33
1592,158380.0,2023-07-14 22:54:02,1192977890,8550,19,84,38,1,83
1593,158381.0,2023-07-14 22:58:04,1192981362,0,9,64,34,0,64
1594,158385.0,2023-07-14 23:11:53,1192993095,7158,84,11,7,1,10
1598,158386.0,2023-07-15 00:06:43,1193035099,0,0,1,0,0,1
1599,158382.0,2023-07-15 16:15:29,1193492774,0,1,7,0,0,7
1602,158405.0,2023-07-15 17:01:59,1193530521,73415,183,17,10,8,9
1603,158406.0,2023-07-15 17:09:14,1193536018,160293,156,99,40,8,91
1605,158415.0,2023-07-15 17:24:49,1193548007,0,6,68,36,0,68
1607,158416.0,2023-07-15 17:36:41,1193557535,5145,88,29,27,2,27
1609,158417.0,2023-07-15 17:45:50,1193564621,6113,94,44,31,2,42
1621,148536.0,2023-07-17 17:18:38,1194681612,0,39,52,23,0,52
1622,148540.0,2023-07-17 17:19:22,1194682158,0,17,39,28,0,39
1623,148537.0,2023-07-17 17:19:52,1194682499,937,18,17,10,1,16
1624,148542.0,2023-07-17 17:20:21,1194682856,0,0,4,1,0,4
1626,148638.0,2023-07-17 17:20:49,1194683178,30,185,52,29,1,51
1628,148795.0,2023-07-17 17:21:33,1194683691,0,2,51,17,0,51
1632,147386.0,2023-07-17 21:31:21,1195007861,2824,6,8,4,2,6
1633,147256.0,2023-07-17 21:32:52,1195009650,5691,11,9,7,1,8
1634,147281.0,2023-07-17 21:34:15,1195011396,15425,49,23,16,2,21
1638,158527.0,2023-07-17 22:52:43,1195108393,7058,9,12,2,3,9
1641,158543.0,2023-07-18 02:40:48,1195293032,4378,42,46,14,2,44
1642,158542.0,2023-07-18 02:43:35,1195294030,21425,50,31,20,7,24
1643,158541.0,2023-07-18 02:46:19,1195294933,30141,106,45,27,5,40
1645,158582.0,2023-07-18 15:50:12,1195814143,12014,17,35,17,3,32
1646,158584.0,2023-07-18 15:50:29,1195814393,6068,9,10,5,1,9
1648,158578.0,2023-07-18 16:32:21,1195852033,12976,27,17,13,1,16
1651,158599.0,2023-07-18 16:32:42,1195852364,0,0,8,5,0,8
1653,158607.0,2023-07-18 17:46:03,1196002279,3866,26,30,9,2,28
1654,158608.0,2023-07-18 17:51:35,1196018508,22440,75,19,14,5,14
1655,158611.0,2023-07-18 18:00:41,1196045392,7279,8,39,15,4,35
1656,158612.0,2023-07-18 18:24:12,1196117275,1058,1,2,1,1,1
1659,158609.0,2023-07-18 19:03:31,1196195957,424119,97,28,11,6,22
1660,158626.0,2023-07-18 19:41:06,1196259447,48689,112,123,18,7,116
1661,158627.0,2023-07-18 19:41:10,1196259609,15466,67,20,16,4,16
1662,140068.0,2023-07-18 20:32:57,1196335509,0,2,15,9,0,15
1663,140076.0,2023-07-18 20:33:31,1196336063,404,12,14,9,1,13
1664,140196.0,2023-07-18 20:34:41,1196337181,5823,143,13,8,2,11
1665,158666.0,2023-07-18 21:03:25,1196365964,18627,8,40,29,2,38
1666,122289.0,2023-07-18 21:17:45,1196381839,0,0,3,1,0,3
1667,158669.0,2023-07-18 21:41:57,1196406254,76848,91,10,6,6,4
1669,158625.0,2023-07-18 21:41:59,1196406284,141767,96,67,39,8,59
1670,158673.0,2023-07-18 22:20:22,1196443682,190074,47,49,29,4,45
1671,158674.0,2023-07-18 22:22:00,1196445284,67618,105,54,31,8,46
1672,158675.0,2023-07-18 22:22:34,1196445867,2029,22,28,24,2,26
1673,158677.0,2023-07-18 22:23:02,1196446287,2601,15,6,5,2,4
1674,158678.0,2023-07-18 22:23:25,1196446674,12712,113,61,39,4,57
1678,158697.0,2023-07-18 23:31:43,1196523935,101775,29,12,5,3,9
1680,158700.0,2023-07-18 23:49:54,1196546549,61129,225,13,5,4,9
1685,158702.0,2023-07-19 00:17:46,1196576227,11489,34,5,5,3,2
1691,158717.0,2023-07-19 16:13:13,1197039223,1544,16,71,7,2,69
1692,158739.0,2023-07-19 18:03:35,1197121637,0,0,2,0,0,2
1694,158742.0,2023-07-19 18:03:43,1197121740,0,0,6,5,0,6
1695,158746.0,2023-07-19 18:49:25,1197158426,0,21,105,72,0,105
1696,158755.0,2023-07-19 19:38:12,1197196235,47811,100,83,65,7,76
1699,158769.0,2023-07-19 20:46:27,1197247316,0,0,1,0,0,1
1705,158782.0,2023-07-19 22:25:50,1197318903,2564,19,42,16,1,41
1706,158784.0,2023-07-19 22:41:49,1197329628,74372,187,180,23,5,175
1707,158785.0,2023-07-19 22:46:31,1197332891,11349,48,51,22,3,48
1708,158787.0,2023-07-19 22:51:44,1197336409,29923,197,47,26,5,42
1710,158789.0,2023-07-19 23:01:18,1197342885,4949,30,14,4,3,11
1711,158705.0,2023-07-19 23:47:05,1197372781,16961,28,19,12,4,15
1720,158694.0,2023-07-19 23:56:02,1197378465,69702,178,32,16,5,27
1721,158696.0,2023-07-19 23:56:46,1197378945,62908,236,23,14,4,19
1723,158703.0,2023-07-20 00:00:20,1197381073,1324,2,4,1,1,3
1725,158796.0,2023-07-20 00:52:40,1197409090,34845,75,8,5,3,5
1726,158800.0,2023-07-20 01:12:06,1197418197,59391,61,14,5,2,12
1727,158808.0,2023-07-20 14:44:25,1197571491,21893,62,31,14,3,28
1728,158809.0,2023-07-20 14:44:56,1197571648,32779,86,52,31,5,47
1729,158813.0,2023-07-20 15:55:11,1197606000,17093,67,22,14,6,16
1730,158706.0,2023-07-20 15:55:56,1197606366,12164,39,17,6,5,12
1731,158818.0,2023-07-20 16:13:34,1197617259,66443,31,29,19,3,26
1735,147910.0,2023-07-20 17:11:23,1197656320,0,1,45,36,0,45
1736,158819.0,2023-07-20 17:30:19,1197669926,164878,357,72,34,17,55
1738,158823.0,2023-07-20 17:30:30,1197670077,26784,91,28,16,6,22
1743,158833.0,2023-07-20 17:31:00,1197670430,67790,126,83,52,5,78
1745,158839.0,2023-07-20 17:31:32,1197670881,117573,295,55,36,9,46
1747,158844.0,2023-07-20 17:51:16,1197685536,26499,144,17,7,5,12
1748,158846.0,2023-07-20 17:56:18,1197689340,7811,52,45,9,2,43
1755,158847.0,2023-07-20 18:03:09,1197694441,20059,130,14,8,7,7
1758,158862.0,2023-07-20 18:23:28,1197709723,87126,108,25,11,9,16
1760,100988.0,2023-07-20 18:39:22,1197722046,12588,28,33,22,2,31
1761,100985.0,2023-07-20 18:40:28,1197722822,23409,103,91,49,4,87
1762,100982.0,2023-07-20 18:40:52,1197723118,0,5,64,28,0,64
1763,100990.0,2023-07-20 18:41:22,1197723516,55,13,26,17,1,25
1764,131434.0,2023-07-20 18:41:46,1197723783,810,42,37,8,2,35
1767,158860.0,2023-07-20 18:56:07,1197734931,88824,301,51,27,10,41
1769,158865.0,2023-07-20 18:56:21,1197735121,161774,108,58,32,5,53
1770,158867.0,2023-07-20 18:56:29,1197735238,63142,108,45,25,12,33
1772,158871.0,2023-07-20 18:56:46,1197735427,1205,8,11,5,1,10
1774,158882.0,2023-07-20 19:04:45,1197741670,62748,336,52,30,7,45
1776,158881.0,2023-07-20 19:32:35,1197762927,9076,8,2,0,1,1
1777,158884.0,2023-07-20 19:32:47,1197763076,0,38,32,30,0,32
1778,158889.0,2023-07-20 19:33:08,1197763352,1480,66,44,28,1,43
1779,158890.0,2023-07-20 19:34:11,1197764133,25877,146,31,2,12,19
1780,158901.0,2023-07-20 20:14:53,1197793697,19326,40,16,12,4,12
1781,115504.0,2023-07-20 20:15:07,1197793905,12281,97,51,33,5,46
1782,158900.0,2023-07-20 20:16:26,1197794889,46800,141,86,37,11,75
1783,158903.0,2023-07-20 20:34:40,1197807923,101484,102,43,26,10,33
1784,158902.0,2023-07-20 20:36:45,1197809523,436,5,3,0,3,0
1785,158904.0,2023-07-20 20:39:18,1197811424,11973,18,7,0,2,5
1786,158905.0,2023-07-20 20:41:02,1197812597,44505,124,35,10,5,30
1787,158907.0,2023-07-20 21:16:29,1197837994,1418,12,9,4,1,8
1790,158920.0,2023-07-20 23:13:11,1197917116,3109,14,10,8,2,8
1791,158945.0,2023-07-21 14:28:00,1198137142,138337,259,45,31,8,37
1798,98288.0,2023-07-21 15:52:58,1198173319,82760,128,39,17,8,31
1799,97777.0,2023-07-21 15:53:43,1198173742,107373,336,164,33,11,153
1800,98276.0,2023-07-21 15:54:22,1198174154,62159,116,20,10,5,15
1801,108975.0,2023-07-21 15:55:03,1198174562,15296,54,17,5,3,14
1802,149818.0,2023-07-21 15:55:48,1198174975,5426,5,18,6,3,15
1804,149293.0,2023-07-21 15:57:07,1198175718,7814,108,86,39,9,77
1811,159000.0,2023-07-21 18:37:22,1198289106,37366,25,31,18,1,30
1812,158981.0,2023-07-21 18:55:13,1198303318,25433,209,39,25,6,33
1816,159006.0,2023-07-21 19:09:52,1198314973,97488,283,18,12,9,9
1817,159022.0,2023-07-21 20:23:22,1198370489,69317,25,40,31,1,39
1819,148600.0,2023-07-21 20:32:17,1198376894,23850,42,31,12,3,28
1820,148488.0,2023-07-21 20:32:44,1198377203,176310,219,117,54,10,107
1821,148506.0,2023-07-21 20:33:11,1198377561,117372,238,95,64,6,89
1822,148594.0,2023-07-21 20:33:39,1198377894,10682,26,57,37,2,55
1823,148598.0,2023-07-21 20:34:05,1198378218,3024,38,32,21,2,30
1824,159027.0,2023-07-21 20:50:17,1198389631,0,0,10,3,0,10
1825,159026.0,2023-07-21 20:50:51,1198390016,0,5,6,3,0,6
1828,159025.0,2023-07-21 20:51:29,1198390518,0,0,1,0,0,1
1831,159024.0,2023-07-21 20:51:54,1198390790,9839,25,4,2,1,3
1832,94881.0,2023-07-21 21:06:32,1198401064,2726,24,15,7,1,14
1838,159050.0,2023-07-21 22:00:45,1198472562,0,0,20,16,0,20
1842,138470.0,2023-07-21 22:30:35,1198503477,10193,65,65,20,2,63
1844,159058.0,2023-07-21 22:45:47,1198513665,141863,32,32,27,3,29
1845,159061.0,2023-07-21 22:45:55,1198513737,23033,127,46,34,8,38
1847,159062.0,2023-07-21 22:46:05,1198513856,2753,17,30,20,3,27
1848,159063.0,2023-07-21 23:06:42,1198527226,18367,115,38,24,7,31
1851,159065.0,2023-07-21 23:18:18,1198534624,15275,30,32,27,4,28
1852,159066.0,2023-07-21 23:23:41,1198538064,96418,85,50,39,8,42
1853,159068.0,2023-07-21 23:49:13,1198553061,145895,101,40,28,5,35
1854,159069.0,2023-07-22 00:00:08,1198559155,289,9,25,17,1,24
1856,159070.0,2023-07-22 00:45:07,1198582144,45805,131,76,26,9,67
1857,159071.0,2023-07-22 01:00:29,1198587503,34027,74,182,45,15,167
1858,159075.0,2023-07-22 15:14:17,1198752006,4914,101,15,4,2,13
1859,159076.0,2023-07-22 15:17:20,1198753033,5330,14,13,8,3,10
1860,159077.0,2023-07-22 15:23:28,1198755221,30479,121,76,23,1,75
1861,159079.0,2023-07-22 15:42:14,1198762369,15811,88,36,21,6,30
1862,159080.0,2023-07-22 15:46:05,1198763806,116044,143,115,49,24,91
1863,159083.0,2023-07-22 15:57:08,1198768312,7331,51,57,21,3,54
1867,159110.0,2023-07-22 16:29:08,1198782306,9878,92,22,16,2,20
1868,159114.0,2023-07-22 16:36:45,1198785940,45950,131,12,7,6,6
1869,159113.0,2023-07-22 16:37:12,1198786183,46323,77,16,9,5,11
1872,159115.0,2023-07-22 16:38:23,1198786801,30520,102,58,14,9,49
1873,159109.0,2023-07-22 16:39:00,1198787117,749,14,11,8,1,10
1874,159116.0,2023-07-22 16:39:01,1198787127,2856,7,14,10,1,13
1875,159124.0,2023-07-22 16:57:26,1198796563,22553,51,30,16,2,28
1876,159125.0,2023-07-22 17:02:10,1198798928,108693,102,26,11,8,18
1877,159126.0,2023-07-22 17:07:05,1198801511,39249,142,13,7,4,9
1879,159129.0,2023-07-22 17:19:35,1198808308,25170,85,49,28,2,47
1881,159142.0,2023-07-24 14:27:47,1199535133,11879,28,5,0,2,3
1883,159144.0,2023-07-24 14:51:41,1199543172,0,0,2,2,0,2
1891,159151.0,2023-07-24 15:48:40,1199570525,2960,13,30,17,1,29
1893,159150.0,2023-07-24 15:48:58,1199570706,0,3,20,3,0,20
1894,159152.0,2023-07-24 15:49:21,1199570953,13495,94,10,7,2,8
1895,159153.0,2023-07-24 15:56:36,1199575122,0,0,6,5,0,6
1902,159173.0,2023-07-24 17:25:48,1199638006,26002,94,100,51,8,92
1903,159082.0,2023-07-24 17:27:42,1199639399,50330,76,43,24,4,39
1904,159177.0,2023-07-24 18:15:08,1199677885,89725,139,11,4,6,5
1905,159181.0,2023-07-24 18:36:36,1199695286,12294,44,12,6,2,10
1908,159192.0,2023-07-24 19:26:46,1199738002,95357,297,265,47,6,259
1913,159207.0,2023-07-24 20:57:13,1199815066,8026,176,33,7,3,30
1917,159215.0,2023-07-24 22:17:12,1199885418,28811,62,39,26,7,32
1918,159220.0,2023-07-24 22:24:58,1199891520,26498,52,70,28,5,65
1920,143185.0,2023-07-24 22:47:40,1199909449,18962,114,31,24,5,26
1922,159238.0,2023-07-24 23:12:39,1199927966,34853,310,55,36,10,45
1924,159267.0,2023-07-25 16:00:19,1201276422,2737,14,2,0,2,0
1928,123105.0,2023-07-25 16:44:20,1201309344,83744,98,35,30,3,32
1929,123106.0,2023-07-25 16:45:10,1201310035,198059,208,45,35,9,36
1930,123107.0,2023-07-25 16:45:43,1201310487,44897,110,79,35,8,71
1931,135929.0,2023-07-25 16:46:35,1201311205,6237,5,8,6,3,5
1934,159297.0,2023-07-25 17:04:16,1201325612,213239,244,53,24,11,42
1936,159302.0,2023-07-25 17:04:49,1201326051,5482,128,84,9,6,78
1937,135856.0,2023-07-25 17:12:56,1201332793,6792,21,21,14,2,19
1938,159300.0,2023-07-25 17:24:41,1201342922,0,16,27,11,0,27
1939,159299.0,2023-07-25 17:25:15,1201343547,15414,104,20,9,3,17
1940,159298.0,2023-07-25 17:25:47,1201344003,0,28,2,2,0,2
1941,159308.0,2023-07-25 17:43:13,1201357745,30411,9,10,2,1,9
1942,159307.0,2023-07-25 17:43:17,1201357790,25313,153,21,9,4,17
1943,159312.0,2023-07-25 17:51:39,1201363996,15456,32,116,56,4,112
1951,159328.0,2023-07-25 18:41:21,1201409660,33819,202,21,15,4,17
1952,159332.0,2023-07-25 19:58:47,1201490359,70406,115,84,54,7,77
1954,159370.0,2023-07-25 22:51:43,1201633142,37929,80,30,19,5,25
1955,159368.0,2023-07-25 22:52:12,1201633544,60566,66,37,30,3,34
1958,159373.0,2023-07-25 23:29:06,1201662777,13582,22,4,3,1,3
1962,159404.0,2023-07-26 15:24:59,1201931412,10224,88,9,3,2,7
1963,159406.0,2023-07-26 15:32:18,1201935635,67303,195,51,20,7,44
1964,159147.0,2023-07-26 15:33:36,1201936368,69151,180,75,22,5,70
1966,111272.0,2023-07-26 16:21:55,1201967118,37779,98,35,29,6,29
1969,159385.0,2023-07-26 16:58:51,1201994344,47269,138,73,41,11,62
1971,159387.0,2023-07-26 16:59:08,1201994598,11555,28,6,4,2,4
1972,159396.0,2023-07-26 17:00:13,1201995402,245495,93,17,10,5,12
1973,159405.0,2023-07-26 17:00:22,1201995502,1548,37,35,21,2,33
1974,108672.0,2023-07-26 17:15:22,1202007069,80770,129,45,28,5,40
1975,108501.0,2023-07-26 17:15:58,1202007488,41939,91,89,57,6,83
1976,108499.0,2023-07-26 17:16:24,1202007865,99564,106,90,38,5,85
1977,108479.0,2023-07-26 17:16:58,1202008275,28276,23,119,58,4,115
1979,149448.0,2023-07-26 17:17:54,1202008990,69309,55,34,15,5,29
1980,116529.0,2023-07-26 17:41:17,1202028049,61373,131,61,28,12,49
1981,114831.0,2023-07-26 17:41:48,1202028467,640,21,25,8,1,24
1982,127117.0,2023-07-26 17:42:22,1202028962,55847,129,57,15,3,54
1983,116412.0,2023-07-26 17:42:40,1202029183,11918,5,14,6,3,11
1987,116409.0,2023-07-26 17:58:02,1202052705,39426,27,15,3,4,11
1988,148992.0,2023-07-26 17:58:26,1202053470,65462,236,25,14,5,20
1989,159408.0,2023-07-26 18:11:55,1202076502,0,0,7,5,0,7
1990,159452.0,2023-07-26 18:21:47,1202092875,50363,71,141,123,5,136
1992,149629.0,2023-07-26 19:53:51,1202172391,91459,305,76,52,11,65
1993,150081.0,2023-07-26 19:54:21,1202172802,70497,172,46,25,7,39
1994,149640.0,2023-07-26 19:54:42,1202173095,11687,24,14,3,4,10
1995,149858.0,2023-07-26 19:55:08,1202173432,10957,55,23,13,5,18
1996,159497.0,2023-07-26 20:41:31,1202215604,10878,63,22,20,5,17
1997,159498.0,2023-07-26 20:41:41,1202215724,117366,135,84,22,7,77
1998,159510.0,2023-07-26 21:42:25,1202277202,32660,38,19,12,4,15
1999,159509.0,2023-07-26 21:42:57,1202277681,95263,26,92,54,4,88
2000,159507.0,2023-07-26 21:43:29,1202278270,12026,39,21,10,3,18
2002,159505.0,2023-07-26 21:44:17,1202279123,1,1,15,9,1,14
2003,159502.0,2023-07-26 21:44:40,1202279535,113,2,10,5,2,8
2004,159501.0,2023-07-26 21:44:57,1202279816,48164,151,30,10,7,23
2005,159500.0,2023-07-26 21:45:19,1202280172,68975,257,55,41,9,46
2006,159499.0,2023-07-26 21:45:44,1202280530,47001,29,68,50,4,64
2007,132158.0,2023-07-26 22:13:41,1202308404,8923,8,28,19,2,26
2008,132152.0,2023-07-26 22:14:52,1202309451,3952,10,45,19,2,43
2009,132153.0,2023-07-26 22:15:20,1202309870,4329,2,22,15,1,21
2010,140796.0,2023-07-26 22:15:49,1202310271,202871,12,24,16,1,23
2011,132164.0,2023-07-26 22:16:32,1202310889,23774,91,108,60,7,101
2012,132160.0,2023-07-26 22:16:57,1202311242,0,0,19,14,0,19
2013,159513.0,2023-07-26 22:20:35,1202314202,20344,88,38,8,6,32
2014,139595.0,2023-07-26 22:26:29,1202319387,4093,26,20,15,1,19
2016,139530.0,2023-07-26 22:26:59,1202320278,139721,157,91,66,12,79
2018,149270.0,2023-07-26 22:30:07,1202326080,7224,24,20,6,1,19
2020,159517.0,2023-07-26 23:07:06,1202395375,24028,36,11,9,2,9
2021,159518.0,2023-07-26 23:07:16,1202395746,16684,10,53,33,2,51
2022,159525.0,2023-07-26 23:07:23,1202395969,65903,297,74,42,6,68
2023,139526.0,2023-07-26 23:09:21,1202399642,1432,17,63,36,2,61
2026,159527.0,2023-07-26 23:43:31,1202452144,116739,29,22,17,3,19
2027,159529.0,2023-07-26 23:43:38,1202452305,20594,17,23,17,2,21
2038,130084.0,2023-07-27 22:00:17,1203108715,0,0,7,2,0,7
2041,159675.0,2023-07-27 22:56:26,1203164473,10908,50,17,2,2,15
2042,159674.0,2023-07-27 22:56:51,1203164834,18767,44,76,23,4,72
2043,159673.0,2023-07-27 22:57:07,1203165076,0,0,14,0,0,14
2045,159684.0,2023-07-27 23:37:08,1203197812,40857,197,151,39,11,140
2046,159682.0,2023-07-27 23:37:15,1203197894,4658,2,10,8,1,9
2047,159680.0,2023-07-27 23:37:25,1203198038,49611,131,37,12,9,28
2048,159679.0,2023-07-27 23:37:34,1203198138,11836,23,14,8,2,12
2049,159668.0,2023-07-27 23:38:28,1203198764,15047,146,6,3,4,2
2050,159670.0,2023-07-27 23:38:45,1203198981,19596,93,49,32,2,47
2057,159715.0,2023-07-28 14:57:28,1203420269,29090,100,43,32,6,37
2061,159717.0,2023-07-28 15:30:59,1203435839,0,0,3,2,0,3
2062,159720.0,2023-07-28 15:38:33,1203440142,55443,71,60,19,6,54
2066,159724.0,2023-07-28 15:58:32,1203452211,24637,8,8,5,3,5
2067,132793.0,2023-07-28 16:18:22,1203464809,72953,50,120,81,6,114
2068,133107.0,2023-07-28 16:20:47,1203466493,111515,98,72,43,10,62
2069,133015.0,2023-07-28 16:21:11,1203466767,60586,98,23,12,4,19
2072,159744.0,2023-07-28 18:53:55,1203576873,21363,107,19,15,2,17
2073,159745.0,2023-07-28 18:59:20,1203580672,95626,40,75,51,6,69
2075,159747.0,2023-07-28 19:06:16,1203586038,37418,101,33,10,6,27
2076,159748.0,2023-07-28 19:14:35,1203592051,48595,51,39,23,3,36
2077,159749.0,2023-07-28 19:20:36,1203596524,70222,71,64,25,3,61
2078,159750.0,2023-07-28 19:26:14,1203600798,42715,38,12,3,2,10
2082,159760.0,2023-07-28 20:16:47,1203638450,5232,47,9,6,1,8
2083,159769.0,2023-07-28 20:17:02,1203638590,25538,308,289,43,7,282
2085,159772.0,2023-07-28 20:33:00,1203650039,1954,140,19,8,2,17
2089,159791.0,2023-07-28 22:03:41,1203712428,71466,82,90,47,7,83
2091,159797.0,2023-07-28 22:23:57,1203725933,117704,208,89,57,13,76
2095,147489.0,2023-07-28 22:31:33,1203730849,166,4,5,0,1,4
2096,159792.0,2023-07-28 22:32:44,1203731639,225990,77,47,11,6,41
2100,159820.0,2023-07-29 14:26:11,1203994160,156853,193,25,14,5,20
2101,159821.0,2023-07-29 14:30:59,1203995323,0,0,5,4,0,5
2102,159822.0,2023-07-29 14:40:56,1203997976,102547,77,36,14,6,30
2106,159823.0,2023-07-29 14:49:20,1204000368,0,0,10,6,0,10
2110,159828.0,2023-07-29 15:20:26,1204009906,363,4,23,9,2,21
2112,159825.0,2023-07-29 15:24:04,1204011360,124483,75,13,7,5,8
2114,159830.0,2023-07-29 15:31:06,1204014902,13428,213,37,28,6,31
2117,128875.0,2023-07-29 15:43:36,1204021899,0,11,16,5,0,16
2119,147487.0,2023-07-29 15:53:41,1204027479,14545,87,83,62,5,78
2120,159833.0,2023-07-29 16:23:41,1204045722,13607,40,50,3,3,47
2121,159835.0,2023-07-29 16:25:22,1204046772,47268,166,11,6,3,8
2122,159834.0,2023-07-29 16:25:47,1204047001,2879,20,12,3,2,10
2123,159832.0,2023-07-29 16:26:14,1204047306,3111,11,17,13,1,16
2126,147492.0,2023-07-29 16:39:05,1204054453,10142,79,17,13,5,12
2128,159838.0,2023-07-29 16:56:06,1204064841,77312,169,56,37,9,47
2130,159837.0,2023-07-29 16:58:03,1204065988,6989,144,26,11,6,20
2144,126185.0,2023-07-29 18:25:04,1204118828,8936,8,7,4,1,6
2145,126189.0,2023-07-29 18:25:35,1204119535,166715,129,36,23,9,27
2146,133748.0,2023-07-29 18:26:05,1204120066,14003,212,13,7,4,9
2147,126191.0,2023-07-29 18:26:41,1204120889,103032,50,15,8,3,12
2149,133749.0,2023-07-29 18:27:16,1204121631,72743,292,50,25,9,41
2152,159871.0,2023-07-29 19:38:19,1204162868,0,0,1,0,0,1
2155,159875.0,2023-07-29 19:39:04,1204163293,10635,70,12,4,1,11
2156,159876.0,2023-07-29 19:39:22,1204163506,0,17,5,5,0,5
2172,150184.0,2023-07-31 16:10:21,1204958311,113449,55,31,21,3,28
2173,159930.0,2023-07-31 16:20:26,1204965827,40715,41,12,2,3,9
2174,159941.0,2023-07-31 16:52:46,1204992863,6594,5,35,17,2,33
2175,159943.0,2023-07-31 16:54:57,1204994771,0,10,252,31,0,252
2177,159946.0,2023-07-31 17:00:08,1204999148,0,0,4,2,0,4
2178,130073.0,2023-07-31 17:08:59,1205006273,57977,38,298,34,3,295
2179,159949.0,2023-07-31 17:11:34,1205008470,288,2,236,32,1,235
2187,125231.0,2023-07-31 17:44:18,1205040079,36153,93,112,73,6,106
2189,125227.0,2023-07-31 17:45:11,1205040917,6508,19,14,10,1,13
2190,125092.0,2023-07-31 17:45:45,1205041441,41593,114,32,13,4,28
2191,124841.0,2023-07-31 17:46:25,1205042130,58675,110,103,35,9,94
2193,124826.0,2023-07-31 17:46:59,1205042676,10794,31,56,24,1,55
2194,18392.0,2023-07-31 17:50:12,1205045826,0,0,45,21,0,45
2207,160010.0,2023-07-31 20:06:07,1205206268,27045,87,45,24,3,42
2208,160011.0,2023-07-31 20:11:36,1205210748,0,4,42,37,0,42
2209,160012.0,2023-07-31 20:31:47,1205227401,0,3,25,20,0,25
2210,160015.0,2023-07-31 20:37:28,1205231900,2171,40,88,48,1,87
2212,160020.0,2023-07-31 20:45:12,1205237646,0,2,157,80,0,157
2228,160115.0,2023-08-01 16:45:20,1205797404,2540,7,7,5,1,6
2229,160121.0,2023-08-01 17:07:04,1205811356,17326,46,16,7,3,13
2231,160133.0,2023-08-01 17:28:32,1205826965,25996,89,32,13,4,28
2232,160142.0,2023-08-01 18:04:28,1205853127,2002,11,6,3,1,5
2233,160143.0,2023-08-01 18:12:13,1205858944,9983,34,43,29,3,40
2238,94649.0,2023-08-01 19:33:03,1205923495,9259,29,10,6,2,8
2239,94091.0,2023-08-01 19:33:28,1205923882,0,0,21,3,0,21
2240,94088.0,2023-08-01 19:33:50,1205924231,92633,275,105,42,18,87
2241,128881.0,2023-08-01 19:34:15,1205924685,0,0,3,0,0,3
2242,149566.0,2023-08-01 19:34:35,1205924961,9883,100,9,7,1,8
2243,149484.0,2023-08-01 19:35:00,1205925324,13389,89,29,7,2,27
2244,149568.0,2023-08-01 19:35:31,1205925845,2624,17,36,5,4,32
2245,106920.0,2023-08-01 19:39:33,1205929419,30013,1,33,14,1,32
2246,106886.0,2023-08-01 19:39:55,1205929740,30013,8,71,41,1,70
2248,129501.0,2023-08-01 19:40:39,1205930396,0,1,3,1,0,3
2249,131017.0,2023-08-01 19:41:22,1205931011,38043,251,51,18,5,46
2250,131141.0,2023-08-01 19:41:52,1205931463,10226,44,10,9,2,8
2255,160172.0,2023-08-01 21:56:48,1206040454,42900,13,10,2,4,6
2256,160181.0,2023-08-01 22:49:01,1206078863,0,37,5,2,0,5
2270,160227.0,2023-08-02 16:00:47,1206472325,211785,191,60,26,15,45
2273,160231.0,2023-08-02 16:30:18,1206492632,13187,124,8,5,2,6
2277,29193.0,2023-08-02 16:38:01,1206498215,0,4,41,22,0,41
2278,160237.0,2023-08-02 16:50:17,1206513439,11153,29,11,2,2,9
2283,160245.0,2023-08-02 17:34:21,1206574500,14133,134,23,12,4,19
2284,148550.0,2023-08-02 17:54:32,1206597709,7940,19,63,52,2,61
2285,148524.0,2023-08-02 17:55:02,1206598113,26679,61,26,19,4,22
2286,148521.0,2023-08-02 17:55:21,1206598430,12885,41,24,15,2,22
2287,149119.0,2023-08-02 17:55:40,1206598690,1095,7,5,1,1,4
2288,148520.0,2023-08-02 17:55:57,1206598910,8460,16,27,18,2,25
2298,130077.0,2023-08-02 20:22:34,1206726324,9432,21,37,22,3,34
2299,130081.0,2023-08-02 20:23:21,1206727107,42776,59,63,38,7,56
2301,130088.0,2023-08-02 20:24:44,1206728387,14571,145,62,41,5,57
2303,130078.0,2023-08-02 20:25:28,1206729011,11975,195,54,41,5,49
2304,130085.0,2023-08-02 20:25:54,1206729421,12370,36,130,81,4,126
2305,90453.0,2023-08-02 20:39:30,1206741587,7498,23,10,3,3,7
2306,90451.0,2023-08-02 20:40:07,1206742117,103330,174,64,42,7,57
2307,149894.0,2023-08-02 20:42:22,1206744129,12995,25,29,21,2,27
2308,150376.0,2023-08-02 20:43:25,1206744947,0,3,55,18,0,55
2312,160325.0,2023-08-02 22:45:40,1206850645,33445,260,192,40,6,186
2313,160328.0,2023-08-02 22:46:11,1206851088,8942,135,108,42,3,105
2321,160330.0,2023-08-03 15:54:07,1207270510,27847,223,55,23,6,49
2322,160336.0,2023-08-03 15:54:38,1207270824,344669,188,27,15,9,18
2323,160332.0,2023-08-03 15:54:45,1207270880,39180,51,27,11,4,23
2324,160337.0,2023-08-03 15:55:12,1207271212,64562,80,83,68,3,80
2325,160338.0,2023-08-03 15:55:29,1207271443,11694,56,13,5,2,11
2327,160377.0,2023-08-03 16:26:41,1207292862,11193,109,28,9,1,27
2328,126019.0,2023-08-03 16:33:29,1207297938,473583,702,238,41,60,178
2329,160379.0,2023-08-03 16:40:22,1207303063,13548,61,31,27,2,29
2332,160382.0,2023-08-03 17:20:36,1207334258,13543,149,5,4,3,2
2333,123227.0,2023-08-03 18:01:08,1207368207,81279,193,72,53,9,63
2334,124950.0,2023-08-03 18:02:32,1207369451,85553,142,46,31,9,37
2335,149711.0,2023-08-03 18:17:17,1207382235,60382,426,37,21,6,31
2336,149712.0,2023-08-03 18:22:37,1207387029,19151,233,34,19,4,30
2337,124955.0,2023-08-03 18:27:44,1207391378,6507,155,28,24,3,25
2338,148356.0,2023-08-03 18:44:18,1207406714,73603,452,153,48,14,139
2340,160392.0,2023-08-03 19:12:45,1207432797,0,0,7,0,0,7
2345,150374.0,2023-08-03 19:49:11,1207466750,12766,102,15,12,3,12
2347,125140.0,2023-08-03 19:57:17,1207473794,2062,46,49,40,2,47
2349,150428.0,2023-08-03 20:44:19,1207512163,13768,122,48,8,3,45
2350,150427.0,2023-08-03 20:44:45,1207512548,9389,212,55,18,4,51
2351,150440.0,2023-08-03 20:45:13,1207512945,0,72,31,12,0,31
2352,150430.0,2023-08-03 20:45:51,1207513427,22021,175,67,21,5,62
2353,150566.0,2023-08-03 20:46:19,1207513820,17973,45,33,18,3,30
2354,150511.0,2023-08-03 20:46:38,1207514047,46409,64,116,30,2,114
2355,160401.0,2023-08-03 20:54:22,1207520481,29972,264,70,24,16,54
2356,160406.0,2023-08-03 21:48:33,1207563268,25440,44,97,17,4,93
2358,160407.0,2023-08-03 22:00:37,1207573771,109550,195,34,22,9,25
2359,160409.0,2023-08-03 22:06:22,1207578950,40137,67,55,36,6,49
2372,160453.0,2023-08-04 17:11:43,1208087478,228,17,18,9,4,14
2373,160452.0,2023-08-04 17:12:03,1208087757,10952,40,78,61,3,75
2374,160456.0,2023-08-04 17:40:37,1208112555,19805,79,6,4,1,5
2376,129758.0,2023-08-04 18:13:20,1208141344,6565,34,92,77,2,90
2377,129755.0,2023-08-04 18:13:40,1208141660,19469,125,74,54,5,69
2378,129761.0,2023-08-04 18:14:01,1208141976,15967,170,35,31,4,31
2379,129760.0,2023-08-04 18:14:20,1208142285,3591,2,5,3,1,4
2380,129763.0,2023-08-04 18:14:44,1208142705,5063,2,4,2,1,3
2381,150621.0,2023-08-04 18:15:05,1208142975,24575,43,18,4,5,13
2382,160463.0,2023-08-04 18:36:59,1208166330,3600,24,19,10,1,18
2383,135940.0,2023-08-04 18:48:50,1208177334,0,5,8,6,0,8
2389,160415.0,2023-08-04 21:08:46,1208301046,70932,155,49,36,10,39
2390,130033.0,2023-08-04 21:42:27,1208329186,18683,95,56,29,4,52
2391,130030.0,2023-08-04 21:42:59,1208329620,25638,118,27,16,7,20
2392,160413.0,2023-08-04 21:51:20,1208336654,29031,106,16,6,4,12
2395,160410.0,2023-08-04 22:51:08,1208384482,77926,181,28,6,8,20
2401,160450.0,2023-08-05 17:50:34,1208891488,10696,5,4,2,2,2
2402,160465.0,2023-08-05 18:07:10,1208902540,1481,16,2,1,2,0
2403,71670.0,2023-08-05 18:08:06,1208903139,0,46,43,6,0,43
2406,160527.0,2023-08-05 18:37:32,1208923113,27267,146,65,37,3,62
2407,160526.0,2023-08-05 18:37:53,1208923410,25048,20,39,28,2,37
2409,160528.0,2023-08-05 18:40:37,1208925085,0,138,19,10,0,19
2410,113818.0,2023-08-05 19:19:21,1208948304,80080,139,15,6,4,11
2411,114621.0,2023-08-05 19:20:09,1208948827,126618,142,31,11,8,23
2412,114622.0,2023-08-05 19:20:21,1208948949,56998,294,48,20,14,34
2413,123076.0,2023-08-05 19:20:50,1208949204,27836,38,75,40,2,73
2414,123395.0,2023-08-05 19:27:12,1208952956,16859,32,77,48,2,75
2415,160469.0,2023-08-07 14:31:16,1209655914,0,0,1,0,0,1
2416,123320.0,2023-08-07 15:03:40,1209668859,31704,69,32,21,5,27
2420,160544.0,2023-08-07 15:37:36,1209689332,27837,153,23,17,6,17
2421,160547.0,2023-08-07 15:56:29,1209702007,14187,26,32,24,4,28
2422,114623.0,2023-08-07 15:57:38,1209702757,0,4,13,7,0,13
2425,150323.0,2023-08-07 17:43:17,1209788547,192034,102,86,57,10,76
2426,150322.0,2023-08-07 17:45:48,1209790769,20665,193,35,10,6,29
2427,150324.0,2023-08-07 17:46:07,1209791099,3280,278,43,4,7,36
2428,123226.0,2023-08-07 17:46:16,1209791240,8634,48,15,12,3,12
2429,150330.0,2023-08-07 17:46:28,1209791391,7387,28,52,29,2,50
2430,150328.0,2023-08-07 17:46:45,1209791638,190477,103,34,24,5,29
2431,150326.0,2023-08-07 17:47:07,1209791973,20691,29,21,13,4,17
2434,160563.0,2023-08-07 18:00:56,1209804522,4900,19,14,7,1,13
2435,158798.0,2023-08-07 18:53:32,1209853432,835,35,7,1,1,6
2438,160577.0,2023-08-07 21:30:39,1209997651,23596,151,54,26,7,47
2439,160583.0,2023-08-07 21:42:29,1210010589,11314,43,29,16,3,26
2440,160581.0,2023-08-07 21:42:52,1210011078,2434,12,54,44,3,51
2441,160579.0,2023-08-07 21:43:12,1210011407,273159,138,66,30,7,59
2442,160582.0,2023-08-07 21:43:36,1210011793,0,2,9,3,0,9
2452,160668.0,2023-08-08 22:12:51,1210790457,5700,12,57,32,3,54
2454,160683.0,2023-08-08 22:21:58,1210798584,2039,12,3,1,1,2
2455,160687.0,2023-08-09 00:02:39,1210874676,522,28,22,19,1,21
2465,160716.0,2023-08-09 15:17:06,1211191397,747,13,8,3,2,6
2468,120431.0,2023-08-09 15:41:36,1211204247,13954,65,29,21,3,26
2470,160719.0,2023-08-09 15:43:52,1211205519,23755,137,67,53,5,62
2472,120497.0,2023-08-09 15:44:13,1211205782,6601,27,13,8,3,10
2475,120668.0,2023-08-09 15:51:48,1211210388,4321,34,47,33,2,45
2476,160728.0,2023-08-09 15:52:16,1211210714,37390,29,56,33,2,54
2478,120507.0,2023-08-09 15:57:32,1211213933,22655,165,13,9,6,7
2495,160747.0,2023-08-09 17:51:58,1211299142,7277,51,16,4,2,14
2500,160751.0,2023-08-09 18:12:00,1211318163,13158,67,27,14,1,26
2502,160752.0,2023-08-09 18:20:33,1211326291,0,1,4,1,0,4
2503,160753.0,2023-08-09 18:38:37,1211343069,0,4,50,34,0,50
2506,160758.0,2023-08-09 19:16:39,1211377765,0,3,23,15,0,23
2507,160761.0,2023-08-09 19:28:54,1211388867,0,0,18,5,0,18
2508,160755.0,2023-08-09 19:41:29,1211399797,5997,106,27,10,1,26
2509,160774.0,2023-08-09 19:56:10,1211412926,2564,12,26,19,1,25
2510,160775.0,2023-08-09 20:01:32,1211417628,0,23,68,45,0,68
2511,160782.0,2023-08-09 20:08:45,1211423628,44201,124,58,26,7,51
2517,160793.0,2023-08-09 22:04:42,1211516144,0,17,21,9,0,21
2518,160804.0,2023-08-09 22:44:43,1211545955,15268,35,82,25,2,80
2520,160806.0,2023-08-09 23:06:52,1211562125,1432,14,10,7,1,9
2521,160813.0,2023-08-10 14:24:14,1211795508,0,0,36,19,0,36
2524,160827.0,2023-08-10 15:24:02,1211819384,15363,24,31,26,1,30
2531,105234.0,2023-08-10 18:54:34,1211978209,13560,59,66,34,4,62
2532,116844.0,2023-08-10 18:54:57,1211978533,42976,56,66,46,3,63
2533,116128.0,2023-08-10 18:55:30,1211979051,15136,83,53,32,2,51
2535,150698.0,2023-08-10 18:57:24,1211980646,12136,44,92,60,4,88
2540,93493.0,2023-08-10 20:32:39,1212059707,66203,94,76,47,6,70
2541,93494.0,2023-08-10 20:40:40,1212066339,57006,70,107,53,3,104
2542,93485.0,2023-08-10 20:47:34,1212072179,53748,48,78,38,4,74
2543,93481.0,2023-08-10 20:51:15,1212075251,29156,31,54,27,3,51
2544,93486.0,2023-08-10 21:09:44,1212089453,505869,199,102,63,10,92
2566,160917.0,2023-08-10 22:26:58,1212146049,3981,78,44,38,2,42
2586,129839.0,2023-08-11 01:20:39,1212254976,2689,37,36,21,2,34
2587,129836.0,2023-08-11 01:21:24,1212255330,37386,184,89,25,7,82
2588,129840.0,2023-08-11 01:22:20,1212255761,40309,175,27,24,4,23
2589,129841.0,2023-08-11 01:25:21,1212257181,45854,73,73,31,3,70
2596,112988.0,2023-08-11 15:53:06,1212466758,8850,105,54,14,2,52
2597,99151.0,2023-08-11 15:53:51,1212467185,75226,140,40,20,7,33
2598,150331.0,2023-08-11 15:54:17,1212467481,985,193,53,18,3,50
2599,149906.0,2023-08-11 15:54:48,1212467751,141608,302,122,57,7,115
2600,149869.0,2023-08-11 15:55:09,1212467946,48311,106,73,33,4,69
2607,160969.0,2023-08-11 17:01:15,1212513239,2401,92,2,1,1,1
2609,160972.0,2023-08-11 17:01:54,1212513787,34438,84,95,38,7,88
2613,129835.0,2023-08-11 17:10:37,1212520242,70297,348,67,41,5,62
2614,129838.0,2023-08-11 17:16:33,1212524729,0,0,19,15,0,19
2624,149962.0,2023-08-11 18:15:07,1212572232,161567,32,13,4,3,10
2625,149965.0,2023-08-11 18:15:33,1212572581,241725,24,7,2,1,6
2626,149964.0,2023-08-11 18:15:47,1212572770,12908,42,15,0,7,8
2627,149963.0,2023-08-11 18:16:08,1212573064,26160,7,11,8,1,10
2628,149959.0,2023-08-11 18:16:26,1212573322,13588,48,4,0,2,2
2629,149958.0,2023-08-11 18:16:44,1212573512,1461,2,436,21,1,435
2630,149960.0,2023-08-11 18:17:02,1212573813,0,9,5,2,0,5
2631,150102.0,2023-08-11 18:43:52,1212603056,50798,123,124,79,4,120
2632,150250.0,2023-08-11 18:44:43,1212604723,25400,42,20,13,2,18
2634,150106.0,2023-08-11 18:45:17,1212605788,140727,247,144,78,9,135
2636,150098.0,2023-08-11 18:45:45,1212606741,6837,65,14,10,1,13
2637,160991.0,2023-08-11 18:46:28,1212608112,311,66,13,2,1,12
2645,149907.0,2023-08-11 20:27:22,1212798100,20051,150,85,52,3,82
2649,150045.0,2023-08-11 20:28:34,1212800386,53904,146,15,13,7,8
2651,161001.0,2023-08-11 20:29:11,1212801553,2723,244,52,19,3,49
2652,149898.0,2023-08-11 20:29:11,1212801558,6255,7,9,5,2,7
2654,150049.0,2023-08-11 20:30:08,1212803297,0,56,39,24,0,39
2655,149864.0,2023-08-11 20:31:30,1212805866,0,93,50,38,0,50
2656,149949.0,2023-08-11 20:32:18,1212807363,11517,26,33,15,1,32
2658,161015.0,2023-08-11 22:15:56,1213001375,0,0,8,5,0,8
2661,161024.0,2023-08-11 22:53:32,1213069746,46591,25,59,25,3,56
2663,161026.0,2023-08-11 23:04:21,1213088419,17200,72,13,6,5,8
2664,161027.0,2023-08-11 23:07:42,1213092508,43458,113,36,29,3,33
2665,161028.0,2023-08-11 23:11:00,1213097018,17795,30,54,45,2,52
2667,161042.0,2023-08-12 15:29:36,1213389982,5334,9,73,36,1,72
2668,161045.0,2023-08-12 16:10:50,1213406879,33408,78,49,37,7,42
2669,161046.0,2023-08-12 16:14:16,1213408589,64534,78,24,4,4,20
2671,161044.0,2023-08-12 16:19:35,1213411085,53956,80,25,18,4,21
2672,161047.0,2023-08-12 16:20:27,1213411532,80027,244,23,18,8,15
2677,161051.0,2023-08-12 17:20:56,1213442472,36914,70,119,67,4,115
2678,161050.0,2023-08-12 17:21:16,1213442657,220040,227,220,115,3,217
2679,161049.0,2023-08-12 17:21:37,1213442857,2153,97,149,90,1,148
2680,129834.0,2023-08-12 17:54:58,1213461468,41316,38,51,37,2,49
2682,161060.0,2023-08-12 18:36:57,1213485601,143146,48,25,14,2,23
2685,161078.0,2023-08-14 15:14:16,1214227380,44644,147,4,3,3,1
2686,161080.0,2023-08-14 15:51:16,1214248647,19135,191,173,91,4,169
2687,161081.0,2023-08-14 16:07:05,1214259021,23809,44,60,23,6,54
2694,161087.0,2023-08-14 17:07:04,1214301173,0,0,3,2,0,3
2695,161089.0,2023-08-14 17:07:19,1214301378,102254,329,37,26,13,24
2697,161091.0,2023-08-14 17:14:09,1214306450,15107,72,7,4,1,6
2699,161092.0,2023-08-14 17:26:14,1214316328,4513,14,6,3,3,3
2701,161102.0,2023-08-14 17:35:04,1214323725,0,2,40,22,0,40
2706,161105.0,2023-08-14 18:13:23,1214354877,0,1,2,1,0,2
2714,161130.0,2023-08-14 19:51:15,1214445449,25620,64,32,8,3,29
2727,161175.0,2023-08-14 22:45:13,1214584616,159997,47,81,50,2,79
2729,161178.0,2023-08-14 23:00:43,1214595816,67542,105,56,30,7,49
2744,161202.0,2023-08-15 14:35:24,1214867473,9146,210,45,17,6,39
2745,161213.0,2023-08-15 15:09:58,1214883281,7757,263,32,23,2,30
2746,161223.0,2023-08-15 15:46:10,1214905400,16666,22,6,4,3,3
2748,161228.0,2023-08-15 15:46:28,1214905617,4527,13,71,64,1,70
2752,130170.0,2023-08-15 15:51:14,1214908742,24313,50,42,31,3,39
2771,161248.0,2023-08-15 17:20:11,1214976176,19745,52,46,17,3,43
2772,161249.0,2023-08-15 17:50:33,1215001499,0,0,7,4,0,7
2775,129845.0,2023-08-15 17:55:46,1215005737,15059,50,42,24,5,37
2776,149935.0,2023-08-15 17:56:07,1215006074,0,0,2,0,0,2
2777,130115.0,2023-08-15 17:56:19,1215006215,19751,39,140,74,3,137
2778,129849.0,2023-08-15 17:56:29,1215006374,0,70,18,3,0,18
2779,130165.0,2023-08-15 17:56:40,1215006458,4669,4,21,16,1,20
2780,129850.0,2023-08-15 17:57:09,1215006859,38129,172,59,37,5,54
2781,149973.0,2023-08-15 17:57:45,1215007370,0,0,6,5,0,6
2783,161251.0,2023-08-15 18:18:54,1215024911,221347,284,70,26,14,56
2786,150370.0,2023-08-15 18:51:12,1215053200,1884,128,37,20,2,35
2795,161286.0,2023-08-15 20:17:27,1215127115,75266,67,31,20,4,27
2797,99362.0,2023-08-15 20:19:49,1215128989,12940,19,20,11,1,19
2798,99361.0,2023-08-15 20:20:54,1215129884,7866,25,14,7,3,11
2799,93600.0,2023-08-15 20:39:24,1215144971,15150,63,27,15,2,25
2800,105564.0,2023-08-15 20:39:43,1215145190,37293,58,44,28,5,39
2801,93586.0,2023-08-15 20:43:41,1215148291,113809,67,42,35,5,37
2806,18377.0,2023-08-15 22:24:27,1215231533,34972,31,65,36,1,64
2813,98847.0,2023-08-15 23:58:13,1215302115,40174,200,52,28,6,46
2814,109795.0,2023-08-16 00:00:13,1215303580,4579,63,39,20,2,37
2815,98815.0,2023-08-16 00:02:38,1215305245,4746,32,74,50,2,72
2816,151065.0,2023-08-16 00:04:27,1215306519,15044,55,41,25,3,38
2826,98814.0,2023-08-16 01:32:33,1215361619,15252,65,47,31,4,43
2828,161361.0,2023-08-16 16:03:24,1215942561,0,17,50,36,0,50
2831,161371.0,2023-08-16 17:26:54,1216009661,5361,53,29,18,3,26
2833,161374.0,2023-08-16 18:11:56,1216049671,0,0,46,34,0,46
2834,161385.0,2023-08-16 18:12:06,1216049828,51354,130,26,22,4,22
2835,161386.0,2023-08-16 18:12:14,1216049945,66239,379,31,17,5,26
2836,161387.0,2023-08-16 18:46:43,1216080943,51555,72,125,68,12,113
2837,161394.0,2023-08-16 18:51:35,1216085207,1602,8,18,10,2,16
2838,161443.0,2023-08-16 19:48:09,1216142774,9551,222,86,30,3,83
2839,161440.0,2023-08-16 19:48:38,1216143222,0,1,50,13,0,50
2840,161445.0,2023-08-16 20:09:21,1216164871,177170,265,49,31,13,36
2844,161462.0,2023-08-16 20:42:17,1216205873,11819,19,16,4,5,11
2848,161467.0,2023-08-16 21:03:31,1216228242,24675,29,16,9,3,13
2851,161484.0,2023-08-16 22:02:21,1216287961,288528,150,49,25,11,38
2852,161392.0,2023-08-16 22:07:09,1216292745,5578,53,63,30,3,60
2864,141878.0,2023-08-16 23:09:37,1216350968,117713,396,68,53,13,55
2865,161519.0,2023-08-17 14:32:51,1216691394,110106,73,14,7,6,8
2866,150338.0,2023-08-17 14:38:27,1216693691,25090,97,53,22,6,47
2867,150770.0,2023-08-17 14:38:57,1216693928,4047,24,22,11,2,20
2868,150414.0,2023-08-17 14:39:36,1216694148,35769,72,37,18,4,33
2869,150267.0,2023-08-17 14:40:04,1216694366,3849,12,25,16,1,24
2870,150417.0,2023-08-17 14:40:30,1216694537,0,4,6,0,0,6
2872,161523.0,2023-08-17 14:57:43,1216702239,2308,8,27,26,1,26
2877,130392.0,2023-08-17 15:40:50,1216726580,30268,42,26,13,6,20
2887,161540.0,2023-08-17 15:52:23,1216734260,5281,89,33,25,2,31
2889,161494.0,2023-08-17 16:04:46,1216742746,4734,48,51,25,2,49
2890,161545.0,2023-08-17 16:18:52,1216753011,0,4,1,1,0,1
2891,139963.0,2023-08-17 16:23:15,1216756482,15087,14,218,8,2,216
2896,119776.0,2023-08-17 16:41:20,1216771193,15885,98,55,8,5,50
2897,161567.0,2023-08-17 17:05:21,1216790924,0,0,1,0,0,1
2898,161577.0,2023-08-17 17:10:09,1216794668,9703,100,44,26,1,43
2899,161583.0,2023-08-17 17:37:30,1216817594,5812,67,24,11,6,18
2900,121117.0,2023-08-17 17:43:45,1216823075,1461,116,96,59,1,95
2901,121480.0,2023-08-17 17:52:40,1216830906,3635,31,53,34,2,51
2902,149082.0,2023-08-17 17:59:41,1216837311,1461,21,9,6,1,8
2905,161590.0,2023-08-17 18:10:16,1216846738,71020,50,20,13,3,17
2906,161591.0,2023-08-17 18:19:29,1216855003,31820,44,33,25,3,30
2908,161605.0,2023-08-17 18:49:12,1216881717,13141,25,11,6,2,9
2917,161619.0,2023-08-17 19:03:56,1216894805,12330,42,18,15,2,16
2918,151255.0,2023-08-17 19:20:52,1216909459,14960,13,3,2,1,2
2919,161621.0,2023-08-17 19:30:37,1216918120,4184,71,15,5,2,13
2920,161624.0,2023-08-17 19:48:30,1216933310,12653,70,87,20,3,84
2921,161627.0,2023-08-17 19:57:12,1216940500,2683,30,4,0,1,3
2925,161635.0,2023-08-17 21:02:21,1216995206,0,315,116,31,0,116
2937,161670.0,2023-08-18 00:08:26,1217139392,8002,75,56,35,6,50
2939,161669.0,2023-08-18 00:09:01,1217139768,18928,129,49,37,7,42
2940,161671.0,2023-08-18 00:13:11,1217142172,8333,13,12,8,4,8
2942,116271.0,2023-08-18 00:24:38,1217148374,28408,88,45,30,6,39
2943,161680.0,2023-08-18 00:35:25,1217154272,33594,68,44,29,4,40
2944,161697.0,2023-08-18 15:15:47,1217362675,47444,113,56,41,6,50
2946,161701.0,2023-08-18 15:38:01,1217375826,0,0,16,15,0,16
2947,161705.0,2023-08-18 15:47:15,1217381645,8158,5,20,14,1,19
2948,140849.0,2023-08-18 15:53:27,1217386033,0,12,11,9,0,11
2949,161706.0,2023-08-18 15:54:44,1217386874,80327,31,89,25,1,88
2952,161711.0,2023-08-18 16:00:26,1217390830,37750,76,99,4,8,91
2953,140843.0,2023-08-18 16:10:37,1217398276,0,7,30,20,0,30
2955,130205.0,2023-08-18 17:06:23,1217441746,51372,86,36,15,6,30
2956,161731.0,2023-08-18 17:31:00,1217462057,18201,91,48,28,3,45
2957,161734.0,2023-08-18 18:01:22,1217488062,60331,137,16,6,5,11
2959,161736.0,2023-08-18 18:07:42,1217493456,26245,58,10,3,2,8
2962,109210.0,2023-08-18 18:19:35,1217503865,0,1,8,5,0,8
2966,161747.0,2023-08-18 18:33:10,1217515613,0,1,5,4,0,5
2974,161786.0,2023-08-18 21:08:53,1217676909,52862,46,71,32,1,70
2975,161787.0,2023-08-18 21:11:33,1217678847,17216,39,16,11,3,13
2976,161732.0,2023-08-18 21:33:40,1217693810,9378,19,11,5,2,9
2980,161797.0,2023-08-18 21:57:08,1217710115,9850,44,22,14,1,21
2981,161796.0,2023-08-18 21:57:17,1217710200,53719,32,10,6,3,7
2983,161799.0,2023-08-18 22:06:07,1217715914,17826,146,80,61,5,75
2984,161810.0,2023-08-18 22:18:21,1217723574,8151,43,8,6,2,6
2987,161818.0,2023-08-18 22:45:41,1217741015,23479,53,46,3,1,45
2990,131066.0,2023-08-18 23:10:34,1217756046,1086,93,31,19,2,29
2991,131000.0,2023-08-18 23:35:56,1217770435,4276,3,2,0,1,1
2992,161829.0,2023-08-18 23:51:36,1217779106,81881,188,51,24,6,45
2994,161843.0,2023-08-19 00:27:17,1217797040,0,4,3,1,0,3
2997,145702.0,2023-08-19 03:42:04,1217868443,22792,58,34,21,4,30
2998,161846.0,2023-08-19 04:10:38,1217875454,13238,113,42,34,4,38
2999,161847.0,2023-08-19 04:14:01,1217876269,2604,20,39,28,2,37
3001,161849.0,2023-08-19 04:25:15,1217879056,30556,155,33,22,4,29
3002,161850.0,2023-08-19 04:34:34,1217881299,43984,36,29,22,2,27
3008,161862.0,2023-08-19 16:12:46,1217987194,7105,50,32,28,3,29
3009,161866.0,2023-08-19 17:17:38,1218016803,9355,45,73,59,2,71
3010,130159.0,2023-08-19 17:22:15,1218019111,0,5,37,21,0,37
3013,161871.0,2023-08-19 19:16:16,1218079693,8484,16,17,10,2,15
3017,161876.0,2023-08-19 20:35:44,1218120219,13141,42,18,11,2,16
3018,161877.0,2023-08-19 20:40:58,1218122774,0,0,8,4,0,8
3019,161878.0,2023-08-20 03:15:37,1218269805,8669,22,13,5,1,12
3021,161893.0,2023-08-21 15:13:32,1218753711,102302,176,42,17,7,35
3022,136904.0,2023-08-21 15:26:01,1218759912,10320,20,15,5,2,13
3024,161903.0,2023-08-21 16:32:59,1218801718,35903,12,11,7,1,10
3026,161911.0,2023-08-21 17:21:53,1218839052,33471,81,59,39,7,52
3028,129484.0,2023-08-21 17:29:32,1218845170,21618,148,91,53,7,84
3029,129482.0,2023-08-21 17:30:07,1218845730,23750,32,49,41,1,48
3030,141222.0,2023-08-21 17:30:29,1218846026,17326,161,79,57,5,74
3031,107681.0,2023-08-21 18:20:09,1218887733,10534,49,78,52,4,74
3032,140992.0,2023-08-21 18:21:53,1218889246,10452,30,9,5,4,5
3033,161920.0,2023-08-21 18:28:47,1218895422,16907,18,16,10,3,13
3034,161951.0,2023-08-21 21:16:07,1219036684,51798,83,39,15,3,36
3036,161987.0,2023-08-21 23:06:06,1219118288,0,3,4,2,0,4
3037,126101.0,2023-08-21 23:15:48,1219125344,8197,207,50,22,5,45
3038,161991.0,2023-08-21 23:20:15,1219128608,222301,264,75,20,3,72
3042,162002.0,2023-08-22 15:01:43,1219405061,17957,42,55,20,3,52
3043,130206.0,2023-08-22 15:03:59,1219406361,16621,50,36,8,3,33
3044,130204.0,2023-08-22 15:28:54,1219419951,47792,142,33,16,7,26
3045,86577.0,2023-08-22 16:01:27,1219441355,98293,141,93,63,6,87
3046,162010.0,2023-08-22 16:12:55,1219449910,95240,113,42,35,4,38
3047,162012.0,2023-08-22 16:20:37,1219455495,120342,98,81,53,5,76
3051,162021.0,2023-08-22 17:01:26,1219488041,10800,42,5,4,1,4
3053,141071.0,2023-08-22 18:51:07,1219582264,31617,114,13,2,8,5
3054,141068.0,2023-08-22 18:51:38,1219582635,7772,16,26,12,2,24
3056,162051.0,2023-08-22 19:22:45,1219609788,44441,155,75,54,5,70
3057,162052.0,2023-08-22 19:36:45,1219621958,35101,52,85,61,6,79
3058,162053.0,2023-08-22 19:37:24,1219622569,20229,98,54,34,6,48
3059,162071.0,2023-08-22 20:01:35,1219647225,9125,71,8,1,7,1
3060,161709.0,2023-08-22 20:29:32,1219671580,76345,62,26,17,7,19
3061,162089.0,2023-08-22 21:08:17,1219704656,17323,76,52,28,9,43
3063,162101.0,2023-08-22 22:33:59,1219777520,80813,51,50,29,4,46
3068,162112.0,2023-08-22 23:13:27,1219809649,4799,3,4,3,2,2
3079,162157.0,2023-08-23 15:31:46,1220150006,44854,119,20,9,4,16
3088,162182.0,2023-08-23 16:47:42,1220200923,57739,180,23,13,6,17
3089,162184.0,2023-08-23 16:48:35,1220201624,7159,32,34,27,3,31
3092,162189.0,2023-08-23 17:13:55,1220221609,2898,19,38,25,1,37
3094,162208.0,2023-08-23 17:49:36,1220252113,87239,92,33,16,2,31
3101,162216.0,2023-08-23 18:21:18,1220279615,4475,3,8,5,1,7
3102,162215.0,2023-08-23 18:22:33,1220280606,157407,280,42,26,10,32
3103,136448.0,2023-08-23 18:22:48,1220280823,19925,20,27,15,5,22
3104,162214.0,2023-08-23 18:23:51,1220281822,0,6,23,11,0,23
3105,162212.0,2023-08-23 18:24:13,1220282176,0,0,14,10,0,14
3106,162217.0,2023-08-23 18:33:28,1220290281,0,1,17,14,0,17
3107,162220.0,2023-08-23 18:34:48,1220291408,7007,34,68,46,7,61
3108,162222.0,2023-08-23 18:51:45,1220305953,0,135,61,28,0,61
3109,124388.0,2023-08-23 19:06:48,1220319146,124066,84,63,44,6,57
3114,162234.0,2023-08-23 19:27:55,1220337695,14610,19,36,24,2,34
3116,124474.0,2023-08-23 20:04:43,1220368682,1505,18,39,30,1,38
3117,150389.0,2023-08-23 20:13:16,1220375895,34886,126,17,7,10,7
3118,150390.0,2023-08-23 20:13:33,1220376137,96074,298,94,56,4,90
3119,150392.0,2023-08-23 20:13:45,1220376308,35076,68,51,22,2,49
3120,150393.0,2023-08-23 20:13:59,1220376494,0,31,80,41,0,80
3121,152044.0,2023-08-23 20:14:15,1220376758,43117,86,38,32,4,34
3123,162260.0,2023-08-23 21:12:17,1220423192,59984,196,34,21,13,21
3124,150944.0,2023-08-23 21:17:32,1220427374,1956,42,33,23,1,32
3125,150921.0,2023-08-23 21:17:56,1220427663,81,244,40,18,3,37
3126,150918.0,2023-08-23 21:18:18,1220427999,35270,44,54,31,3,51
3127,150912.0,2023-08-23 21:18:40,1220428277,2176,27,12,10,1,11
3128,150905.0,2023-08-23 21:19:01,1220428548,47517,283,48,27,4,44
3129,150901.0,2023-08-23 21:19:25,1220428882,2115,23,37,28,1,36
3130,162262.0,2023-08-23 21:25:25,1220433720,72075,112,60,6,3,57
3131,162261.0,2023-08-23 21:26:27,1220434565,7194,9,41,14,1,40
3132,162264.0,2023-08-23 21:33:38,1220440415,9081,238,70,41,5,65
3138,162269.0,2023-08-23 22:15:04,1220473268,9446,76,11,7,3,8
3140,89410.0,2023-08-23 22:15:35,1220473684,16926,9,32,12,1,31
3145,130783.0,2023-08-23 23:37:58,1220536306,83655,60,30,21,3,27
3146,130784.0,2023-08-23 23:41:11,1220538636,118990,158,46,28,6,40
3147,130787.0,2023-08-23 23:44:02,1220540556,124588,553,89,49,14,75
3148,130767.0,2023-08-23 23:48:59,1220544000,127942,307,86,60,9,77
3149,152798.0,2023-08-24 00:32:11,1220572632,3982,75,57,3,5,52
3150,153051.0,2023-08-24 00:33:11,1220573211,26931,136,116,35,5,111
3151,152802.0,2023-08-24 00:35:11,1220574434,73287,90,116,59,9,107
3152,152801.0,2023-08-24 00:35:57,1220574939,0,55,27,15,0,27
3153,152349.0,2023-08-24 00:37:32,1220576078,7,155,71,22,1,70
3154,152680.0,2023-08-24 00:38:21,1220576682,281,2,4,0,1,3
3155,152345.0,2023-08-24 00:38:53,1220577021,21053,259,46,23,4,42
3156,152344.0,2023-08-24 00:39:28,1220577404,9790,73,85,48,5,80
3157,152721.0,2023-08-24 00:40:02,1220577781,4421,5,46,22,2,44
3160,152363.0,2023-08-24 00:41:42,1220579019,35860,180,94,29,12,82
3164,152797.0,2023-08-24 14:45:10,1220839127,52526,57,41,8,3,38
3165,151561.0,2023-08-24 15:23:18,1220857550,2622,69,15,7,2,13
3166,151398.0,2023-08-24 15:24:03,1220857979,16452,115,77,48,5,72
3167,151400.0,2023-08-24 15:24:49,1220858396,95703,103,57,44,5,52
3168,151394.0,2023-08-24 15:25:28,1220858792,31220,119,59,47,6,53
3169,151399.0,2023-08-24 15:26:09,1220859212,18680,0,55,5,1,54
3170,151567.0,2023-08-24 15:26:53,1220859641,62154,151,87,66,6,81
3171,151369.0,2023-08-24 15:28:01,1220860261,21968,49,87,21,5,82
3172,151373.0,2023-08-24 15:28:38,1220860636,118955,90,46,20,7,39
3173,151370.0,2023-08-24 15:29:28,1220861103,139182,39,37,17,8,29
3174,151363.0,2023-08-24 15:30:02,1220861392,100195,40,17,12,4,13
3176,151371.0,2023-08-24 15:31:41,1220862321,196516,151,69,25,12,57
3178,151362.0,2023-08-24 15:32:21,1220862673,90947,255,114,43,11,103
3188,162311.0,2023-08-24 15:55:56,1220877725,3786,20,63,28,6,57
3190,162317.0,2023-08-24 16:24:08,1220897415,3065,23,18,12,2,16
3198,95170.0,2023-08-24 16:37:42,1220907912,35710,159,150,56,5,145
3200,132218.0,2023-08-24 16:44:32,1220913334,43053,277,248,35,5,243
3201,151972.0,2023-08-24 16:45:12,1220913894,2421,0,23,15,1,22
3202,151973.0,2023-08-24 16:45:43,1220914261,36609,229,107,55,13,94
3204,96812.0,2023-08-24 16:48:09,1220916287,7216,0,43,32,1,42
3210,162353.0,2023-08-24 17:31:33,1220952214,4133,15,37,24,1,36
3211,162354.0,2023-08-24 17:36:10,1220956092,12162,51,93,54,5,88
3216,151658.0,2023-08-24 18:01:37,1220977819,23298,70,69,29,3,66
3217,151654.0,2023-08-24 18:01:59,1220978169,6909,49,28,8,2,26
3225,162310.0,2023-08-24 18:44:25,1221021167,7632,30,8,3,2,6
3227,162372.0,2023-08-24 19:11:40,1221045819,0,3,75,40,0,75
3228,162385.0,2023-08-24 19:47:46,1221075964,108652,66,77,23,6,71
3230,11429.0,2023-08-24 20:08:37,1221093519,3897,63,24,15,3,21
3231,93577.0,2023-08-24 20:57:54,1221133230,30266,33,21,14,4,17
3232,151776.0,2023-08-24 21:06:34,1221139849,0,0,3,2,0,3
3233,151689.0,2023-08-24 21:07:15,1221140441,10177,79,34,20,8,26
3234,151649.0,2023-08-24 21:07:43,1221140809,0,0,1,0,0,1
3235,151650.0,2023-08-24 21:08:19,1221141286,10969,5,25,11,1,24
3237,151722.0,2023-08-24 21:09:01,1221141836,7853,65,40,24,1,39
3238,162399.0,2023-08-24 21:09:33,1221142259,1812,36,72,49,1,71
3246,162415.0,2023-08-24 22:28:54,1221203308,170906,91,48,28,10,38
3251,162432.0,2023-08-24 22:52:21,1221222162,18615,103,69,31,7,62
3260,162454.0,2023-08-25 14:19:11,1222531449,66624,214,40,31,9,31
3262,162455.0,2023-08-25 14:25:35,1222533074,15123,106,63,56,4,59
3265,114567.0,2023-08-25 14:41:53,1222567737,6984,42,31,9,2,29
3271,162485.0,2023-08-25 15:59:21,1222807619,8384,27,12,11,3,9
3272,162487.0,2023-08-25 16:22:13,1222857165,77209,134,33,27,6,27
3273,162488.0,2023-08-25 16:25:14,1222864272,67344,166,24,10,14,10
3274,162489.0,2023-08-25 16:28:53,1222868130,67465,116,26,8,5,21
3275,162490.0,2023-08-25 16:34:34,1222871454,15181,19,71,26,1,70
3281,162508.0,2023-08-25 17:21:55,1222919054,0,0,5,0,0,5
3284,162511.0,2023-08-25 17:27:41,1222930406,0,0,3,2,0,3
3285,162534.0,2023-08-25 18:38:04,1223001377,5055,7,5,3,1,4
3289,162540.0,2023-08-25 19:28:09,1223079201,8378,4,12,8,1,11
3291,162527.0,2023-08-25 20:30:03,1223228255,46716,153,105,52,4,101
3293,162573.0,2023-08-25 21:47:16,1223354792,332075,122,40,31,5,35
3300,162583.0,2023-08-25 22:53:59,1223517892,23655,73,34,17,4,30
3301,162586.0,2023-08-25 23:05:09,1223546434,2384,15,6,4,1,5
3302,162590.0,2023-08-25 23:11:35,1223558702,8783,32,21,15,2,19
3303,162591.0,2023-08-25 23:15:31,1223565923,2247,6,3,1,1,2
3304,162592.0,2023-08-25 23:19:22,1223573066,0,2,60,43,0,60
3305,130768.0,2023-08-25 23:24:12,1223581800,104236,119,156,63,8,148
3307,162594.0,2023-08-25 23:37:58,1223602090,777,18,5,1,1,4
3309,132928.0,2023-08-26 00:05:56,1223662185,65880,259,82,52,4,78
3311,162597.0,2023-08-26 00:29:29,1223698798,0,16,17,13,0,17
3312,162600.0,2023-08-26 14:23:57,1223912037,29926,49,7,4,2,5
3313,162601.0,2023-08-26 14:35:02,1223915236,41827,63,16,11,7,9
3315,162609.0,2023-08-26 15:01:02,1223922725,0,0,11,6,0,11
3324,162614.0,2023-08-26 15:19:38,1223929573,25030,69,39,10,5,34
3325,130055.0,2023-08-26 15:41:54,1223939113,34305,185,29,15,8,21
3326,129714.0,2023-08-26 15:42:17,1223939288,8935,15,8,3,2,6
3327,129711.0,2023-08-26 15:42:37,1223939405,34306,50,56,31,6,50
3328,132203.0,2023-08-26 15:43:02,1223939619,0,0,7,3,0,7
3329,141707.0,2023-08-26 15:43:27,1223939785,2516,2,3,1,1,2
3330,162615.0,2023-08-26 15:46:19,1223941058,1873,5,37,16,1,36
3331,150585.0,2023-08-26 15:49:58,1223942542,28761,77,42,22,2,40
3332,162618.0,2023-08-26 15:58:53,1223946313,0,0,20,16,0,20
3336,162624.0,2023-08-26 16:26:28,1223959974,5927,20,14,14,1,13
3338,162638.0,2023-08-26 17:18:54,1223989595,38601,92,184,48,4,180
3339,147730.0,2023-08-26 17:23:47,1223992877,79935,160,69,35,5,64
3341,162642.0,2023-08-26 17:50:08,1224009878,0,3,83,60,0,83
3342,162645.0,2023-08-26 18:04:50,1224019873,7449,15,6,3,2,4
3343,162647.0,2023-08-26 18:40:49,1224044349,0,3,58,49,0,58
3344,162646.0,2023-08-26 18:41:05,1224044511,0,64,33,29,0,33
3345,162648.0,2023-08-26 18:58:14,1224055390,0,3,37,34,0,37
3347,162634.0,2023-08-26 19:18:23,1224067638,16834,105,14,11,4,10
3349,162626.0,2023-08-26 19:18:37,1224067793,17492,28,37,32,3,34
3350,162625.0,2023-08-26 19:18:51,1224067898,80484,220,85,64,9,76
3351,162623.0,2023-08-26 19:18:57,1224067967,0,0,8,6,0,8
3352,162619.0,2023-08-26 19:19:05,1224068074,120586,77,100,29,2,98
3353,162589.0,2023-08-26 19:19:20,1224068216,8380,8,8,7,1,7
3354,162554.0,2023-08-26 19:19:30,1224068300,10291,57,36,26,2,34
3355,142227.0,2023-08-28 14:33:39,1224756932,127159,116,229,21,8,221
3357,142230.0,2023-08-28 14:34:46,1224757321,33630,212,60,26,12,48
3358,142220.0,2023-08-28 14:35:13,1224757494,13102,58,6,3,2,4
3359,142333.0,2023-08-28 14:35:35,1224757630,44058,204,41,15,11,30
3360,142224.0,2023-08-28 14:35:52,1224757726,5090,8,51,22,1,50
3361,142232.0,2023-08-28 14:36:20,1224757904,8093,17,12,8,2,10
3363,162667.0,2023-08-28 15:02:37,1224767074,622,6,25,14,2,23
3365,152020.0,2023-08-28 15:10:10,1224770142,17392,268,51,34,2,49
3366,153140.0,2023-08-28 15:19:43,1224774555,3469,26,46,32,1,45
3367,152905.0,2023-08-28 15:20:10,1224774798,35381,35,37,10,6,31
3368,152599.0,2023-08-28 15:20:34,1224775025,0,1,46,27,0,46
3369,152164.0,2023-08-28 15:20:55,1224775210,0,0,34,29,0,34
3370,152162.0,2023-08-28 15:21:20,1224775435,12702,58,9,1,4,5
3372,142235.0,2023-08-28 15:31:20,1224780810,44410,17,17,14,2,15
3373,127405.0,2023-08-28 15:41:34,1224786525,28426,238,44,23,5,39
3374,162672.0,2023-08-28 15:42:01,1224786759,4240,30,25,12,1,24
3375,162679.0,2023-08-28 15:57:21,1224795663,0,0,2,0,0,2
3376,160459.0,2023-08-28 16:36:31,1224823266,440,1,1,1,1,0
3381,141609.0,2023-08-28 16:39:46,1224825634,1789,13,55,35,1,54
3382,132446.0,2023-08-28 16:39:55,1224825737,71154,91,83,50,4,79
3383,162696.0,2023-08-28 16:39:55,1224825749,57962,107,27,19,5,22
3384,132447.0,2023-08-28 16:40:03,1224825851,17513,110,27,12,6,21
3385,132452.0,2023-08-28 16:40:15,1224826016,43160,263,111,44,12,99
3388,162699.0,2023-08-28 16:59:54,1224841419,55003,6,41,8,4,37
3389,162703.0,2023-08-28 17:00:00,1224841519,26874,178,64,16,8,56
3393,162708.0,2023-08-28 17:57:05,1224887331,0,0,11,5,0,11
3394,162723.0,2023-08-28 17:57:26,1224887601,0,0,9,7,0,9
3398,162725.0,2023-08-28 18:20:53,1224907552,53896,69,19,14,4,15
3399,162731.0,2023-08-28 18:29:16,1224914605,6251,57,4,0,3,1
3400,151258.0,2023-08-28 18:48:47,1224930623,85541,103,32,18,6,26
3402,151290.0,2023-08-28 18:49:23,1224931136,57991,189,35,21,9,26
3404,151390.0,2023-08-28 18:49:57,1224931604,32436,148,75,51,6,69
3405,140684.0,2023-08-28 18:50:48,1224932314,17155,35,53,33,4,49
3407,140555.0,2023-08-28 18:51:24,1224932809,93736,150,53,24,8,45
3408,151288.0,2023-08-28 18:51:58,1224933231,45636,154,48,32,4,44
3409,162745.0,2023-08-28 18:59:00,1224938885,0,1,14,6,0,14
3410,127413.0,2023-08-28 19:20:49,1224957305,6615,90,60,32,5,55
3412,151738.0,2023-08-28 19:59:41,1224989726,131932,123,47,25,7,40
3413,151739.0,2023-08-28 20:00:39,1224990412,1057,10,12,9,1,11
3414,145542.0,2023-08-28 20:01:03,1224990737,25345,116,121,95,4,117
3415,162773.0,2023-08-28 20:55:24,1225036966,537,43,12,5,2,10
3416,142508.0,2023-08-28 20:56:13,1225037819,51859,85,55,19,10,45
3417,142509.0,2023-08-28 20:57:37,1225039369,19185,5,41,23,2,39
3419,152112.0,2023-08-28 21:35:47,1225077082,75850,40,118,68,2,116
3420,152165.0,2023-08-28 21:36:15,1225077542,2673,58,31,18,2,29
3421,152183.0,2023-08-28 21:36:45,1225077961,0,0,9,5,0,9
3422,152399.0,2023-08-28 21:37:05,1225078281,0,26,32,9,0,32
3423,162730.0,2023-08-28 22:30:10,1225128176,70,92,32,17,2,30
3426,162797.0,2023-08-28 22:47:59,1225145346,13305,114,35,6,8,27
3427,141782.0,2023-08-28 22:49:41,1225146893,60090,216,64,29,18,46
3428,132020.0,2023-08-28 22:49:59,1225147161,24728,131,58,27,9,49
3429,132024.0,2023-08-28 22:51:59,1225149175,42681,232,41,10,3,38
3430,132106.0,2023-08-28 22:52:24,1225149575,15769,31,49,39,1,48
3431,132022.0,2023-08-28 22:52:41,1225149832,53615,67,83,32,3,80
3432,132025.0,2023-08-28 22:53:15,1225150364,0,51,56,42,0,56
3437,162846.0,2023-08-29 14:32:14,1225408864,0,0,6,3,0,6
3438,162847.0,2023-08-29 14:40:23,1225412005,179547,266,88,53,17,71
3444,162850.0,2023-08-29 15:02:43,1225421657,0,0,5,2,0,5
3445,109663.0,2023-08-29 15:05:56,1225423096,255,2,29,10,1,28
3446,107683.0,2023-08-29 15:06:27,1225423333,16925,73,70,44,5,65
3449,162851.0,2023-08-29 15:07:27,1225423816,0,45,41,10,0,41
3451,162852.0,2023-08-29 15:15:40,1225428090,8504,36,41,28,4,37
3454,153018.0,2023-08-29 15:20:18,1225430575,552,1,3,0,1,2
3455,153001.0,2023-08-29 15:20:47,1225430847,10385,172,43,14,4,39
3457,153000.0,2023-08-29 15:22:09,1225431584,0,0,1,0,0,1
3458,152960.0,2023-08-29 15:22:47,1225431929,9180,118,28,2,2,26
3459,152069.0,2023-08-29 15:23:13,1225432138,6201,18,48,23,2,46
3460,162856.0,2023-08-29 15:30:47,1225436412,135089,299,57,15,17,40
3467,153544.0,2023-08-29 15:35:50,1225439582,69338,77,119,48,6,113
3468,153516.0,2023-08-29 15:36:24,1225439942,28848,84,129,70,4,125
3469,153584.0,2023-08-29 15:37:02,1225440297,19359,21,117,54,3,114
3470,162859.0,2023-08-29 15:37:14,1225440464,44097,42,18,15,4,14
3471,153545.0,2023-08-29 15:37:31,1225440597,1431,57,423,96,2,421
3472,153518.0,2023-08-29 15:38:48,1225441460,63897,76,80,46,5,75
3475,162855.0,2023-08-29 15:50:31,1225449051,58072,344,48,27,14,34
3479,162886.0,2023-08-29 16:07:54,1225460912,5151,160,4,2,3,1
3480,162863.0,2023-08-29 16:08:04,1225461038,6075,12,2,1,1,1
3482,162857.0,2023-08-29 16:08:19,1225461199,51215,121,45,23,4,41
3483,162774.0,2023-08-29 16:08:26,1225461276,13730,47,62,52,1,61
3485,162772.0,2023-08-29 16:09:01,1225461637,0,0,1,0,0,1
3489,127503.0,2023-08-29 16:52:56,1225496737,34783,46,45,19,5,40
3492,162907.0,2023-08-29 17:02:30,1225504376,1409,26,30,10,1,29
3500,118319.0,2023-08-29 17:24:36,1225522828,20799,15,22,17,2,20
3501,118335.0,2023-08-29 17:24:50,1225523027,31201,18,28,24,2,26
3502,118338.0,2023-08-29 17:25:17,1225523422,63447,87,48,27,6,42
3503,115667.0,2023-08-29 17:25:34,1225523684,39598,39,40,28,2,38
3504,129517.0,2023-08-29 17:25:49,1225523907,0,0,27,22,0,27
3506,151137.0,2023-08-29 17:26:04,1225524134,0,0,1,0,0,1
3509,151532.0,2023-08-29 17:27:39,1225525505,4444,4,46,27,1,45
3510,151557.0,2023-08-29 17:27:55,1225525724,6769,35,34,3,2,32
3511,151530.0,2023-08-29 17:28:10,1225525924,5647,6,6,1,1,5
3512,151575.0,2023-08-29 17:28:27,1225526137,149129,46,23,16,2,21
3515,142820.0,2023-08-29 19:16:17,1225618766,14404,55,76,47,6,70
3517,65981.0,2023-08-29 19:43:02,1225640832,111073,183,109,65,9,100
3518,162939.0,2023-08-29 19:47:24,1225644531,51598,85,46,25,11,35
3528,162940.0,2023-08-29 19:51:22,1225647959,10865,46,23,9,4,19
3541,136403.0,2023-08-29 22:11:47,1225756229,13205,24,46,30,2,44
3542,130993.0,2023-08-29 22:12:50,1225756962,22114,135,71,44,4,67
3543,151186.0,2023-08-29 22:13:15,1225757326,6770,35,28,9,1,27
3555,163027.0,2023-08-30 14:19:47,1226041312,0,0,23,15,0,23
3558,163038.0,2023-08-30 14:53:06,1226053454,1380,24,4,2,1,3
3561,123634.0,2023-08-30 15:15:35,1226064391,24049,139,23,16,4,19
3562,123916.0,2023-08-30 15:16:20,1226064802,9136,48,38,31,3,35
3563,123639.0,2023-08-30 15:16:47,1226065048,11932,68,43,22,4,39
3564,124208.0,2023-08-30 15:17:09,1226065264,11875,83,34,14,5,29
3565,123917.0,2023-08-30 15:17:30,1226065476,30401,80,21,12,2,19
3566,151750.0,2023-08-30 15:18:02,1226065783,1154,22,33,26,1,32
3568,143674.0,2023-08-30 17:06:54,1226168810,13506,31,72,64,3,69
3569,141242.0,2023-08-30 17:08:03,1226170107,25553,141,76,21,7,69
3570,143162.0,2023-08-30 17:08:38,1226170767,21147,41,21,17,2,19
3571,143164.0,2023-08-30 17:09:18,1226171527,18238,86,35,29,4,31
3578,141986.0,2023-08-30 17:11:22,1226174012,529,2,20,12,1,19
3582,163071.0,2023-08-30 17:24:58,1226189941,18762,79,21,13,6,15
3584,151439.0,2023-08-30 17:39:40,1226207307,4009,18,15,2,2,13
3585,151437.0,2023-08-30 17:39:55,1226207598,52548,54,71,27,2,69
3586,151431.0,2023-08-30 17:40:08,1226207871,42425,24,20,17,1,19
3587,151435.0,2023-08-30 17:40:32,1226208318,56429,61,48,26,3,45
3588,151441.0,2023-08-30 17:40:48,1226208630,17608,18,11,7,4,7
3589,151433.0,2023-08-30 17:41:05,1226208993,0,0,3,0,0,3
3592,163094.0,2023-08-30 18:03:16,1226235005,0,37,13,0,0,13
3593,163099.0,2023-08-30 18:24:24,1226259968,31386,91,163,60,3,160
3594,163109.0,2023-08-30 18:45:32,1226285361,0,7,10,3,0,10
3595,163133.0,2023-08-30 20:00:12,1226370374,27678,167,10,2,4,6
3613,163185.0,2023-08-30 22:38:29,1226558144,0,0,1,0,0,1
3614,163176.0,2023-08-30 22:46:57,1226567700,507,156,8,2,1,7
3620,152624.0,2023-08-30 23:11:19,1226594474,0,0,2,0,0,2
3621,152794.0,2023-08-30 23:11:41,1226594836,4190,52,69,40,3,66
3622,153392.0,2023-08-30 23:12:02,1226595251,12041,21,54,1,4,50
3623,152567.0,2023-08-30 23:12:20,1226595585,10762,44,23,13,2,21
3624,152908.0,2023-08-30 23:12:34,1226595830,6960,8,2,1,1,1
3625,152941.0,2023-08-30 23:12:47,1226596048,0,6,12,1,0,12
3634,163250.0,2023-08-31 15:20:02,1227023491,65624,174,87,64,5,82
3639,132927.0,2023-08-31 15:35:04,1227059895,5578,8,8,3,1,7
3640,163252.0,2023-08-31 15:40:19,1227073172,1811,71,26,3,7,19
3645,163255.0,2023-08-31 15:57:42,1227106717,18383,41,80,38,2,78
3646,163256.0,2023-08-31 16:00:17,1227109280,2515,32,9,5,2,7
3647,163261.0,2023-08-31 16:06:06,1227115002,55327,99,121,37,18,103
3648,163269.0,2023-08-31 16:51:42,1227159403,6491,33,61,33,3,58
3650,96699.0,2023-08-31 17:35:13,1227193525,9307,234,44,13,6,38
3652,132929.0,2023-08-31 19:35:55,1227537642,22513,101,33,9,13,20
3653,132925.0,2023-08-31 19:45:43,1227564360,9564,106,48,12,2,46
3654,127161.0,2023-08-31 19:53:34,1227573539,39877,35,23,14,3,20
3655,126969.0,2023-08-31 19:53:58,1227573921,16792,68,18,14,5,13
3656,126967.0,2023-08-31 19:54:17,1227574289,0,10,14,11,0,14
3657,137424.0,2023-08-31 19:54:32,1227574547,53453,67,31,14,8,23
3658,126970.0,2023-08-31 19:54:50,1227574792,13687,17,21,16,2,19
3661,142152.0,2023-08-31 20:03:16,1227582825,8044,1,34,11,1,33
3662,132971.0,2023-08-31 20:10:29,1227588930,12688,37,20,17,3,17
3663,134637.0,2023-08-31 20:13:12,1227591029,12282,37,46,37,2,44
3667,163381.0,2023-09-01 00:41:54,1227772678,25377,216,50,30,6,44
3672,163422.0,2023-09-01 15:18:50,1227998182,17239,31,7,2,3,4
3674,163438.0,2023-09-01 16:56:57,1228062011,0,0,26,11,0,26
3677,163450.0,2023-09-01 18:19:44,1228126122,5333,3,3,2,1,2
3679,163452.0,2023-09-01 18:30:49,1228134544,16632,72,29,17,3,26
3683,163468.0,2023-09-01 21:48:11,1228305376,7680,12,12,11,1,11
3686,112831.0,2023-09-02 14:42:26,1228791782,23503,50,59,14,2,57
3687,112832.0,2023-09-02 14:44:09,1228792498,59114,85,92,16,4,88
3688,112823.0,2023-09-02 14:45:25,1228792987,45301,93,29,10,9,20
3689,112834.0,2023-09-02 14:46:18,1228793302,26018,162,45,10,16,29
3694,163491.0,2023-09-02 15:20:38,1228807629,11136,56,8,4,3,5
3696,163489.0,2023-09-02 15:21:22,1228808025,18123,13,31,11,4,27
3697,163488.0,2023-09-02 15:21:38,1228808147,2990,9,31,10,1,30
3698,163486.0,2023-09-02 15:21:54,1228808271,0,0,5,2,0,5
3700,112833.0,2023-09-02 16:42:48,1228852561,118332,251,134,40,15,119
3705,163454.0,2023-09-04 15:01:52,1230044753,34737,46,3,1,3,0
3712,163540.0,2023-09-04 16:45:02,1230111497,9456,62,18,6,1,17
3715,127136.0,2023-09-04 17:07:54,1230130255,64300,36,58,20,4,54
3718,151755.0,2023-09-04 17:26:53,1230146597,4579,8,15,5,2,13
3720,151757.0,2023-09-04 17:27:09,1230146976,1482,5,5,2,1,4
3721,151756.0,2023-09-04 17:27:25,1230147227,42679,34,44,31,2,42
3723,152636.0,2023-09-04 17:27:44,1230147455,173,16,32,6,2,30
3725,152210.0,2023-09-04 17:28:09,1230147832,0,1,59,39,0,59
3727,152212.0,2023-09-04 17:28:33,1230148158,0,0,16,7,0,16
3729,152258.0,2023-09-04 17:33:18,1230152474,7280,77,20,12,2,18
3732,152267.0,2023-09-04 19:21:38,1230242110,0,0,10,4,0,10
3734,163573.0,2023-09-04 20:48:58,1230330519,8800,43,25,15,1,24
3735,163577.0,2023-09-04 21:04:44,1230346305,0,14,36,23,0,36
3736,163579.0,2023-09-04 21:10:01,1230352472,1879,6,6,3,1,5
3738,163588.0,2023-09-04 21:17:43,1230361453,62267,111,156,32,7,149
3741,163592.0,2023-09-04 21:42:23,1230392947,0,167,57,28,0,57
3744,163594.0,2023-09-04 21:47:01,1230401037,1345,53,66,32,4,62
3746,163596.0,2023-09-04 21:54:26,1230414316,12006,187,57,32,2,55
3751,163604.0,2023-09-04 22:36:34,1230460758,102874,134,37,14,7,30
3752,163609.0,2023-09-04 23:03:47,1230482376,9590,42,2,0,2,0
3754,163611.0,2023-09-04 23:21:48,1230496059,209724,239,81,41,11,70
3755,163615.0,2023-09-04 23:35:51,1230509781,177912,24,76,29,2,74
3756,163617.0,2023-09-04 23:44:51,1230521256,20365,73,52,21,1,51
3757,163619.0,2023-09-04 23:53:18,1230532373,164754,44,345,82,4,341
3758,163620.0,2023-09-05 00:00:25,1230539878,91168,221,83,29,12,71
3761,163632.0,2023-09-05 15:31:02,1230820908,12229,203,18,3,9,9
3768,163645.0,2023-09-05 15:57:53,1230838860,5754,35,29,15,2,27
3769,131815.0,2023-09-05 16:10:53,1230847619,2559,13,25,11,3,22
3770,131638.0,2023-09-05 16:20:38,1230854692,17814,34,26,24,4,22
3771,131629.0,2023-09-05 16:24:03,1230857180,12624,96,8,7,3,5
3773,131599.0,2023-09-05 16:35:57,1230866618,5552,8,4,3,1,3
3782,128686.0,2023-09-05 17:19:01,1230903580,8679,70,37,22,4,33
3784,163670.0,2023-09-05 17:38:12,1230921060,1378,11,8,8,1,7
3785,163668.0,2023-09-05 17:38:37,1230921397,40489,65,27,5,5,22
3787,132076.0,2023-09-05 17:55:42,1230937202,1697,46,40,16,1,39
3788,132075.0,2023-09-05 17:56:10,1230937637,37077,46,51,27,2,49
3789,143333.0,2023-09-05 17:56:43,1230938089,14220,150,34,14,1,33
3794,142825.0,2023-09-05 18:48:41,1230986059,392,4,9,1,3,6
3795,142107.0,2023-09-05 18:49:11,1230986721,0,0,15,3,0,15
3796,142085.0,2023-09-05 18:49:30,1230987159,54775,63,74,44,2,72
3797,142164.0,2023-09-05 18:49:48,1230987629,11747,18,35,27,2,33
3798,142212.0,2023-09-05 18:50:12,1230988083,79024,130,60,47,6,54
3799,142213.0,2023-09-05 18:50:32,1230988581,71100,123,67,36,3,64
3800,142186.0,2023-09-05 18:50:58,1230989179,14081,75,26,13,2,24
3801,142184.0,2023-09-05 18:51:13,1230989637,2076,160,28,16,2,26
3803,129903.0,2023-09-05 19:46:02,1231052568,4906,3,11,3,1,10
3804,163689.0,2023-09-05 19:50:57,1231056791,0,0,1,0,0,1
3805,153857.0,2023-09-05 20:21:56,1231085438,31113,108,58,42,3,55
3806,100282.0,2023-09-05 20:22:12,1231085683,29815,163,71,48,6,65
3807,121856.0,2023-09-05 20:22:37,1231086055,17686,48,86,63,5,81
3808,153795.0,2023-09-05 20:23:01,1231086355,5765,8,16,8,1,15
3809,163692.0,2023-09-05 20:32:25,1231095066,101572,98,80,50,7,73
3814,163697.0,2023-09-05 20:45:57,1231106672,2990,8,12,11,1,11
3830,163725.0,2023-09-05 21:43:10,1231158668,57834,223,42,26,4,38
3837,163754.0,2023-09-06 15:16:01,1231499925,180858,242,31,24,5,26
3842,163758.0,2023-09-06 15:48:14,1231520441,3423,65,24,6,1,23
3845,131633.0,2023-09-06 16:10:35,1231536292,7342,39,19,16,2,17
3848,132482.0,2023-09-06 16:28:14,1231550428,43032,50,91,64,5,86
3851,152138.0,2023-09-06 16:45:25,1231564722,815,86,11,0,2,9
3852,152134.0,2023-09-06 16:45:53,1231565135,3426,70,11,0,3,8
3854,151961.0,2023-09-06 16:46:46,1231565859,10064,342,29,17,1,28
3856,151937.0,2023-09-06 16:47:34,1231566520,381,47,23,13,3,20
3858,163777.0,2023-09-06 17:01:12,1231578062,0,9,30,18,0,30
3868,163765.0,2023-09-06 17:38:31,1231614824,43706,19,71,18,3,68
3869,163778.0,2023-09-06 17:41:01,1231617353,108955,380,127,57,6,121
3883,142223.0,2023-09-06 19:19:07,1231714655,2659,36,13,4,2,11
3885,142221.0,2023-09-06 19:20:44,1231716182,150,60,86,31,1,85
3886,142313.0,2023-09-06 19:21:19,1231716704,3636,31,13,6,3,10
3887,141647.0,2023-09-06 19:21:47,1231717191,46436,274,39,24,7,32
3888,141638.0,2023-09-06 19:22:19,1231717736,10373,48,42,32,3,39
3893,131872.0,2023-09-06 19:39:00,1231733308,22380,64,52,35,6,46
3894,163816.0,2023-09-06 20:08:02,1231760428,60418,104,103,14,8,95
3895,163817.0,2023-09-06 20:15:26,1231767089,0,20,22,18,0,22
3899,131874.0,2023-09-06 20:33:15,1231783035,14607,17,38,17,1,37
3900,131870.0,2023-09-06 20:33:46,1231783440,40209,304,69,32,6,63
3901,131873.0,2023-09-06 20:34:09,1231783797,10134,27,110,72,3,107
3903,152778.0,2023-09-06 20:34:50,1231784376,8027,138,25,10,4,21
3904,163822.0,2023-09-06 20:35:39,1231785079,2320,18,36,31,1,35
3907,163825.0,2023-09-06 20:41:21,1231790241,0,19,4,2,0,4
3908,163826.0,2023-09-06 20:46:21,1231794588,4998,42,9,3,4,5
3914,163827.0,2023-09-06 21:59:03,1231851274,5950,84,14,7,2,12
3915,163821.0,2023-09-06 22:00:21,1231852431,47384,103,21,11,3,18
3918,163850.0,2023-09-06 23:11:21,1231919059,36389,34,51,37,5,46
3919,163853.0,2023-09-06 23:30:59,1231940620,205405,420,76,45,16,60
3920,131614.0,2023-09-07 15:28:05,1232246267,3571,7,12,5,1,11
3921,134085.0,2023-09-07 16:10:44,1232275493,36698,64,23,17,4,19
3922,134083.0,2023-09-07 16:11:44,1232276125,11269,38,55,42,3,52
3923,134086.0,2023-09-07 16:12:32,1232276761,0,169,89,43,0,89
3924,134089.0,2023-09-07 16:14:04,1232277919,0,20,28,22,0,28
3925,163866.0,2023-09-07 16:16:11,1232279502,3918,6,16,10,1,15
3926,163868.0,2023-09-07 16:19:13,1232281782,21562,65,29,9,3,26
3929,134172.0,2023-09-07 16:29:58,1232289619,4364,20,74,35,1,73
3931,163870.0,2023-09-07 16:33:06,1232292820,0,5,15,12,0,15
3932,153431.0,2023-09-07 16:47:11,1232304372,0,0,5,2,0,5
3933,153343.0,2023-09-07 16:47:33,1232304650,13378,11,15,9,2,13
3934,153323.0,2023-09-07 16:47:48,1232304868,14246,14,9,8,2,7
3935,153565.0,2023-09-07 16:48:01,1232305062,0,0,14,3,0,14
3936,153320.0,2023-09-07 16:48:18,1232305249,34674,145,107,75,5,102
3937,163871.0,2023-09-07 16:56:12,1232311421,31430,11,24,14,2,22
3938,163874.0,2023-09-07 16:59:34,1232314094,20673,84,71,22,13,58
3942,153564.0,2023-09-07 17:14:02,1232326015,11138,10,9,7,2,7
3947,163884.0,2023-09-07 18:48:16,1232406272,44966,55,25,16,6,19
3949,163887.0,2023-09-07 18:48:32,1232406509,104479,172,102,64,6,96
3951,163892.0,2023-09-07 18:48:53,1232406753,2424,14,106,60,1,105
3952,163899.0,2023-09-07 18:49:10,1232407026,7103,9,42,22,4,38
3953,163903.0,2023-09-07 18:57:15,1232414194,9939,156,71,4,2,69
3954,163880.0,2023-09-07 19:28:07,1232440727,11958,25,34,23,6,28
3955,163906.0,2023-09-07 19:43:51,1232453524,2164,5,1,0,1,0
3957,163907.0,2023-09-07 19:48:37,1232457970,17901,99,44,18,3,41
3959,163923.0,2023-09-07 20:29:30,1232491578,8771,31,10,5,3,7
3960,163925.0,2023-09-07 20:45:37,1232503962,4950,32,2,1,1,1
3963,163926.0,2023-09-07 22:45:20,1232593200,10372,22,20,8,2,18
3965,119486.0,2023-09-07 23:09:21,1232610020,142104,45,17,8,4,13
3966,163967.0,2023-09-08 15:53:53,1232945786,3759,41,28,7,2,26
3967,163968.0,2023-09-08 16:03:44,1232951452,7145,18,10,6,3,7
3969,163970.0,2023-09-08 16:13:55,1232957717,5536,26,3,3,2,1
3970,163971.0,2023-09-08 16:21:50,1232962403,1545,10,7,5,1,6
3972,163983.0,2023-09-08 16:40:22,1232974694,8263,23,22,15,3,19
3974,122326.0,2023-09-08 16:41:21,1232975343,0,45,55,36,0,55
3976,122319.0,2023-09-08 16:41:43,1232975597,70719,60,40,22,5,35
3977,153704.0,2023-09-08 16:42:29,1232976092,27838,246,39,29,2,37
3978,122321.0,2023-09-08 16:43:15,1232976643,26168,257,18,5,5,13
3979,143048.0,2023-09-08 16:44:20,1232977448,23087,216,53,28,5,48
3980,153705.0,2023-09-08 16:45:00,1232977886,0,5,9,4,0,9
3981,122320.0,2023-09-08 16:45:35,1232978270,0,3,30,27,0,30
3986,163998.0,2023-09-08 17:16:36,1233003733,18800,57,14,8,6,8
3997,133690.0,2023-09-08 19:11:55,1233109826,600,14,25,16,1,24
3998,133711.0,2023-09-08 19:25:05,1233121027,0,3,50,32,0,50
3999,133712.0,2023-09-08 19:31:05,1233126154,5272,10,37,17,1,36
4003,153328.0,2023-09-08 21:14:27,1233220469,44112,59,38,22,1,37
4004,153014.0,2023-09-08 21:14:56,1233220829,14328,69,45,26,1,44
4005,153433.0,2023-09-08 21:15:22,1233221178,0,0,2,0,0,2
4006,153034.0,2023-09-08 21:15:45,1233221449,0,0,44,30,0,44
4007,153019.0,2023-09-08 21:16:15,1233221867,3571,30,4,1,2,2
4008,153016.0,2023-09-08 21:16:39,1233222141,15204,48,29,16,2,27
4009,153449.0,2023-09-08 21:17:15,1233222594,44783,69,11,5,5,6
4010,143582.0,2023-09-08 21:17:38,1233222859,473,3,16,8,1,15
4011,153023.0,2023-09-08 21:17:42,1233222903,16897,3,45,35,2,43
4012,143575.0,2023-09-08 21:18:56,1233223773,302585,13,79,9,2,77
4013,143495.0,2023-09-08 21:19:43,1233224368,16283,102,82,31,8,74
4014,143591.0,2023-09-08 21:20:29,1233224957,123453,285,72,21,19,53
4015,143597.0,2023-09-08 21:21:05,1233225418,26142,112,51,24,8,43
4017,143657.0,2023-09-08 21:22:24,1233226478,13929,63,52,11,4,48
4018,142478.0,2023-09-08 21:24:10,1233227817,0,48,17,7,0,17
4019,142480.0,2023-09-08 21:24:46,1233228267,1750,1,6,3,1,5
4020,142481.0,2023-09-08 21:25:22,1233228849,130346,293,56,37,12,44
4021,142471.0,2023-09-08 21:25:54,1233229274,0,3,37,11,0,37
4023,133723.0,2023-09-08 21:37:57,1233237729,0,0,27,19,0,27
4024,164040.0,2023-09-08 21:47:29,1233244907,4106,5,27,24,1,26
4025,111285.0,2023-09-08 22:48:50,1233288475,0,7,6,5,0,6
4026,111165.0,2023-09-08 22:49:19,1233288810,0,11,7,6,0,7
4027,111159.0,2023-09-08 22:49:39,1233289102,14804,217,16,8,4,12
4028,121000.0,2023-09-08 22:50:05,1233289431,28176,142,17,9,6,11
4029,134556.0,2023-09-08 22:50:25,1233289660,19412,108,37,13,4,33
4030,143666.0,2023-09-08 22:50:47,1233289909,5203,37,11,7,2,9
4031,153855.0,2023-09-08 22:51:08,1233290144,13254,24,3,2,1,2
4033,164058.0,2023-09-09 15:04:57,1233837779,30328,51,56,27,3,53
4035,164025.0,2023-09-09 15:29:52,1233850658,3721,25,5,2,1,4
4036,153097.0,2023-09-09 15:32:40,1233851734,20801,24,45,14,1,44
4037,154383.0,2023-09-09 16:31:20,1233877083,0,0,1,0,0,1
4038,132077.0,2023-09-09 16:42:19,1233882591,74898,76,49,39,6,43
4039,164071.0,2023-09-09 17:24:31,1233904301,0,31,17,6,0,17
4040,164072.0,2023-09-09 17:29:43,1233907075,19367,44,16,2,4,12
4044,154104.0,2023-09-11 15:21:23,1234729230,97600,217,29,14,10,19
4045,154101.0,2023-09-11 15:21:38,1234729390,25556,76,70,38,4,66
4046,154110.0,2023-09-11 15:22:22,1234729827,31673,36,63,49,4,59
4047,154098.0,2023-09-11 15:22:24,1234729841,10282,48,45,15,2,43
4048,154102.0,2023-09-11 15:22:26,1234729869,167289,320,49,33,5,44
4049,154107.0,2023-09-11 15:22:29,1234729890,47792,72,74,57,4,70
4051,101448.0,2023-09-12 17:21:27,1235532198,7899,219,100,35,2,98
4053,164160.0,2023-09-12 17:25:45,1235535873,5544,109,177,9,1,176
4054,90682.0,2023-09-12 17:25:48,1235535942,94141,135,40,13,8,32
4055,164175.0,2023-09-12 17:26:01,1235536109,9289,32,34,26,1,33
4056,91038.0,2023-09-12 17:28:32,1235538283,79500,196,80,44,8,72
4057,90880.0,2023-09-12 17:30:09,1235539671,19087,314,167,64,6,161
4058,153307.0,2023-09-12 17:46:04,1235553713,0,0,1,0,0,1
4059,153279.0,2023-09-12 17:46:33,1235554191,22055,54,16,8,5,11
4060,153147.0,2023-09-12 17:46:55,1235554533,9173,8,13,4,3,10
4061,152850.0,2023-09-12 17:47:25,1235554977,33792,68,93,66,5,88
4062,152849.0,2023-09-12 17:47:56,1235555459,47879,241,336,41,8,328
4072,154074.0,2023-09-12 18:15:30,1235581574,0,2,21,14,0,21
4073,164118.0,2023-09-12 18:20:27,1235586141,56272,153,62,8,7,55
4076,90746.0,2023-09-12 18:23:48,1235589380,15357,161,23,2,7,16
4077,91034.0,2023-09-12 18:25:19,1235590784,43795,45,38,21,3,35
4081,164197.0,2023-09-12 18:45:45,1235610137,5775,62,13,6,4,9
4082,91342.0,2023-09-12 18:52:25,1235616538,938,15,23,11,1,22
4084,164213.0,2023-09-12 19:17:24,1235639821,2426,32,25,14,1,24
4085,164212.0,2023-09-12 19:17:42,1235640089,6970,38,8,2,3,5
4087,164202.0,2023-09-12 19:18:17,1235640590,771,7,23,15,3,20
4090,164227.0,2023-09-12 20:43:33,1235719035,0,0,11,9,0,11
4092,164230.0,2023-09-12 20:45:35,1235720820,39043,27,22,15,2,20
4093,164231.0,2023-09-12 20:52:15,1235726687,30905,23,18,12,1,17
4096,164119.0,2023-09-12 21:33:27,1235761008,17427,35,12,6,4,8
4097,164239.0,2023-09-12 21:40:13,1235766696,44,247,18,9,1,17
4099,164242.0,2023-09-12 22:27:36,1235804233,167559,145,57,19,15,42
4103,164268.0,2023-09-13 00:02:41,1235875438,8985,47,21,9,3,18
4104,133719.0,2023-09-13 15:04:26,1236104129,16858,158,37,32,4,33
4105,100279.0,2023-09-13 15:04:54,1236104350,23800,78,33,26,5,28
4108,133691.0,2023-09-13 15:14:20,1236108837,17300,19,30,25,2,28
4110,133717.0,2023-09-13 15:18:48,1236111121,3583,45,56,37,3,53
4112,133885.0,2023-09-13 15:49:23,1236130266,47989,93,30,18,3,27
4113,143334.0,2023-09-13 16:01:29,1236138093,57838,62,8,6,2,6
4114,133888.0,2023-09-13 16:02:00,1236138385,4083,102,52,40,2,50
4116,120977.0,2023-09-13 16:10:40,1236144325,77416,130,18,13,5,13
4117,120985.0,2023-09-13 16:11:11,1236144729,85436,174,40,25,4,36
4118,120984.0,2023-09-13 16:11:45,1236145093,54252,169,94,73,12,82
4119,143697.0,2023-09-13 16:11:56,1236145230,52825,134,72,24,7,65
4120,120982.0,2023-09-13 16:12:18,1236145493,1468,8,48,15,1,47
4121,142844.0,2023-09-13 16:13:00,1236145930,24369,147,28,20,4,24
4123,133887.0,2023-09-13 16:16:29,1236148468,0,1,10,4,0,10
4124,142761.0,2023-09-13 16:55:52,1236179273,0,1,44,20,0,44
4125,142759.0,2023-09-13 16:56:13,1236179695,31729,131,51,31,3,48
4126,142763.0,2023-09-13 16:58:49,1236181861,10515,8,37,30,1,36
4127,142762.0,2023-09-13 16:59:10,1236182131,90424,188,35,23,9,26
4129,142766.0,2023-09-13 17:00:00,1236182846,0,0,4,1,0,4
4131,134434.0,2023-09-13 17:03:23,1236185675,32530,19,83,75,3,80
4132,134693.0,2023-09-13 17:03:49,1236185960,1769,14,53,26,1,52
4133,134673.0,2023-09-13 17:04:15,1236186356,11948,102,59,13,2,57
4134,145195.0,2023-09-13 17:05:53,1236187617,33970,21,38,30,1,37
4140,154439.0,2023-09-13 17:28:18,1236206454,16292,119,53,35,7,46
4141,154438.0,2023-09-13 17:28:33,1236206682,27693,118,24,14,6,18
4142,154436.0,2023-09-13 17:29:04,1236207117,4529,50,80,42,2,78
4143,154435.0,2023-09-13 17:29:31,1236207510,6818,12,7,2,2,5
4144,154437.0,2023-09-13 18:24:04,1236254208,3230,234,113,47,5,108
4145,142277.0,2023-09-13 18:44:04,1236271879,7204,33,36,10,2,34
4146,142461.0,2023-09-13 18:44:59,1236272647,3243,19,27,21,1,26
4147,142278.0,2023-09-13 18:45:49,1236273349,13939,52,18,14,2,16
4148,142251.0,2023-09-13 18:47:39,1236274906,1501,28,12,3,2,10
4149,142578.0,2023-09-13 18:49:36,1236276643,19632,170,104,63,8,96
4150,142587.0,2023-09-13 18:50:21,1236277292,33734,102,150,63,11,139
4151,142550.0,2023-09-13 18:51:07,1236277962,6225,43,14,8,1,13
4152,143200.0,2023-09-13 18:52:03,1236278842,0,0,22,12,0,22
4153,143205.0,2023-09-13 18:52:45,1236279478,0,0,9,7,0,9
4154,142546.0,2023-09-13 18:53:33,1236280252,17019,43,62,44,2,60
4155,142864.0,2023-09-13 18:54:20,1236280930,0,10,66,34,0,66
4156,154669.0,2023-09-13 18:57:18,1236283439,0,22,14,5,0,14
4157,155116.0,2023-09-13 18:58:01,1236284042,351,31,78,53,1,77
4158,154794.0,2023-09-13 18:58:54,1236284840,27456,124,17,7,8,9
4159,154795.0,2023-09-13 19:03:17,1236288555,9228,175,32,7,4,28
4160,164317.0,2023-09-13 19:14:28,1236298005,9196,58,10,5,6,4
4167,164376.0,2023-09-13 23:27:04,1236498824,1038,12,14,6,1,13
4168,164375.0,2023-09-13 23:27:29,1236499178,5131,25,63,42,2,61
4169,164373.0,2023-09-13 23:27:53,1236499546,46462,128,50,27,3,47
4171,164406.0,2023-09-14 14:55:25,1236776443,10649,53,63,38,2,61
4178,164411.0,2023-09-14 15:50:11,1236806133,0,0,1,0,0,1
4179,164414.0,2023-09-14 15:50:27,1236806298,3109,48,45,14,2,43
4181,153722.0,2023-09-14 15:55:34,1236809513,146868,142,25,15,6,19
4183,153727.0,2023-09-14 15:56:08,1236809879,24772,71,53,21,5,48
4185,153731.0,2023-09-14 15:56:28,1236810170,4429,141,37,5,17,20
4186,153774.0,2023-09-14 15:56:46,1236810389,60372,209,60,26,5,55
4187,153777.0,2023-09-14 15:57:15,1236810730,2042,32,26,14,2,24
4188,141700.0,2023-09-14 16:26:42,1236831758,16353,31,92,18,3,89
4189,152110.0,2023-09-14 16:27:15,1236832202,1704,6,14,5,1,13
4190,133683.0,2023-09-14 17:36:24,1236887626,41879,93,57,45,2,55
4192,142329.0,2023-09-14 17:56:29,1236903616,25835,41,25,21,5,20
4193,142330.0,2023-09-14 17:56:53,1236903974,16551,70,8,5,5,3
4194,142894.0,2023-09-14 17:57:11,1236904187,39506,110,22,14,6,16
4195,142896.0,2023-09-14 17:57:29,1236904394,22801,44,31,21,5,26
4196,142898.0,2023-09-14 17:57:46,1236904642,1194,6,10,3,1,9
4197,142945.0,2023-09-14 17:58:05,1236904947,1194,5,2,0,1,1
4199,142484.0,2023-09-14 18:14:55,1236918693,85929,175,196,72,6,190
4202,86322.0,2023-09-14 20:20:37,1237020495,23799,31,98,31,3,95
4203,100394.0,2023-09-14 20:21:18,1237021033,20163,209,60,37,10,50
4204,87006.0,2023-09-14 20:22:11,1237021746,30724,71,64,52,5,59
4205,86345.0,2023-09-14 20:22:53,1237022303,9782,49,34,27,3,31
4206,87007.0,2023-09-14 20:23:35,1237022823,5739,24,32,23,1,31
4208,164485.0,2023-09-14 22:26:00,1237112731,60184,50,34,26,2,32
4223,164507.0,2023-09-15 15:52:29,1237817577,14442,172,42,20,4,38
4225,164508.0,2023-09-15 15:52:52,1237817830,4464,61,101,72,4,97
4227,164517.0,2023-09-15 15:53:13,1237818067,0,0,8,6,0,8
4234,164524.0,2023-09-15 16:22:28,1237836933,12804,27,9,2,2,7
4240,117220.0,2023-09-15 16:43:41,1237851256,176,14,52,25,2,50
4241,117216.0,2023-09-15 16:44:01,1237851488,88732,152,102,51,7,95
4242,117214.0,2023-09-15 16:44:21,1237851730,8679,3,50,44,1,49
4243,117222.0,2023-09-15 16:44:41,1237852015,36579,89,62,41,4,58
4244,117206.0,2023-09-15 16:44:59,1237852218,8436,98,29,14,5,24
4245,117223.0,2023-09-15 16:45:54,1237852881,97569,88,88,52,5,83
4246,164540.0,2023-09-15 17:05:19,1237866596,0,9,122,72,0,122
4247,151802.0,2023-09-15 17:08:32,1237868898,8103,39,28,12,2,26
4248,117217.0,2023-09-15 17:18:34,1237876199,98531,114,81,33,12,69
4251,164566.0,2023-09-15 19:44:00,1237984210,1017,18,2,0,1,1
4254,164619.0,2023-09-18 15:33:57,1239272602,58294,50,10,7,3,7
4259,164567.0,2023-09-18 16:08:56,1239315972,267,147,43,23,2,41
4262,164571.0,2023-09-18 16:09:48,1239316960,47322,144,27,15,7,20
4263,164572.0,2023-09-18 16:10:14,1239317534,47095,204,49,30,5,44
4264,164573.0,2023-09-18 16:11:04,1239318653,0,0,4,3,0,4
4266,164614.0,2023-09-18 16:12:31,1239320468,36469,586,101,37,6,95
4269,164632.0,2023-09-18 16:28:15,1239337681,33662,121,25,18,7,18
4270,164635.0,2023-09-18 16:28:32,1239337926,168613,146,33,25,6,27
4284,164648.0,2023-09-18 18:17:29,1239454577,0,0,3,2,0,3
4286,164650.0,2023-09-18 18:21:19,1239458001,4071,13,174,2,1,173
4294,164666.0,2023-09-18 19:34:04,1239521959,0,0,10,6,0,10
4299,164679.0,2023-09-18 21:46:52,1239641368,0,0,11,0,0,11
4300,164701.0,2023-09-18 22:59:39,1239702611,16400,33,10,5,3,7
4302,142542.0,2023-09-19 14:23:46,1239968368,0,0,3,2,0,3
4303,142817.0,2023-09-19 14:24:34,1239968670,24380,189,104,63,3,101
4304,142891.0,2023-09-19 14:25:15,1239968919,0,8,16,14,0,16
4305,142539.0,2023-09-19 14:25:55,1239969126,52120,87,55,42,4,51
4306,154485.0,2023-09-19 14:26:47,1239969432,18596,216,90,44,6,84
4307,143554.0,2023-09-19 14:59:22,1239983580,47709,204,97,57,11,86
4311,133685.0,2023-09-19 15:45:17,1240011480,0,3,31,26,0,31
4312,134186.0,2023-09-19 15:49:38,1240014521,44,37,76,34,1,75
4315,164749.0,2023-09-19 17:07:50,1240078119,4030,324,55,33,2,53
4316,164751.0,2023-09-19 17:14:19,1240083681,28863,111,29,22,3,26
4317,164752.0,2023-09-19 17:20:16,1240088941,13994,77,21,13,4,17
4319,164754.0,2023-09-19 17:26:01,1240094245,37963,100,42,24,5,37
4320,164755.0,2023-09-19 17:31:58,1240099605,7700,11,26,19,1,25
4321,164757.0,2023-09-19 17:37:54,1240104780,6664,108,32,26,3,29
4323,164759.0,2023-09-19 17:52:16,1240118817,0,0,6,4,0,6
4325,155073.0,2023-09-19 18:18:08,1240143370,907,3,50,31,1,49
4326,143524.0,2023-09-19 18:18:35,1240143818,1529,10,72,66,2,70
4327,143003.0,2023-09-19 18:18:59,1240144210,76247,18,26,16,3,23
4328,143567.0,2023-09-19 18:19:15,1240144493,32519,93,49,41,4,45
4329,143510.0,2023-09-19 18:19:37,1240144841,7802,48,7,3,5,2
4330,143004.0,2023-09-19 18:19:55,1240145039,73750,16,24,12,2,22
4331,119243.0,2023-09-19 18:25:53,1240150509,38329,54,26,9,6,20
4332,119216.0,2023-09-19 18:26:15,1240150883,0,0,3,0,0,3
4333,164784.0,2023-09-19 19:21:23,1240209174,28549,63,61,46,5,56
4341,164795.0,2023-09-19 21:05:56,1240325800,46859,241,39,17,9,30
4342,164800.0,2023-09-19 21:22:27,1240343627,35421,42,26,17,5,21
4357,164832.0,2023-09-20 15:42:43,1240887419,0,0,1,0,0,1
4360,164834.0,2023-09-20 15:54:38,1240895963,50589,25,12,6,1,11
4365,146745.0,2023-09-20 16:33:45,1240926623,6862,103,32,20,6,26
4372,164897.0,2023-09-20 18:35:31,1241036232,7178,108,45,25,5,40
4373,164899.0,2023-09-20 18:58:15,1241057146,67387,126,14,7,7,7
4374,164900.0,2023-09-20 19:07:17,1241065107,20829,35,4,2,3,1
4375,164902.0,2023-09-20 19:15:37,1241072448,26829,71,20,4,4,16
4378,164911.0,2023-09-20 19:23:53,1241079530,101254,300,99,28,13,86
4379,88539.0,2023-09-20 19:35:55,1241089852,133963,15,6,3,1,5
4380,88583.0,2023-09-20 19:36:16,1241090140,133963,16,7,5,1,6
4381,88547.0,2023-09-20 19:37:23,1241091446,134221,23,39,17,3,36
4382,88541.0,2023-09-20 19:37:42,1241091719,142198,208,19,7,2,17
4383,145183.0,2023-09-20 19:38:00,1241091931,0,0,21,15,0,21
4384,144876.0,2023-09-20 19:39:47,1241093387,0,0,2,0,0,2
4386,164914.0,2023-09-20 20:19:57,1241128534,9537,21,2,2,1,1
4388,164919.0,2023-09-20 20:37:20,1241143404,10548,26,43,13,3,40
4389,164921.0,2023-09-20 20:50:32,1241154393,27129,43,10,5,5,5
4391,164927.0,2023-09-20 21:14:16,1241174414,0,0,3,2,0,3
4393,164931.0,2023-09-20 22:19:07,1241226974,22119,54,8,5,4,4
4394,164943.0,2023-09-21 00:00:22,1241301357,62430,105,21,12,11,10
4395,164944.0,2023-09-21 00:06:25,1241305516,53274,326,114,31,12,102
4396,164945.0,2023-09-21 00:17:20,1241312757,37854,24,6,3,1,5
4399,144088.0,2023-09-21 15:08:52,1241511295,0,12,10,7,0,10
4405,164971.0,2023-09-21 15:50:13,1241539906,7280,26,69,49,1,68
4406,146001.0,2023-09-21 15:54:02,1241542686,162408,219,105,30,5,100
4408,164980.0,2023-09-21 16:07:12,1241552095,5531,50,5,2,4,1
4418,134432.0,2023-09-21 19:39:50,1241727943,0,0,94,40,0,94
4421,165029.0,2023-09-21 20:35:48,1241777566,34869,39,12,9,4,8
4428,165046.0,2023-09-21 21:44:57,1241847136,0,15,28,6,0,28
4429,165047.0,2023-09-21 21:50:22,1241852697,12912,29,13,5,2,11
4434,165052.0,2023-09-21 22:46:27,1241909063,632,3,7,5,1,6
4447,165091.0,2023-09-22 15:31:27,1242249332,684,4,21,13,2,19
4449,165093.0,2023-09-22 15:31:58,1242249616,11898,35,68,28,4,64
4464,142353.0,2023-09-22 19:29:58,1242484337,24953,21,60,40,4,56
4466,144006.0,2023-09-22 19:30:26,1242484814,0,6,5,1,0,5
4467,144378.0,2023-09-22 19:31:10,1242485551,30176,190,55,40,3,52
4468,154717.0,2023-09-22 19:31:31,1242485948,24921,27,29,10,2,27
4473,154837.0,2023-09-22 22:55:38,1242700423,105,187,88,57,1,87
4474,154824.0,2023-09-22 22:56:13,1242700974,0,1,6,0,0,6
4476,154821.0,2023-09-22 22:57:06,1242701839,13846,207,90,53,2,88
4477,154812.0,2023-09-22 22:57:31,1242702237,12028,27,6,4,3,3
4485,165141.0,2023-09-23 14:59:30,1243991043,15882,81,77,59,4,73
4486,165149.0,2023-09-23 15:29:01,1244057039,8888,58,18,13,4,14
4488,165150.0,2023-09-23 15:40:06,1244070815,42502,74,27,16,6,21
4489,165152.0,2023-09-23 15:40:12,1244070942,3150,6,20,1,1,19
4495,165157.0,2023-09-23 16:11:08,1244133731,4450,32,31,18,2,29
4502,165164.0,2023-09-23 16:58:30,1244201756,0,2,7,1,0,7
4505,165167.0,2023-09-23 17:26:09,1244241123,24701,55,34,22,8,26
4507,165166.0,2023-09-23 17:26:35,1244241854,17741,115,15,5,5,10
4508,165165.0,2023-09-23 17:26:52,1244242429,17761,314,24,16,6,18
4510,165169.0,2023-09-23 17:49:42,1244284697,1912,38,34,21,5,29
4512,165171.0,2023-09-23 17:56:38,1244298050,1285,150,38,23,3,35
4515,143507.0,2023-09-25 14:58:30,1245346002,18301,151,36,23,4,32
4516,143530.0,2023-09-25 14:58:57,1245346476,142,121,58,29,1,57
4517,143620.0,2023-09-25 14:59:20,1245346901,6573,41,46,18,3,43
4518,143550.0,2023-09-25 14:59:45,1245347377,3199,22,37,18,2,35
4519,143508.0,2023-09-25 15:00:12,1245347873,7700,45,35,15,1,34
4521,165225.0,2023-09-25 16:57:53,1245507612,35882,23,40,23,2,38
4537,165236.0,2023-09-25 17:57:54,1245593253,12090,5,12,2,2,10
4540,165237.0,2023-09-25 18:00:17,1245595476,83214,109,29,19,5,24
4544,165247.0,2023-09-25 19:41:29,1245721645,0,1,8,6,0,8
4545,165240.0,2023-09-25 19:41:50,1245721917,14613,19,50,30,2,48
4547,165249.0,2023-09-25 21:08:50,1245793258,0,0,2,1,0,2
4548,84751.0,2023-09-25 21:16:36,1245799171,54907,341,41,21,7,34
4563,165308.0,2023-09-26 15:16:33,1246312981,22675,121,14,10,5,9
4567,165298.0,2023-09-26 15:29:33,1246320287,141596,108,91,50,6,85
4568,165316.0,2023-09-26 16:03:52,1246342016,26206,37,49,19,6,43
4570,165318.0,2023-09-26 16:14:41,1246349598,9742,0,32,10,2,30
4578,165332.0,2023-09-26 18:10:44,1246442654,6444,17,25,10,2,23
4579,165333.0,2023-09-26 18:24:56,1246454454,32860,46,24,16,4,20
4581,165339.0,2023-09-26 19:01:39,1246485109,1888,18,44,14,2,42
4582,165334.0,2023-09-26 19:01:55,1246485341,0,0,12,6,0,12
4583,165336.0,2023-09-26 19:02:08,1246485459,3056,8,16,5,1,15
4584,165338.0,2023-09-26 19:02:19,1246485645,3368,3,2,0,1,1
4585,165340.0,2023-09-26 19:02:29,1246485735,17033,6,40,23,1,39
4586,165341.0,2023-09-26 19:10:29,1246491942,0,0,5,2,0,5
4592,106179.0,2023-09-26 19:27:27,1246505918,49914,76,44,19,3,41
4595,154880.0,2023-09-26 19:37:29,1246513834,0,0,14,4,0,14
4596,165356.0,2023-09-26 19:42:44,1246517967,13441,26,11,2,3,8
4597,165354.0,2023-09-26 19:43:05,1246518265,26884,26,25,3,2,23
4598,155145.0,2023-09-26 19:49:17,1246523418,55163,53,41,24,5,36
4601,155146.0,2023-09-26 19:58:30,1246532175,6426,22,19,14,2,17
4602,114566.0,2023-09-26 20:29:34,1246557201,10504,175,63,17,8,55
4603,114564.0,2023-09-26 20:30:10,1246557707,3586,7,52,8,1,51
4604,114568.0,2023-09-26 20:30:37,1246558030,873,258,29,8,3,26
4605,115084.0,2023-09-26 20:31:09,1246558460,975,65,23,10,5,18
4606,136857.0,2023-09-26 20:31:35,1246558797,5809,18,21,15,3,18
4608,146323.0,2023-09-26 20:32:31,1246559528,21839,25,15,2,1,14
4623,165370.0,2023-09-26 21:48:03,1246617882,1497,8,13,8,1,12
4624,165373.0,2023-09-26 22:12:45,1246636705,76214,198,67,40,7,60
4625,165372.0,2023-09-26 22:13:17,1246637061,186423,118,53,32,3,50
4628,165366.0,2023-09-26 22:15:18,1246638482,224640,255,98,29,21,77
4631,134433.0,2023-09-26 22:42:26,1246659126,1411,17,6,0,3,3
4632,123158.0,2023-09-26 22:47:35,1246662982,126247,99,51,34,6,45
4633,123173.0,2023-09-26 23:01:22,1246673195,46013,40,9,5,3,6
4635,165392.0,2023-09-26 23:03:29,1246674816,50886,116,122,31,5,117
4637,165422.0,2023-09-27 13:26:02,1246908167,0,0,1,0,0,1
4639,165427.0,2023-09-27 15:03:53,1246939351,5180,8,24,21,1,23
4641,144366.0,2023-09-27 15:45:16,1246963836,25624,378,96,47,8,88
4643,144368.0,2023-09-27 15:45:34,1246964057,4233,67,89,41,2,87
4644,144369.0,2023-09-27 15:45:48,1246964218,4099,60,53,18,2,51
4645,144370.0,2023-09-27 15:46:05,1246964390,84604,167,81,44,7,74
4648,165432.0,2023-09-27 16:02:04,1246975527,0,6,1,1,0,1
4650,106189.0,2023-09-27 16:06:20,1246978433,46306,62,36,20,2,34
4651,143948.0,2023-09-27 16:15:21,1246985026,22024,195,47,8,4,43
4657,155484.0,2023-09-27 16:32:51,1246997971,6552,35,40,17,2,38
4659,155495.0,2023-09-27 16:33:48,1246998727,25497,113,89,34,7,82
4660,155504.0,2023-09-27 16:34:14,1246999083,140100,242,123,44,11,112
4662,155513.0,2023-09-27 16:34:48,1246999489,13815,49,76,30,5,71
4663,155519.0,2023-09-27 16:35:13,1246999855,73556,75,60,21,5,55
4664,155805.0,2023-09-27 16:36:09,1247000551,117326,176,65,22,13,52
4673,165452.0,2023-09-27 17:18:57,1247035006,91640,168,43,25,7,36
4674,165463.0,2023-09-27 17:37:56,1247053771,6691,15,22,11,2,20
4685,154042.0,2023-09-27 18:28:10,1247102579,14505,34,57,19,3,54
4686,154040.0,2023-09-27 18:28:33,1247102886,8313,33,15,9,2,13
4687,105401.0,2023-09-27 18:31:11,1247105373,2027,21,112,74,1,111
4688,120973.0,2023-09-27 18:32:08,1247106222,17764,297,33,12,3,30
4689,120893.0,2023-09-27 18:32:38,1247106667,40507,22,48,21,1,47
4690,132704.0,2023-09-27 18:33:03,1247107066,17292,69,19,10,3,16
4691,145067.0,2023-09-27 18:33:26,1247107415,0,110,7,4,0,7
4692,145099.0,2023-09-27 18:33:48,1247107801,0,0,12,10,0,12
4695,95297.0,2023-09-27 19:17:16,1247150223,7108,77,38,22,4,34
4696,95301.0,2023-09-27 19:17:43,1247150606,715,18,17,7,1,16
4697,95307.0,2023-09-27 19:18:13,1247151148,0,11,15,11,0,15
4698,95312.0,2023-09-27 19:18:52,1247151844,7345,26,41,15,2,39
4699,145331.0,2023-09-27 19:19:22,1247152303,37018,179,26,10,7,19
4700,95311.0,2023-09-27 19:19:51,1247152768,23660,175,149,13,7,142
4701,95304.0,2023-09-27 19:20:14,1247153104,9026,137,50,9,4,46
4703,135626.0,2023-09-27 19:29:25,1247161386,7986,47,45,28,3,42
4704,95313.0,2023-09-27 19:29:24,1247161392,131850,112,16,4,7,9
4705,95295.0,2023-09-27 19:30:04,1247161949,715,20,27,11,1,26
4706,106443.0,2023-09-27 19:30:33,1247162388,5313,54,14,7,4,10
4707,135632.0,2023-09-27 19:31:56,1247163476,5935,64,74,51,2,72
4708,135628.0,2023-09-27 19:35:34,1247166600,29663,187,199,87,5,194
4709,143696.0,2023-09-27 19:43:56,1247174229,0,91,63,34,0,63
4710,165428.0,2023-09-27 20:05:01,1247193200,4719,94,8,7,1,7
4713,165511.0,2023-09-27 22:26:23,1247300014,54227,71,37,27,7,30
4716,153202.0,2023-09-27 22:58:45,1247322120,35302,116,48,29,8,40
4717,153878.0,2023-09-27 22:59:15,1247322473,14150,60,10,3,6,4
4718,153678.0,2023-09-27 22:59:43,1247322781,6207,8,19,4,2,17
4719,153251.0,2023-09-27 23:00:24,1247323203,4326,35,30,22,3,27
4720,153889.0,2023-09-27 23:00:57,1247323572,14857,98,31,13,7,24
4724,144375.0,2023-09-27 23:42:42,1247351580,3236,18,17,12,1,16
4725,165540.0,2023-09-28 00:15:46,1247372741,3572,12,19,11,2,17
4726,165541.0,2023-09-28 00:15:55,1247372813,46662,56,26,17,4,22
4727,165554.0,2023-09-28 15:09:10,1247582487,5686,5,16,6,1,15
4728,165555.0,2023-09-28 15:14:28,1247585200,0,0,3,1,0,3
4758,165542.0,2023-09-28 21:12:22,1247928794,33592,129,106,71,7,99
4759,165641.0,2023-09-28 21:45:52,1247961583,49274,391,63,42,20,43
4760,165642.0,2023-09-28 21:57:32,1247973227,18399,50,15,8,3,12
4761,154932.0,2023-09-28 22:02:50,1247978193,0,2,10,6,0,10
4762,155488.0,2023-09-28 22:03:26,1247978763,993,24,7,5,1,6
4765,165665.0,2023-09-29 15:00:09,1248310525,0,0,3,2,0,3
4767,109540.0,2023-09-29 16:28:37,1248358098,36548,59,120,72,3,117
4768,109632.0,2023-09-29 16:30:25,1248359039,23773,49,69,37,3,66
4769,130209.0,2023-09-29 16:30:39,1248359185,3986,17,136,61,3,133
4770,109532.0,2023-09-29 16:30:48,1248359271,90122,177,107,95,4,103
4771,109634.0,2023-09-29 16:31:31,1248359609,2831,39,11,4,2,9
4772,145969.0,2023-09-29 16:32:12,1248359982,45929,142,116,62,7,109
4774,144007.0,2023-09-29 16:35:38,1248361816,20579,166,58,39,6,52
4775,144003.0,2023-09-29 16:35:54,1248361947,15730,23,42,31,1,41
4776,143838.0,2023-09-29 16:36:21,1248362160,33476,16,25,8,2,23
4778,144001.0,2023-09-29 16:36:54,1248362401,0,28,3,0,0,3
4779,155337.0,2023-09-29 16:37:11,1248362567,9847,30,44,6,1,43
4782,165673.0,2023-09-29 17:29:59,1248392017,94457,62,28,17,3,25
4784,135629.0,2023-09-29 18:15:15,1248429364,0,2,87,27,0,87
4785,111617.0,2023-09-29 18:46:26,1248457577,18048,21,55,49,2,53
4786,111622.0,2023-09-29 18:46:27,1248457595,122105,75,84,60,5,79
4787,143347.0,2023-09-29 18:46:33,1248457688,337,15,45,28,1,44
4788,142683.0,2023-09-29 18:46:44,1248457866,12866,121,17,8,2,15
4806,165832.0,2023-10-02 16:39:48,1249957843,0,0,11,2,0,11
4807,165833.0,2023-10-02 16:46:39,1249963707,18139,28,26,17,2,24
4808,165834.0,2023-10-02 16:53:28,1249969311,87357,88,65,43,6,59
4809,165849.0,2023-10-02 17:02:04,1249976431,0,15,3,0,0,3
4810,165855.0,2023-10-02 17:15:18,1249985306,48713,33,31,18,2,29
4825,145180.0,2023-10-03 16:47:58,1250702514,159910,110,154,29,8,146
4828,154960.0,2023-10-03 17:03:19,1250716478,112357,69,61,27,4,57
4868,122645.0,2023-10-04 15:57:34,1251437138,6593,252,99,63,5,94
4872,135039.0,2023-10-04 16:19:59,1251452922,17912,83,118,61,3,115
4899,120188.0,2023-10-05 15:08:26,1252067386,134470,238,36,17,8,28
4900,120190.0,2023-10-05 15:08:57,1252067625,0,0,4,2,0,4
4901,120187.0,2023-10-05 15:09:21,1252067857,3570,12,13,8,2,11
4902,120186.0,2023-10-05 15:09:43,1252068025,0,0,2,1,0,2
4903,120189.0,2023-10-05 15:10:10,1252068255,0,0,12,10,0,12
4906,135020.0,2023-10-05 15:23:26,1252074909,0,1,21,14,0,21
4907,154363.0,2023-10-05 16:12:58,1252105612,5655,72,6,3,1,5
4923,166110.0,2023-10-05 20:15:57,1252295840,21072,134,40,27,8,32
4934,166121.0,2023-10-05 23:01:06,1252418495,1951,13,1,0,1,0
4937,166130.0,2023-10-06 00:29:32,1252475803,1090,4,7,2,1,6
4941,166134.0,2023-10-06 14:12:10,1252723488,677,1,1,1,1,0
4943,156837.0,2023-10-06 14:31:57,1252729270,21532,224,64,42,8,56
4944,156850.0,2023-10-06 14:34:22,1252730041,83348,36,70,43,9,61
4946,156871.0,2023-10-06 14:35:15,1252730343,20504,99,31,17,7,24
4947,156863.0,2023-10-06 14:35:56,1252730546,6026,39,42,7,5,37
4952,156108.0,2023-10-06 16:20:12,1252785786,15083,54,28,8,2,26
4954,155755.0,2023-10-06 16:22:01,1252786946,58204,7,10,6,1,9
4955,155763.0,2023-10-06 16:22:37,1252787374,61461,53,32,14,4,28
4956,155762.0,2023-10-06 16:23:14,1252787801,89808,23,17,13,2,15
4957,156111.0,2023-10-06 16:23:38,1252788058,117977,248,47,32,7,40
4958,156736.0,2023-10-06 16:24:02,1252788299,399,122,38,19,1,37
4959,166146.0,2023-10-06 16:56:54,1252812179,0,8,10,10,0,10
4966,151817.0,2023-10-06 17:56:16,1252860617,6014,237,16,5,3,13
4967,156151.0,2023-10-06 17:56:44,1252861008,3960,16,4,2,2,2
4968,156159.0,2023-10-06 17:57:09,1252861359,235849,141,40,22,13,27
4970,156247.0,2023-10-06 17:57:30,1252861681,204384,261,153,40,18,135
4973,156365.0,2023-10-06 17:58:18,1252862392,3455,23,33,16,2,31
4975,156460.0,2023-10-06 17:59:20,1252863288,5221,30,37,23,4,33
4977,156882.0,2023-10-06 18:00:01,1252863839,62712,103,25,18,3,22
4982,166165.0,2023-10-06 19:01:34,1252915828,12142,18,20,9,5,15
4983,166163.0,2023-10-06 19:01:43,1252916007,82073,216,17,1,7,10
4988,166174.0,2023-10-06 21:08:01,1253021638,4112,87,42,16,2,40
4994,166198.0,2023-10-07 01:03:06,1253182205,40773,170,21,8,6,15
5015,145827.0,2023-10-09 16:34:38,1254324145,14694,108,42,32,2,40
5017,145828.0,2023-10-09 16:35:22,1254324683,11585,126,23,9,1,22
5018,146004.0,2023-10-09 16:35:58,1254325104,26551,246,66,44,4,62
5019,145831.0,2023-10-09 16:36:25,1254325490,0,0,4,2,0,4
5020,145829.0,2023-10-09 16:37:06,1254325950,23476,7,7,2,1,6
5021,154897.0,2023-10-09 16:37:37,1254326274,5469,352,41,16,2,39
5028,144024.0,2023-10-09 20:21:26,1254516197,62517,44,31,17,4,27
5029,144098.0,2023-10-09 20:21:43,1254516420,35574,61,14,6,3,11
5030,144100.0,2023-10-09 20:22:05,1254516717,6467,15,43,30,2,41
5031,144665.0,2023-10-09 20:22:19,1254516904,12736,19,25,22,2,23
5032,144021.0,2023-10-09 20:22:35,1254517120,186992,63,27,20,4,23
5034,154900.0,2023-10-09 21:59:00,1254597781,0,44,29,20,0,29
5035,154899.0,2023-10-09 21:59:19,1254598030,0,11,25,22,0,25
5036,154905.0,2023-10-09 21:59:27,1254598134,0,5,36,30,0,36
5037,124957.0,2023-10-09 21:59:40,1254598309,1333,24,62,48,2,60
5038,154906.0,2023-10-09 21:59:46,1254598385,5128,49,60,45,4,56
5071,156422.0,2023-10-10 22:09:21,1255312482,15769,90,27,12,5,22
5072,156418.0,2023-10-10 22:09:46,1255312814,24738,178,30,19,5,25
5073,155867.0,2023-10-10 22:10:07,1255313091,1980,14,7,5,1,6
5074,155889.0,2023-10-10 22:10:32,1255313396,28955,432,76,16,8,68
5081,166390.0,2023-10-10 23:08:37,1255358308,22872,393,90,43,33,57
5294,148682.0,2023-10-16 17:29:31,1258839042,4335,73,33,20,2,31
5387,166913.0,2023-10-17 17:55:52,1259742923,0,0,23,4,0,23
5390,166922.0,2023-10-17 17:56:48,1259743646,1027,1,2,0,1,1
5438,167045.0,2023-10-18 18:44:11,1260571152,1229,4,10,1,1,9
5491,110298.0,2023-10-19 22:20:10,1261575946,31153,106,44,22,9,35
5620,157656.0,2023-10-24 15:01:25,1264037440,232564,106,60,32,7,53
5626,167423.0,2023-10-24 15:08:38,1264040848,35575,21,17,13,4,13
5635,157602.0,2023-10-24 15:53:35,1264069594,13857,81,10,6,3,7
5758,158678.0,2023-10-26 16:51:41,1266741559,15820,41,61,38,4,57
5794,156129.0,2023-10-26 20:33:15,1266918980,26196,35,61,16,5,56
5908,150831.0,2023-10-30 19:26:53,1269497675,58737,119,92,51,5,87
6137,108672.0,2023-11-08 16:26:59,1274533909,41042,107,45,29,3,42
6138,108501.0,2023-11-08 16:27:53,1274534563,32917,92,92,58,6,86
6139,108499.0,2023-11-08 16:28:25,1274534965,41042,99,91,39,3,88
6142,149448.0,2023-11-08 16:33:59,1274539126,72654,62,35,16,5,30
6171,150323.0,2023-11-08 22:21:01,1274859865,225144,155,90,62,10,80
6250,148939.0,2023-11-10 19:33:43,1276070020,108501,151,36,17,4,32
6253,148907.0,2023-11-10 19:35:03,1276071102,162739,28,26,9,2,24
6401,169239.0,2023-11-14 20:21:07,1278752802,0,0,2,2,0,2
6921,159050.0,2023-11-17 20:13:13,1281357023,1812,3,21,16,1,20
6938,159760.0,2023-11-17 20:14:03,1281357796,12315,37,11,6,3,8
6951,159769.0,2023-11-17 20:14:32,1281358206,48807,333,292,45,7,285
7417,5812.0,2023-11-21 20:38:40,1284576731,50794,105,12,7,5,7
7452,138904.0,2023-11-21 23:07:11,1284744923,11120,27,56,38,1,55
