id_distribuidor,fecha_consulta,folio,saldo_vencido_total,pagos_vencidos,creditos_totales,creditos_con_claves_prevencion,creditos_completados_con_atraso,creditos_completados_sin_atraso
154610,2023-06-07 17:25:26,1166269370,37981,72,10,5,3,7
154745,2023-06-07 18:53:25,1166361717,7528,22,7,5,4,3
154749,2023-06-07 19:24:57,1166388121,30488,171,73,55,5,68
154750,2023-06-07 19:37:53,1166399027,1449,31,5,2,4,1
154767,2023-06-07 21:38:05,1166502669,9573,36,2,2,2,0
154766,2023-06-07 21:39:38,1166503925,129726,259,68,43,8,60
154772,2023-06-07 22:41:56,1166549975,2253,73,37,23,5,32
154771,2023-06-07 22:52:35,1166557426,0,5,39,27,0,39
122546,2023-06-07 23:08:09,1166568805,51870,33,29,22,3,26
154783,2023-06-08 14:31:41,1166864815,32098,272,30,13,16,14
154792,2023-06-08 14:53:23,1166872944,16269,55,21,14,2,19
154793,2023-06-08 15:06:30,1166878206,9123,11,14,14,1,13
154794,2023-06-08 15:08:59,1166879274,27456,105,15,6,8,7
154795,2023-06-08 15:10:47,1166880215,9228,175,30,6,4,26
154803,2023-06-08 15:11:43,1166880725,0,0,1,1,0,1
154805,2023-06-08 15:25:21,1166888648,11179,35,9,2,6,3
154807,2023-06-08 15:35:52,1166895031,0,0,1,0,0,1
154807,2023-06-08 15:35:56,1166895082,0,0,1,0,0,1
154806,2023-06-08 15:38:51,1166897001,9967,13,5,2,3,2
154810,2023-06-08 16:30:37,1166932901,32742,85,95,57,7,88
154811,2023-06-08 16:54:51,1166950138,0,0,3,2,0,3
154811,2023-06-08 16:54:54,1166950175,0,0,3,2,0,3
154812,2023-06-08 16:56:10,1166951047,12028,24,6,4,3,3
154821,2023-06-08 17:39:11,1166984437,12530,234,85,48,2,83
154822,2023-06-08 17:58:31,1166999974,21194,143,97,53,2,95
154823,2023-06-08 17:58:55,1167000311,14766,74,24,12,5,19
154824,2023-06-08 18:11:49,1167010322,0,0,1,0,0,1
154827,2023-06-08 18:27:18,1167022271,9384,24,42,1,1,41
154837,2023-06-08 19:23:58,1167066804,105,227,86,56,1,85
154840,2023-06-08 19:45:33,1167083233,2002,2,16,5,1,15
154844,2023-06-08 20:45:28,1167128091,620,1,2,1,1,1
154845,2023-06-08 20:50:56,1167132165,189302,170,74,39,10,64
154808,2023-06-08 20:51:37,1167132695,36148,49,11,6,3,8
154846,2023-06-08 20:57:36,1167139642,8498,93,18,12,5,13
154847,2023-06-08 21:04:51,1167148337,11499,36,16,10,2,14
154848,2023-06-08 21:12:44,1167157806,55691,90,53,41,5,48
154849,2023-06-08 21:15:26,1167160657,0,1,13,8,0,13
154859,2023-06-08 22:25:09,1167242975,0,0,35,0,0,35
154860,2023-06-08 23:35:46,1167289760,6873,39,11,7,3,8
154861,2023-06-08 23:42:29,1167293546,0,22,10,4,0,10
154862,2023-06-09 00:00:19,1167303410,53896,61,17,13,4,13
154863,2023-06-09 00:15:43,1167312521,13378,67,35,13,3,32
154865,2023-06-09 00:32:09,1167321361,0,0,8,6,0,8
154876,2023-06-09 15:01:07,1167568067,1720,10,5,2,2,3
154878,2023-06-09 15:07:55,1167571353,1413,44,8,4,3,5
154879,2023-06-09 15:15:17,1167575322,0,1,34,25,0,34
154888,2023-06-09 15:31:36,1167584952,6287,22,8,3,1,7
154892,2023-06-09 16:02:48,1167605043,0,0,32,0,0,32
154896,2023-06-09 16:32:22,1167625524,4340,190,28,20,1,27
154897,2023-06-09 16:50:59,1167638874,1127,351,40,17,6,34
154899,2023-06-09 17:39:35,1167675984,0,11,23,21,0,23
154900,2023-06-09 17:40:55,1167676992,0,44,27,19,0,27
154902,2023-06-09 17:41:59,1167677843,21024,32,43,36,1,42
154905,2023-06-09 17:43:08,1167678727,0,5,33,29,0,33
154906,2023-06-09 17:44:58,1167680183,4529,27,57,44,4,53
154927,2023-06-09 18:33:45,1167719533,5427,11,1,0,1,0
154929,2023-06-09 18:52:01,1167735384,252240,97,23,16,4,19
154932,2023-06-09 19:00:56,1167742774,3978,13,10,8,1,9
154935,2023-06-09 19:06:16,1167746893,22322,3,8,2,1,7
154978,2023-06-12 18:38:37,1169253687,143730,212,71,31,18,53
24321,2023-06-12 18:57:16,1169268233,5430,6,4,2,1,3
154978,2023-06-12 19:15:29,1169280394,143730,212,71,31,18,53
154978,2023-06-12 19:16:03,1169280819,143730,212,71,31,18,53
154978,2023-06-12 19:17:07,1169281587,143730,212,71,31,18,53
154978,2023-06-12 19:15:24,1169281972,143730,212,71,31,18,53
155045,2023-06-12 19:58:43,1169313580,39889,59,26,14,4,22
155047,2023-06-12 20:50:14,1169349871,12344,249,21,9,2,19
123173,2023-06-12 21:08:19,1169362431,45454,36,8,4,2,6
123158,2023-06-12 21:11:10,1169364410,202224,129,52,33,8,44
155073,2023-06-12 21:33:56,1169380260,0,1,42,25,0,42
155074,2023-06-12 21:34:44,1169380815,0,39,29,23,0,29
155093,2023-06-12 21:42:16,1169385971,25337,79,18,14,2,16
155094,2023-06-12 21:44:31,1169387646,54765,195,70,19,11,59
155095,2023-06-12 21:50:21,1169391593,30367,195,16,4,7,9
155102,2023-06-12 21:56:25,1169395821,0,1,14,7,0,14
155048,2023-06-12 22:04:32,1169401423,0,1,8,7,0,8
155111,2023-06-12 22:46:53,1169428916,0,0,9,9,0,9
155114,2023-06-12 23:17:02,1169448198,4915,9,8,5,1,7
155116,2023-06-12 23:32:04,1169457561,351,31,72,49,1,71
155118,2023-06-12 23:38:31,1169461615,6976,30,25,17,3,22
155163,2023-06-13 16:12:58,1169821162,1359,25,11,6,2,9
155165,2023-06-13 16:18:05,1169824889,0,8,44,30,0,44
155382,2023-06-15 17:46:53,1171410146,26017,69,55,15,4,51
155384,2023-06-15 17:57:42,1171418763,17157,191,16,4,1,15
155357,2023-06-15 17:58:54,1171419756,3875,1,2,0,1,1
155358,2023-06-15 17:59:14,1171420042,124319,516,58,42,12,46
155386,2023-06-15 18:38:55,1171452155,0,1,6,4,0,6
155387,2023-06-15 19:11:17,1171479277,87967,73,7,4,3,4
155388,2023-06-15 19:12:14,1171480023,96682,123,16,12,6,10
155389,2023-06-15 19:13:05,1171480703,2833,57,33,6,2,31
155390,2023-06-15 19:13:46,1171481243,5589,31,32,25,3,29
155394,2023-06-15 19:14:18,1171481663,51046,64,45,25,5,40
155395,2023-06-15 19:16:11,1171483221,51941,118,12,6,7,5
155398,2023-06-15 19:19:25,1171485948,47678,83,14,4,9,5
155399,2023-06-15 19:23:00,1171488665,9177,10,9,6,2,7
155400,2023-06-15 19:36:12,1171499004,58040,116,6,3,3,3
155403,2023-06-15 19:45:26,1171506034,20855,99,4,0,1,3
155404,2023-06-15 19:47:00,1171507065,6835,28,9,4,3,6
155407,2023-06-15 19:58:06,1171515493,0,0,1,0,0,1
155409,2023-06-15 20:06:50,1171521966,8363,52,14,4,3,11
155410,2023-06-15 20:08:00,1171522849,68980,133,19,8,6,13
155408,2023-06-15 20:20:28,1171532149,36395,25,22,20,2,20
155392,2023-06-15 20:24:12,1171534981,4833,80,5,2,1,4
155413,2023-06-15 20:24:31,1171535177,5780,12,8,8,1,7
155414,2023-06-15 20:31:41,1171540428,71044,242,62,43,9,53
155415,2023-06-15 20:32:30,1171540967,0,0,36,2,0,36
155420,2023-06-15 20:52:09,1171555197,181,7,11,5,1,10
155423,2023-06-15 20:59:18,1171560368,3231,42,4,1,4,0
155424,2023-06-15 21:08:59,1171567482,23234,73,4,2,2,2
155428,2023-06-15 21:56:00,1171601937,84786,150,77,47,10,67
155430,2023-06-15 22:00:01,1171604799,220084,186,55,13,14,41
155431,2023-06-15 22:17:58,1171616307,4934,1,14,4,1,13
155432,2023-06-15 22:23:47,1171620117,44787,93,81,10,4,77
155433,2023-06-15 22:25:46,1171621419,2842,14,8,6,1,7
155434,2023-06-15 22:29:48,1171624166,208,17,20,12,1,19
155452,2023-06-16 14:46:31,1172207263,0,8,7,1,0,7
155391,2023-06-16 15:08:21,1172223155,114059,128,44,19,7,37
70598,2023-06-16 15:25:04,1172240582,0,2,91,33,0,91
155465,2023-06-16 15:48:27,1172262048,61404,61,53,40,4,49
75457,2023-06-16 15:49:43,1172263207,112432,99,142,94,8,134
126251,2023-06-16 16:14:16,1172289315,8159,94,38,27,7,31
116,2023-06-16 16:19:05,1172294613,5250,20,107,20,1,106
116,2023-06-16 16:19:12,1172294756,5250,20,107,20,1,106
155476,2023-06-16 17:05:39,1172347954,71944,131,74,47,7,67
155478,2023-06-16 17:06:06,1172348450,62207,84,57,43,5,52
133918,2023-06-16 17:06:55,1172349382,0,109,22,3,0,22
155481,2023-06-16 17:08:59,1172351722,125352,230,102,43,14,88
155482,2023-06-16 17:10:03,1172352856,11270,48,3,2,1,2
155479,2023-06-16 17:13:28,1172356685,33944,92,45,18,7,38
143637,2023-06-16 17:17:52,1172361744,19101,277,78,35,23,55
143838,2023-06-16 17:20:09,1172364937,19558,13,26,9,2,24
143639,2023-06-16 17:20:58,1172366519,0,156,41,10,0,41
143638,2023-06-16 17:21:14,1172367057,609,96,48,13,1,47
155470,2023-06-16 17:27:38,1172379168,73838,82,85,36,2,83
155472,2023-06-16 17:27:55,1172379705,0,172,54,22,0,54
155486,2023-06-16 17:36:34,1172395595,9916,43,38,25,2,36
155487,2023-06-16 17:40:18,1172402717,2162,4,10,9,1,9
155488,2023-06-16 17:53:17,1172426740,5493,24,6,4,1,5
120188,2023-06-16 17:57:35,1172434918,134470,233,35,15,8,27
155533,2023-06-16 21:13:09,1172762170,0,0,3,1,0,3
155534,2023-06-16 21:17:43,1172770202,19221,106,82,48,4,78
155539,2023-06-16 22:23:11,1172874582,30813,110,41,15,9,32
111622,2023-06-16 22:46:58,1172922916,112734,67,81,58,5,76
111622,2023-06-16 22:47:02,1172923066,112734,67,81,58,5,76
111622,2023-06-16 22:47:03,1172923109,112734,67,81,58,5,76
155484,2023-06-16 22:47:57,1172925088,6552,35,38,17,2,36
155485,2023-06-16 22:48:39,1172926422,39189,88,104,36,6,98
155493,2023-06-16 22:48:50,1172926806,1602,9,9,7,1,8
155495,2023-06-16 22:49:03,1172927302,26007,118,87,34,8,79
155504,2023-06-16 22:49:13,1172927671,140834,238,120,43,12,108
155510,2023-06-16 22:49:28,1172928192,120796,140,86,44,9,77
155513,2023-06-16 22:49:37,1172928571,20382,67,76,31,5,71
155515,2023-06-16 22:49:45,1172928849,33710,68,16,6,5,11
155518,2023-06-16 22:49:53,1172929122,55933,82,14,9,4,10
155519,2023-06-16 22:50:05,1172929519,70854,71,58,20,4,54
111617,2023-06-16 22:51:40,1172932821,8677,15,55,48,2,53
111617,2023-06-16 22:51:41,1172932837,8677,15,55,48,2,53
101063,2023-06-16 23:13:12,1172970568,35368,146,95,79,7,88
101063,2023-06-16 23:13:15,1172970665,35368,146,95,79,7,88
101050,2023-06-16 23:13:34,1172971267,39302,170,90,71,8,82
101050,2023-06-16 23:13:35,1172971297,39302,170,90,71,8,82
101050,2023-06-16 23:13:37,1172971364,39302,170,90,71,8,82
101065,2023-06-16 23:13:59,1172972049,30169,124,67,58,5,62
101065,2023-06-16 23:14:02,1172972163,30169,124,67,58,5,62
101349,2023-06-16 23:14:23,1172972910,47123,56,31,19,4,27
101273,2023-06-16 23:14:53,1172974011,13690,35,36,28,2,34
100273,2023-06-16 23:15:17,1172974831,326119,408,93,68,11,82
100273,2023-06-16 23:15:19,1172974920,326119,408,93,68,11,82
100542,2023-06-16 23:15:47,1172975880,30946,62,68,51,4,64
100542,2023-06-16 23:15:48,1172975936,30946,62,68,51,4,64
100488,2023-06-16 23:16:11,1172976720,5573,79,82,65,2,80
100488,2023-06-16 23:16:15,1172976821,5573,79,82,65,2,80
113781,2023-06-16 23:16:37,1172977598,57810,148,78,57,6,72
113781,2023-06-16 23:16:40,1172977700,57810,148,78,57,6,72
125056,2023-06-16 23:17:02,1172978539,6485,13,21,14,2,19
125056,2023-06-16 23:17:05,1172978639,6485,13,21,14,2,19
125069,2023-06-16 23:17:27,1172979403,9231,85,29,13,6,23
155542,2023-06-16 23:33:23,1173012021,83395,89,20,12,6,14
155417,2023-06-17 00:04:20,1173071086,29474,38,15,10,2,13
155417,2023-06-17 00:04:26,1173071264,29474,38,15,10,2,13
155523,2023-06-17 01:33:38,1173255189,5250,20,107,20,1,106
155555,2023-06-17 15:13:56,1173758049,34354,148,54,19,11,43
155555,2023-06-17 15:13:59,1173758075,34354,148,54,19,11,43
155558,2023-06-17 16:45:12,1173828188,172410,118,61,47,9,52
155563,2023-06-17 17:04:42,1173846072,58667,32,12,10,2,10
155563,2023-06-17 17:04:46,1173846109,58667,32,12,10,2,10
155563,2023-06-17 17:04:47,1173846130,58667,32,12,10,2,10
155563,2023-06-17 17:04:48,1173846149,58667,32,12,10,2,10
155563,2023-06-17 17:04:50,1173846166,58667,32,12,10,2,10
155563,2023-06-17 17:04:53,1173846217,58667,32,12,10,2,10
155563,2023-06-17 17:04:55,1173846244,58667,32,12,10,2,10
155563,2023-06-17 17:04:56,1173846247,58667,32,12,10,2,10
155563,2023-06-17 17:04:57,1173846252,58667,32,12,10,2,10
155563,2023-06-17 17:04:58,1173846283,58667,32,12,10,2,10
155563,2023-06-17 17:05:01,1173846320,58667,32,12,10,2,10
155564,2023-06-17 17:13:44,1173853785,78920,48,17,10,4,13
155564,2023-06-17 17:13:46,1173853820,78920,48,17,10,4,13
155566,2023-06-17 17:30:12,1173868147,43576,46,18,11,4,14
155566,2023-06-17 17:30:14,1173868169,43576,46,18,11,4,14
155566,2023-06-17 17:30:15,1173868183,43576,46,18,11,4,14
155566,2023-06-17 17:30:18,1173868236,43576,46,18,11,4,14
155569,2023-06-17 17:48:48,1173883638,101973,530,93,42,9,84
155570,2023-06-17 17:51:46,1173886188,23215,87,39,3,10,29
155570,2023-06-17 17:51:50,1173886239,23215,87,39,3,10,29
155600,2023-06-19 15:18:03,1174969460,18267,61,77,37,2,75
59982,2023-06-19 15:18:10,1174969554,23962,179,13,5,3,10
59982,2023-06-19 15:18:14,1174969586,23962,179,13,5,3,10
155591,2023-06-19 15:20:59,1174971165,16446,34,32,13,4,28
155603,2023-06-19 15:48:09,1174988052,0,0,6,2,0,6
155603,2023-06-19 15:48:12,1174988072,0,0,6,2,0,6
105814,2023-06-19 15:53:45,1174991464,62857,173,61,53,7,54
155607,2023-06-19 15:54:46,1174992097,6823,72,30,17,3,27
155609,2023-06-19 16:39:10,1175023733,20450,56,99,46,2,97
155609,2023-06-19 16:39:14,1175023787,20450,56,99,46,2,97
105401,2023-06-19 16:40:40,1175024854,2027,22,111,74,1,110
120973,2023-06-19 16:41:13,1175025325,16846,305,33,12,4,29
120893,2023-06-19 16:41:36,1175025641,40507,22,48,21,1,47
120893,2023-06-19 16:41:38,1175025676,40507,22,48,21,1,47
132704,2023-06-19 16:41:52,1175025846,11440,63,19,10,3,16
132704,2023-06-19 16:41:54,1175025871,11440,63,19,10,3,16
145067,2023-06-19 16:42:13,1175026169,7705,129,7,5,2,5
145099,2023-06-19 16:42:28,1175026375,0,0,12,11,0,12
145099,2023-06-19 16:42:30,1175026397,0,0,12,11,0,12
155615,2023-06-19 16:49:13,1175031532,13880,11,11,4,5,6
155615,2023-06-19 16:49:18,1175031597,13880,11,11,4,5,6
154960,2023-06-19 17:12:16,1175049339,85212,81,57,25,4,53
154960,2023-06-19 17:12:22,1175049412,85212,81,57,25,4,53
155619,2023-06-19 17:31:27,1175063847,35604,149,76,59,6,70
155606,2023-06-19 17:39:15,1175069575,86252,67,22,7,2,20
155606,2023-06-19 17:39:19,1175069640,86252,67,22,7,2,20
155618,2023-06-19 17:41:18,1175071127,73920,295,142,88,5,137
155618,2023-06-19 17:41:21,1175071175,73920,295,142,88,5,137
155621,2023-06-19 17:47:42,1175075913,3541,277,92,62,5,87
155637,2023-06-19 18:36:16,1175113662,86309,69,25,12,5,20
155641,2023-06-19 19:21:05,1175147588,2730,8,8,6,1,7
155641,2023-06-19 19:21:11,1175147666,2730,8,8,6,1,7
155643,2023-06-19 19:24:02,1175149893,0,0,5,2,0,5
155645,2023-06-19 19:27:52,1175152720,0,6,3,1,0,3
155645,2023-06-19 19:27:57,1175152779,0,6,3,1,0,3
155646,2023-06-19 19:32:13,1175156251,16522,92,5,3,3,2
155647,2023-06-19 19:34:08,1175157780,9326,20,5,4,2,3
155647,2023-06-19 19:34:14,1175157856,9326,10,5,4,2,3
155656,2023-06-19 20:02:58,1175179851,103936,143,21,18,5,16
155656,2023-06-19 20:03:02,1175179895,103936,143,21,18,5,16
155657,2023-06-19 20:10:09,1175185158,87213,64,21,14,2,19
135020,2023-06-19 20:20:11,1175192371,0,1,17,11,0,17
135039,2023-06-19 20:21:06,1175193026,17912,85,107,57,3,104
155668,2023-06-19 20:39:15,1175206597,5929,14,11,5,3,8
155670,2023-06-19 21:04:15,1175224633,43696,42,12,7,6,6
155670,2023-06-19 21:04:21,1175224686,43696,42,12,7,6,6
114566,2023-06-19 22:23:09,1175280956,30511,173,62,18,12,50
114566,2023-06-19 22:23:13,1175281006,30511,173,62,18,12,50
114564,2023-06-19 22:23:40,1175281350,0,3,51,7,0,51
114568,2023-06-19 22:24:00,1175281635,873,252,28,7,3,25
114568,2023-06-19 22:24:04,1175281694,873,252,28,7,3,25
115084,2023-06-19 22:24:27,1175281957,2354,58,22,9,5,17
136857,2023-06-19 22:24:49,1175282162,2652,13,18,11,1,17
146052,2023-06-19 22:25:07,1175282398,18122,26,16,8,3,13
146323,2023-06-19 22:25:24,1175282641,25068,32,16,3,2,14
122987,2023-06-19 23:51:15,1175341078,74511,150,85,11,9,76
122987,2023-06-19 23:51:17,1175341110,74511,150,85,11,9,76
122987,2023-06-19 23:51:18,1175341111,74511,150,85,11,9,76
122987,2023-06-19 23:51:19,1175341133,74511,150,85,11,9,76
122987,2023-06-19 23:51:21,1175341161,74511,150,85,11,9,76
122987,2023-06-19 23:51:23,1175341189,74511,150,85,11,9,76
122987,2023-06-19 23:51:24,1175341196,74511,150,85,11,9,76
122987,2023-06-19 23:51:25,1175341203,74511,150,85,11,9,76
122987,2023-06-19 23:51:28,1175341252,74511,150,85,11,9,76
122987,2023-06-19 23:51:27,1175341256,74511,150,85,11,9,76
122987,2023-06-19 23:51:29,1175341276,74511,150,85,11,9,76
122987,2023-06-19 23:51:32,1175341300,74511,150,85,11,9,76
134575,2023-06-19 23:54:32,1175343507,19250,115,45,17,5,40
134575,2023-06-19 23:54:34,1175343510,19250,115,45,17,5,40
134575,2023-06-19 23:54:36,1175343550,19250,115,45,17,5,40
134575,2023-06-19 23:54:38,1175343554,19250,115,45,17,5,40
134575,2023-06-19 23:54:40,1175343574,19250,115,45,17,5,40
122909,2023-06-19 23:55:17,1175344011,19693,54,28,3,6,22
122909,2023-06-19 23:55:20,1175344041,19693,54,28,3,6,22
122909,2023-06-19 23:55:21,1175344055,19693,54,28,3,6,22
155640,2023-06-20 14:39:14,1175757829,21453,126,15,7,3,12
155640,2023-06-20 14:39:15,1175757838,21453,126,15,7,3,12
155640,2023-06-20 14:39:16,1175757851,21453,126,15,7,3,12
155640,2023-06-20 14:39:19,1175757873,21453,126,15,7,3,12
155640,2023-06-20 14:39:20,1175757876,21453,126,15,7,3,12
155640,2023-06-20 14:39:21,1175757891,21453,126,15,7,3,12
155640,2023-06-20 14:39:22,1175757901,21453,126,15,7,3,12
155640,2023-06-20 14:39:23,1175757909,21453,126,15,7,3,12
155640,2023-06-20 14:39:24,1175757917,21453,126,15,7,3,12
155640,2023-06-20 14:39:25,1175757923,21453,126,15,7,3,12
74111,2023-06-20 14:46:33,1175761337,20450,56,99,46,2,97
155732,2023-06-20 14:58:35,1175766214,55727,254,22,10,6,16
155763,2023-06-20 17:00:14,1175845693,34701,28,28,10,1,27
155762,2023-06-20 17:03:05,1175847695,84862,15,15,12,2,13
155769,2023-06-20 18:24:54,1175919543,103786,142,43,18,5,38
155769,2023-06-20 18:24:59,1175919648,103786,142,43,18,5,38
155783,2023-06-20 19:22:30,1175977789,25804,159,61,24,2,59
155782,2023-06-20 19:25:07,1175981261,65377,124,44,4,6,38
155782,2023-06-20 19:25:13,1175981369,65377,124,44,4,6,38
155767,2023-06-20 19:27:24,1175984426,48050,34,25,9,4,21
155779,2023-06-20 19:28:27,1175985827,127401,277,97,52,16,81
155780,2023-06-20 19:30:19,1175988400,116753,61,67,26,3,64
123364,2023-06-20 20:52:17,1176102507,1556,1,4,3,1,3
155799,2023-06-20 21:31:32,1176141613,17360,193,66,10,3,63
155799,2023-06-20 21:31:35,1176141662,17360,193,66,10,3,63
155799,2023-06-20 21:31:38,1176141697,17360,193,66,10,3,63
155797,2023-06-20 21:56:06,1176160464,13138,33,27,24,1,26
155797,2023-06-20 21:56:12,1176160540,13138,33,27,24,1,26
155805,2023-06-20 21:56:21,1176160641,100731,163,61,21,10,51
141863,2023-06-20 23:35:44,1176234853,10000,39,25,20,1,24
155755,2023-06-21 14:46:58,1176529550,34701,3,6,3,1,5
155755,2023-06-21 14:47:03,1176529601,34701,3,6,3,1,5
155851,2023-06-21 15:44:05,1176568019,7639,24,16,1,1,15
155853,2023-06-21 16:22:27,1176593163,38560,69,35,14,4,31
155853,2023-06-21 16:22:31,1176593214,38560,69,35,14,4,31
114445,2023-06-21 18:35:07,1176693211,6654,32,33,16,2,31
125015,2023-06-21 18:35:52,1176693776,21872,10,9,4,1,8
114442,2023-06-21 18:36:19,1176694130,3075,34,12,3,1,11
145846,2023-06-21 18:37:09,1176694786,3987,25,12,8,2,10
145842,2023-06-21 18:37:38,1176695121,0,0,11,9,0,11
114443,2023-06-21 18:38:11,1176695588,8677,12,9,4,1,8
145845,2023-06-21 18:38:43,1176695973,8968,156,10,3,2,8
155862,2023-06-21 18:43:46,1176699795,48413,367,12,7,5,7
155863,2023-06-21 18:46:27,1176701777,28371,194,61,23,7,54
155865,2023-06-21 18:47:18,1176702440,54923,143,64,34,4,60
145352,2023-06-21 18:56:51,1176709483,8057,25,6,3,1,5
145352,2023-06-21 18:56:56,1176709525,8057,25,6,3,1,5
155885,2023-06-21 19:38:04,1176739952,73884,319,23,4,11,12
155885,2023-06-21 19:38:07,1176739996,73884,319,23,4,11,12
147270,2023-06-21 19:41:32,1176742544,3064,28,14,7,1,13
147270,2023-06-21 19:41:38,1176742591,3064,28,14,7,1,13
155886,2023-06-21 19:45:48,1176745524,23962,179,13,5,3,10
155889,2023-06-21 20:35:23,1176779274,20360,421,73,15,6,67
155889,2023-06-21 20:35:27,1176779315,20360,421,73,15,6,67
155867,2023-06-21 20:39:32,1176782187,0,12,6,4,0,6
155892,2023-06-21 21:39:55,1176826916,27197,211,17,4,7,10
155892,2023-06-21 21:39:59,1176826987,27197,211,17,4,7,10
147095,2023-06-21 21:47:34,1176832818,19881,35,19,13,4,15
145181,2023-06-21 22:29:40,1176864233,1478,16,18,12,2,16
145181,2023-06-21 22:29:41,1176864269,1478,16,18,12,2,16
145181,2023-06-21 22:29:43,1176864293,1478,16,18,12,2,16
155891,2023-06-21 22:33:27,1176867082,87002,113,33,22,4,29
155890,2023-06-21 22:34:01,1176867466,73467,54,20,5,3,17
121665,2023-06-21 23:08:43,1176890293,33819,106,74,54,2,72
145177,2023-06-21 23:09:22,1176890726,6837,5,28,10,1,27
145176,2023-06-21 23:10:00,1176891149,50712,109,24,16,4,20
121663,2023-06-21 23:10:38,1176891521,31306,118,89,67,7,82
145647,2023-06-21 23:11:11,1176891880,4790,11,21,12,2,19
145179,2023-06-21 23:11:32,1176892104,0,0,5,3,0,5
146110,2023-06-21 23:11:54,1176892307,12336,66,7,4,1,6
75542,2023-06-22 14:33:07,1177101537,13054,99,62,4,2,60
75542,2023-06-22 14:33:12,1177101563,13054,99,62,4,2,60
155924,2023-06-22 15:00:04,1177111072,20191,61,21,12,4,17
155925,2023-06-22 15:00:30,1177111240,0,0,19,8,0,19
98597,2023-06-22 15:11:12,1177115923,0,2,6,0,0,6
122863,2023-06-22 15:48:01,1177141455,14516,232,21,8,4,17
85209,2023-06-22 15:54:54,1177148919,33254,27,10,1,3,7
155951,2023-06-22 16:13:23,1177171258,13054,99,62,4,2,60
155951,2023-06-22 16:13:26,1177171326,13054,99,62,4,2,60
33382,2023-06-22 16:14:00,1177172043,48116,118,131,63,7,124
33382,2023-06-22 16:14:10,1177172268,48116,118,131,63,7,124
155955,2023-06-22 16:24:35,1177184959,60678,87,15,10,4,11
155959,2023-06-22 16:43:36,1177208099,32840,181,47,31,8,39
155959,2023-06-22 16:43:39,1177208168,32840,181,47,31,8,39
155959,2023-06-22 16:43:42,1177208227,32840,181,47,31,8,39
155962,2023-06-22 16:51:55,1177217205,28941,179,35,25,5,30
155962,2023-06-22 16:51:58,1177217261,28941,179,35,25,5,30
155966,2023-06-22 17:18:37,1177250893,71195,185,79,49,9,70
155968,2023-06-22 17:53:02,1177292824,38971,76,22,10,5,17
155968,2023-06-22 17:53:05,1177292898,38971,76,22,10,5,17
155970,2023-06-22 18:11:36,1177313702,19221,106,82,49,4,78
155971,2023-06-22 18:23:50,1177328191,51645,161,48,28,9,39
155973,2023-06-22 18:31:49,1177337619,7727,24,13,5,4,9
155983,2023-06-22 18:42:57,1177351496,57505,100,57,28,6,51
155983,2023-06-22 18:43:02,1177351584,57505,100,57,28,6,51
155985,2023-06-22 18:57:48,1177370032,72450,115,30,15,7,23
155988,2023-06-22 19:11:56,1177379836,8213,29,4,2,3,1
155988,2023-06-22 19:12:02,1177379900,8213,29,4,2,3,1
155952,2023-06-22 19:13:29,1177380923,182371,46,19,10,1,18
155954,2023-06-22 19:13:49,1177381140,228009,151,72,11,5,67
155957,2023-06-22 19:13:58,1177381233,185101,54,16,10,2,14
155960,2023-06-22 19:14:22,1177381515,48417,98,15,7,2,13
155967,2023-06-22 19:15:12,1177382096,12315,51,28,4,2,26
155989,2023-06-22 19:15:24,1177382237,182371,24,1,0,1,0
155990,2023-06-22 19:15:38,1177382386,190760,55,41,24,3,38
155992,2023-06-22 19:16:57,1177383276,99507,317,56,36,12,44
155986,2023-06-22 19:18:57,1177384600,57436,201,22,9,8,14
156003,2023-06-22 19:38:48,1177397562,36515,106,35,17,15,20
156006,2023-06-22 19:56:31,1177410229,45445,126,99,26,5,94
156006,2023-06-22 19:56:33,1177410257,45445,126,99,26,5,94
156006,2023-06-22 19:56:35,1177410297,45445,126,99,26,5,94
145707,2023-06-22 19:58:09,1177411499,25076,137,32,24,6,26
156004,2023-06-22 20:03:08,1177415087,3426,19,31,16,1,30
156005,2023-06-22 20:03:21,1177415228,52537,58,19,4,3,16
156007,2023-06-22 20:03:45,1177415493,28940,57,42,13,3,39
151508,2023-06-22 20:08:59,1177419140,4195,20,36,22,2,34
151505,2023-06-22 20:09:18,1177419424,11263,16,10,7,2,8
156009,2023-06-22 21:12:27,1177478080,6347,26,20,1,1,19
156013,2023-06-22 22:09:42,1177547757,42244,133,24,14,6,18
156013,2023-06-22 22:09:46,1177547839,42244,133,24,14,6,18
156013,2023-06-22 22:09:49,1177547900,42244,133,24,14,6,18
156010,2023-06-22 22:25:11,1177566718,181554,50,24,21,3,21
156027,2023-06-22 22:25:41,1177567280,0,0,6,3,0,6
156011,2023-06-22 22:25:47,1177567391,200948,121,25,24,4,21
156012,2023-06-22 22:26:04,1177567744,50673,123,11,9,7,4
156014,2023-06-22 22:26:15,1177567968,0,3,11,10,0,11
156023,2023-06-22 22:26:42,1177568509,19984,8,16,13,1,15
143960,2023-06-22 22:27:38,1177569638,76074,99,31,12,7,24
143960,2023-06-22 22:27:40,1177569699,76074,99,31,12,7,24
156029,2023-06-22 22:35:16,1177578383,43302,127,47,27,3,44
156030,2023-06-22 22:45:02,1177588489,53575,111,62,42,5,57
156030,2023-06-22 22:45:07,1177588582,53575,111,62,42,5,57
141330,2023-06-22 22:47:29,1177590909,782,54,16,11,1,15
156031,2023-06-22 22:53:28,1177596916,185904,300,120,72,8,112
156036,2023-06-23 00:16:12,1177673196,7196,98,34,14,2,32
156036,2023-06-23 00:16:14,1177673220,7196,98,34,14,2,32
156036,2023-06-23 00:16:15,1177673229,7196,98,34,14,2,32
156046,2023-06-23 14:25:06,1177899197,80167,49,59,46,3,56
156046,2023-06-23 14:25:11,1177899239,80167,49,65,50,3,62
156047,2023-06-23 15:01:19,1177911542,0,5,8,6,0,8
156050,2023-06-23 15:02:55,1177912113,35692,170,84,41,7,77
66881,2023-06-23 15:10:45,1177915494,215578,205,47,22,9,38
66881,2023-06-23 15:10:48,1177915519,215578,205,47,22,9,38
156053,2023-06-23 15:20:40,1177919944,6061,16,10,4,3,7
156053,2023-06-23 15:20:43,1177919960,6061,16,10,4,3,7
156053,2023-06-23 15:20:45,1177919994,6061,16,10,4,3,7
156038,2023-06-23 16:05:14,1177942817,0,23,16,12,0,16
156049,2023-06-23 16:06:13,1177943309,13957,119,24,16,3,21
156067,2023-06-23 16:29:01,1177956608,0,0,8,4,0,8
156068,2023-06-23 16:38:32,1177962656,22973,186,27,19,7,20
156048,2023-06-23 16:46:13,1177967385,25968,69,24,17,3,21
144471,2023-06-23 17:01:05,1177976572,0,24,25,13,0,25
143347,2023-06-23 17:10:01,1177983496,6341,38,43,25,2,41
143348,2023-06-23 17:10:24,1177983796,0,0,7,4,0,7
142683,2023-06-23 17:10:49,1177984036,14713,124,15,8,4,11
140991,2023-06-23 17:11:08,1177984232,7537,46,24,18,2,22
144021,2023-06-23 17:32:42,1177998812,186992,52,27,20,4,23
144098,2023-06-23 17:33:03,1177999064,35574,61,14,6,3,11
123021,2023-06-23 17:54:08,1178013517,0,0,13,7,0,13
123021,2023-06-23 17:54:11,1178013553,0,0,13,7,0,13
123021,2023-06-23 17:54:13,1178013580,0,0,13,7,0,13
123028,2023-06-23 17:58:51,1178016732,18365,39,24,12,1,23
123028,2023-06-23 17:58:52,1178016750,18365,39,24,12,1,23
123028,2023-06-23 17:58:54,1178016772,18365,39,24,12,1,23
156092,2023-06-23 19:11:59,1178065767,82466,151,104,36,7,97
156101,2023-06-23 19:45:23,1178087757,17811,24,5,4,1,4
156107,2023-06-23 21:21:11,1178145600,47917,58,93,48,2,91
156107,2023-06-23 21:21:15,1178145653,47917,58,93,48,2,91
156108,2023-06-23 21:23:26,1178146862,15083,55,25,7,2,23
156099,2023-06-23 22:15:46,1178242593,67789,177,38,16,7,31
156114,2023-06-23 22:16:06,1178243096,5931,27,3,1,2,1
156114,2023-06-23 22:16:07,1178243145,5931,27,3,1,2,1
156102,2023-06-23 22:17:01,1178244509,2810,134,11,6,1,10
156104,2023-06-23 22:18:40,1178247013,0,0,3,0,0,3
156105,2023-06-23 22:20:29,1178249846,34855,67,41,27,4,37
156112,2023-06-23 22:22:26,1178252896,0,0,5,1,0,5
156113,2023-06-23 22:23:31,1178254576,9987,113,38,22,5,33
156109,2023-06-23 22:25:37,1178257786,91138,106,36,30,6,30
156110,2023-06-23 22:26:30,1178259133,110880,177,56,37,5,51
156111,2023-06-23 22:26:43,1178259483,127932,228,44,32,8,36
151817,2023-06-23 22:28:43,1178262607,6024,225,15,4,3,12
151819,2023-06-23 22:29:40,1178264067,23813,51,30,17,4,26
156106,2023-06-23 22:57:34,1178316350,23960,77,13,9,4,9
156141,2023-06-24 15:47:18,1179824469,71426,68,40,30,5,35
156142,2023-06-24 15:59:34,1179829024,27845,95,13,8,6,7
156142,2023-06-24 15:59:36,1179829044,27845,95,13,8,6,7
156145,2023-06-24 16:05:37,1179831379,7754,34,9,3,1,8
123164,2023-06-24 16:05:51,1179831470,5644,48,191,25,2,189
123164,2023-06-24 16:05:54,1179831486,5644,48,191,25,2,189
156146,2023-06-24 16:12:14,1179833923,86658,270,86,27,19,67
156128,2023-06-24 16:13:56,1179834568,9933,8,18,8,2,16
156129,2023-06-24 16:19:17,1179836679,18263,20,55,12,4,51
156129,2023-06-24 16:19:19,1179836691,18263,20,55,12,4,51
156130,2023-06-24 16:22:44,1179838048,22340,263,22,11,6,16
156147,2023-06-24 16:23:48,1179838494,12245,12,10,7,3,7
156138,2023-06-24 16:24:59,1179839004,40351,44,30,19,6,24
156139,2023-06-24 16:28:03,1179840282,28998,47,32,11,7,25
156140,2023-06-24 16:31:16,1179841652,5176,13,7,2,2,5
156148,2023-06-24 17:15:14,1179862818,44039,218,22,15,8,14
156149,2023-06-24 17:49:18,1179880011,17770,40,23,16,1,22
156152,2023-06-24 17:50:51,1179880780,11377,77,16,12,3,13
156156,2023-06-24 17:52:17,1179881490,19885,232,19,11,3,16
154946,2023-06-24 18:17:26,1179894778,18597,28,19,12,2,17
154946,2023-06-24 18:17:29,1179894794,18597,28,19,12,2,17
154946,2023-06-24 18:17:30,1179894815,18597,28,19,12,2,17
154946,2023-06-24 18:17:31,1179894825,18597,28,19,12,2,17
154946,2023-06-24 18:17:32,1179894834,18597,28,19,12,2,17
156157,2023-06-24 18:35:19,1179904050,86983,127,36,14,5,31
156157,2023-06-24 18:35:21,1179904053,86983,127,36,14,5,31
156157,2023-06-24 18:35:20,1179904054,86983,127,36,14,5,31
156158,2023-06-24 18:53:57,1179913990,16959,44,14,9,2,12
156151,2023-06-24 18:54:12,1179914132,3960,15,3,3,2,1
156159,2023-06-24 18:56:05,1179915111,235364,124,38,20,12,26
156160,2023-06-24 19:01:04,1179917865,72593,36,18,15,4,14
156161,2023-06-24 19:07:21,1179921418,72130,13,28,4,4,24
156117,2023-06-24 19:18:47,1179927522,0,1,7,5,0,7
146231,2023-06-26 14:53:03,1180535673,12215,26,15,10,1,14
146231,2023-06-26 14:53:06,1180535690,12215,26,15,10,1,14
146273,2023-06-26 14:53:30,1180535863,27698,195,34,24,7,27
146386,2023-06-26 14:54:16,1180536241,21868,33,43,31,2,41
146384,2023-06-26 14:54:52,1180536487,6417,25,7,2,1,6
146384,2023-06-26 14:54:54,1180536505,6417,25,7,2,1,6
146389,2023-06-26 14:55:25,1180536729,870,95,5,2,2,3
146677,2023-06-26 14:55:59,1180536903,14767,254,144,90,4,140
146677,2023-06-26 14:56:02,1180536913,14767,254,144,90,4,140
146675,2023-06-26 14:56:33,1180537092,4570,129,88,59,1,87
156202,2023-06-26 14:58:39,1180537919,39353,57,63,38,4,59
156204,2023-06-26 15:35:16,1180555148,15879,74,14,9,3,11
156204,2023-06-26 15:35:22,1180555190,15879,74,14,9,3,11
156205,2023-06-26 15:42:41,1180559256,2169,20,5,0,2,3
156205,2023-06-26 15:42:43,1180559269,2169,20,5,0,2,3
156205,2023-06-26 15:42:45,1180559280,2169,20,5,0,2,3
156153,2023-06-26 15:47:28,1180561819,53172,105,30,25,4,26
133088,2023-06-26 15:49:26,1180562919,2559,22,24,18,3,21
134559,2023-06-26 15:49:55,1180563157,13708,116,7,4,4,3
134558,2023-06-26 15:51:05,1180563823,41254,27,29,20,2,27
134558,2023-06-26 15:51:09,1180563869,41254,27,29,20,2,27
133897,2023-06-26 15:51:26,1180564032,582,5,3,0,1,2
144578,2023-06-26 15:53:40,1180565161,3101,77,84,33,3,81
156207,2023-06-26 16:09:46,1180574489,25861,65,29,24,4,25
156207,2023-06-26 16:09:49,1180574518,25861,65,29,24,4,25
133086,2023-06-26 16:17:30,1180579589,11263,54,55,32,5,50
133086,2023-06-26 16:17:34,1180579616,11263,54,55,32,5,50
133086,2023-06-26 16:17:35,1180579633,11263,54,55,32,5,50
133085,2023-06-26 16:17:56,1180579859,7195,43,37,25,2,35
156209,2023-06-26 16:21:53,1180582455,43302,129,34,18,5,29
156211,2023-06-26 16:22:26,1180582825,29959,79,26,20,6,20
156212,2023-06-26 16:22:55,1180583071,65551,119,52,15,5,47
156214,2023-06-26 16:23:34,1180583524,0,16,16,10,0,16
156208,2023-06-26 16:52:19,1180603132,38985,88,78,42,3,75
156208,2023-06-26 16:52:23,1180603185,38985,88,78,42,3,75
156210,2023-06-26 16:53:08,1180603769,94504,249,42,26,6,36
156210,2023-06-26 16:53:10,1180603781,94504,249,42,26,6,36
156210,2023-06-26 16:53:14,1180603834,94504,249,42,26,6,36
156213,2023-06-26 16:54:09,1180604520,697,24,30,24,2,28
156216,2023-06-26 16:55:17,1180605259,116926,268,65,49,8,57
156219,2023-06-26 16:56:33,1180606100,2312,163,21,7,2,19
156220,2023-06-26 16:57:50,1180606965,56392,27,29,22,1,28
156222,2023-06-26 17:00:15,1180608609,28741,189,24,11,9,15
123029,2023-06-26 17:00:47,1180609007,4419,35,24,17,2,22
123029,2023-06-26 17:00:50,1180609048,4419,35,24,17,2,22
156217,2023-06-26 17:06:23,1180613505,24121,10,32,26,4,28
156231,2023-06-26 17:06:29,1180613566,43095,114,42,12,7,35
156234,2023-06-26 17:10:01,1180616424,10164,36,5,1,5,0
156237,2023-06-26 17:13:22,1180619192,65051,327,66,13,14,52
156238,2023-06-26 17:17:08,1180622306,18718,110,30,15,3,27
156241,2023-06-26 17:21:38,1180625960,5989,26,11,5,2,9
136169,2023-06-26 17:49:37,1180646887,2583,129,14,5,6,8
136251,2023-06-26 17:54:29,1180650621,26908,50,86,64,2,84
136427,2023-06-26 17:56:23,1180652040,14154,61,39,25,3,36
136427,2023-06-26 17:56:26,1180652071,14154,61,39,25,3,36
156247,2023-06-26 18:06:11,1180659702,167560,284,107,35,14,93
156247,2023-06-26 18:06:22,1180659827,167560,284,107,35,14,93
135968,2023-06-26 18:07:53,1180661112,3253,21,22,15,1,21
146551,2023-06-26 18:09:04,1180662126,28495,59,19,15,3,16
146551,2023-06-26 18:09:06,1180662167,28495,59,19,15,3,16
146400,2023-06-26 18:09:34,1180662545,1853,9,15,10,1,14
146400,2023-06-26 18:09:37,1180662575,1853,9,15,10,1,14
145850,2023-06-26 19:04:10,1180705423,17895,34,19,8,4,15
145701,2023-06-26 19:06:34,1180707300,11012,18,11,3,3,8
145708,2023-06-26 19:07:01,1180707618,11875,52,12,4,4,8
140340,2023-06-26 19:07:32,1180707999,10058,92,19,7,4,15
146747,2023-06-26 19:08:24,1180708685,6467,40,64,19,1,63
146210,2023-06-26 19:08:56,1180709067,13789,9,6,5,3,3
146845,2023-06-26 19:27:49,1180723757,17316,58,15,4,5,10
146845,2023-06-26 19:27:55,1180723812,17316,58,15,4,5,10
145944,2023-06-26 19:28:18,1180724143,12176,17,30,11,2,28
145922,2023-06-26 19:28:54,1180724576,2904,8,13,7,1,12
88528,2023-06-26 19:32:20,1180727127,92916,201,69,40,9,60
146051,2023-06-26 19:33:14,1180727832,0,0,1,0,0,1
145933,2023-06-26 19:34:56,1180729076,50212,47,37,22,6,31
145933,2023-06-26 19:34:59,1180729112,50212,47,37,22,6,31
156260,2023-06-26 19:50:49,1180740908,0,0,5,1,0,5
156260,2023-06-26 19:50:52,1180740948,0,0,5,1,0,5
146390,2023-06-26 21:17:55,1180804189,0,0,1,0,0,1
147352,2023-06-26 21:18:29,1180804646,1100,36,28,13,1,27
95715,2023-06-26 22:16:26,1180845066,33644,39,48,23,1,47
95711,2023-06-26 22:32:46,1180865955,3000,248,79,34,1,78
95714,2023-06-26 22:34:08,1180867705,87751,50,45,22,2,43
156283,2023-06-26 22:49:06,1180888886,4221,3,57,33,1,56
156284,2023-06-26 22:54:06,1180895784,20514,183,93,60,4,89
154497,2023-06-26 23:13:55,1180911633,49120,144,11,7,7,4
154497,2023-06-26 23:14:00,1180911681,49120,144,11,7,7,4
156285,2023-06-26 23:14:17,1180911871,5038,17,63,44,4,59
72316,2023-06-27 14:32:41,1181134162,2376,14,77,33,1,76
156307,2023-06-27 14:46:27,1181138876,24898,108,18,14,3,15
89926,2023-06-27 15:24:38,1181155094,0,0,1,0,0,1
89926,2023-06-27 15:24:40,1181155108,0,0,1,0,0,1
89926,2023-06-27 15:24:44,1181155150,0,0,1,0,0,1
90971,2023-06-27 15:26:26,1181156094,41929,147,18,10,5,13
90971,2023-06-27 15:26:28,1181156108,41929,147,18,10,5,13
90342,2023-06-27 15:28:35,1181157301,27864,190,102,70,4,98
90342,2023-06-27 15:28:38,1181157343,27864,190,102,70,4,98
90431,2023-06-27 15:29:55,1181158053,2208,38,12,7,2,10
90431,2023-06-27 15:30:02,1181158109,2208,38,12,7,2,10
143086,2023-06-27 15:30:57,1181158633,0,0,1,0,0,1
156312,2023-06-27 15:35:54,1181161230,5745,70,38,26,2,36
156313,2023-06-27 15:36:04,1181161345,0,219,14,1,0,14
156316,2023-06-27 15:40:45,1181163900,47932,162,38,16,9,29
156315,2023-06-27 15:41:22,1181164281,20371,180,9,6,7,2
156278,2023-06-27 15:52:23,1181170816,2376,14,77,33,1,76
156278,2023-06-27 15:52:28,1181170860,2376,14,77,33,1,76
156324,2023-06-27 16:15:39,1181185672,48609,232,36,25,7,29
156150,2023-06-27 17:21:02,1181237016,86636,71,132,44,5,127
144318,2023-06-27 17:37:18,1181250877,16934,20,7,5,1,6
144318,2023-06-27 17:37:22,1181250923,16934,20,7,5,1,6
122028,2023-06-27 17:38:19,1181251689,0,0,5,3,0,5
121900,2023-06-27 17:38:55,1181252164,0,4,69,37,0,69
121898,2023-06-27 17:44:30,1181259157,152211,192,104,59,5,99
122171,2023-06-27 17:45:04,1181260080,5348,63,40,16,2,38
121896,2023-06-27 17:46:27,1181262192,20857,19,113,68,2,111
145883,2023-06-27 17:49:12,1181266100,24439,40,9,4,5,4
156347,2023-06-27 17:58:51,1181280448,7901,12,12,8,2,10
156350,2023-06-27 18:02:21,1181285716,9849,57,25,17,1,24
156350,2023-06-27 18:02:24,1181285799,9849,57,25,17,1,24
156357,2023-06-27 18:22:15,1181316316,19329,15,15,5,2,13
156356,2023-06-27 18:32:03,1181329366,33652,41,22,7,1,21
156359,2023-06-27 18:32:15,1181329642,131133,288,31,14,11,20
95704,2023-06-27 18:34:14,1181332001,3895,52,54,19,2,52
156364,2023-06-27 18:45:56,1181346950,37961,107,20,13,2,18
156355,2023-06-27 18:58:35,1181362787,23179,197,75,19,8,67
156355,2023-06-27 18:58:40,1181362925,23179,197,75,19,8,67
156322,2023-06-27 19:04:11,1181369948,19063,43,10,6,6,4
95719,2023-06-27 19:14:47,1181383177,2723,49,39,26,1,38
156373,2023-06-27 19:19:35,1181389034,5675,60,24,18,3,21
156385,2023-06-27 19:29:41,1181401012,10212,30,32,13,4,28
156385,2023-06-27 19:29:46,1181401114,10212,30,32,13,4,28
95720,2023-06-27 19:31:36,1181403390,0,25,31,17,0,31
156387,2023-06-27 19:36:08,1181408866,3851,24,2,0,1,1
156358,2023-06-27 19:44:31,1181418500,32407,286,44,29,6,38
156360,2023-06-27 19:45:34,1181419681,70461,58,86,27,4,82
156360,2023-06-27 19:45:39,1181419760,70461,58,86,27,4,82
156361,2023-06-27 19:46:13,1181420450,21341,87,19,13,4,15
156362,2023-06-27 19:46:45,1181420953,1034,17,3,2,1,2
156389,2023-06-27 19:47:13,1181421496,0,14,27,19,0,27
156392,2023-06-27 19:55:19,1181428565,40899,81,44,29,4,40
156342,2023-06-27 19:55:18,1181428568,182371,46,19,10,1,18
156343,2023-06-27 19:58:16,1181430972,228009,151,72,11,5,67
156351,2023-06-27 20:01:56,1181433870,185101,54,16,10,2,14
156352,2023-06-27 20:07:50,1181438635,48417,98,15,7,2,13
156365,2023-06-27 20:08:00,1181438772,3426,19,31,16,1,30
156366,2023-06-27 20:10:48,1181440919,28940,57,42,13,3,39
156367,2023-06-27 20:13:44,1181443209,181554,50,24,21,3,21
156372,2023-06-27 20:17:38,1181446304,200948,122,25,24,4,21
156395,2023-06-27 20:25:27,1181452758,17698,149,72,54,3,69
156374,2023-06-27 20:26:16,1181453483,0,3,11,10,0,11
156401,2023-06-27 20:29:16,1181455873,9763,28,30,15,3,27
156383,2023-06-27 20:31:00,1181457228,19984,8,16,14,1,15
156386,2023-06-27 20:31:21,1181457528,52537,58,19,4,3,16
156388,2023-06-27 20:34:28,1181460122,12315,51,28,4,2,26
156390,2023-06-27 20:36:51,1181462059,182371,24,1,0,1,0
145969,2023-06-27 20:39:04,1181463803,70709,163,119,65,8,111
156391,2023-06-27 20:41:03,1181465358,190760,55,41,24,3,38
156371,2023-06-27 20:43:47,1181467459,50673,123,11,9,7,4
123190,2023-06-27 21:46:47,1181521373,419,37,63,39,1,62
123186,2023-06-27 21:47:15,1181521821,1409,6,29,14,1,28
123193,2023-06-27 21:47:39,1181522138,14717,39,76,40,2,74
134553,2023-06-27 21:49:39,1181523792,16679,47,29,10,3,26
134695,2023-06-27 21:49:50,1181523980,20474,91,72,56,4,68
156408,2023-06-27 21:55:22,1181528713,1090,4,7,2,1,6
156426,2023-06-27 22:07:14,1181538930,61129,121,31,11,4,27
156417,2023-06-27 22:17:34,1181547719,28539,107,3,3,3,0
156429,2023-06-27 22:19:57,1181549702,33914,362,91,44,16,75
156418,2023-06-27 22:23:23,1181552589,39583,161,28,19,6,22
156419,2023-06-27 22:24:39,1181553676,15631,166,34,13,4,30
156430,2023-06-27 22:27:25,1181556009,107565,234,77,46,8,69
156430,2023-06-27 22:27:29,1181556065,107565,234,77,46,8,69
156422,2023-06-27 22:27:35,1181556182,7429,94,25,11,4,21
156431,2023-06-27 22:33:42,1181561372,92986,78,25,13,3,22
156434,2023-06-27 22:44:18,1181570396,1674,42,32,23,2,30
156435,2023-06-27 22:49:37,1181574760,895285,115,78,66,9,69
156435,2023-06-27 22:49:40,1181574809,895285,115,78,66,9,69
154825,2023-06-27 22:54:30,1181578703,44511,85,33,4,2,31
156439,2023-06-27 23:19:34,1181606092,3161,183,26,6,3,23
156432,2023-06-27 23:19:53,1181606487,91528,19,36,7,2,34
156327,2023-06-27 23:24:06,1181612312,4152,15,8,5,2,6
156330,2023-06-27 23:24:17,1181612590,50355,242,82,28,7,75
156331,2023-06-27 23:24:52,1181613474,553,30,5,4,1,4
156332,2023-06-27 23:25:06,1181613799,13948,57,25,15,3,22
146249,2023-06-28 14:37:48,1181940229,129528,181,34,21,5,29
147339,2023-06-28 14:50:37,1181946611,22430,69,14,12,2,12
156462,2023-06-28 14:53:46,1181948432,35327,136,21,11,7,14
129690,2023-06-28 14:54:09,1181948638,22430,53,41,19,1,40
129690,2023-06-28 14:54:16,1181948695,22430,53,40,19,1,39
129697,2023-06-28 14:58:02,1181950762,19246,160,44,11,3,41
129893,2023-06-28 15:05:38,1181955038,7388,8,37,16,1,36
129893,2023-06-28 15:05:44,1181955096,7388,8,37,16,1,36
134932,2023-06-28 15:11:52,1181958880,16730,75,19,7,1,18
129862,2023-06-28 15:16:03,1181961625,6307,51,31,13,2,29
123540,2023-06-28 15:20:18,1181964496,0,14,116,65,0,116
109634,2023-06-28 16:14:18,1182005439,2829,23,11,4,2,9
109547,2023-06-28 16:14:47,1182005794,96850,72,12,5,2,10
156478,2023-06-28 16:27:18,1182016400,30322,64,9,3,4,5
156478,2023-06-28 16:27:21,1182016454,30322,64,9,3,4,5
156497,2023-06-28 16:38:00,1182025636,54214,158,18,5,5,13
156494,2023-06-28 16:38:32,1182026184,10634,16,27,18,2,25
156499,2023-06-28 16:42:21,1182029547,8061,11,41,22,1,40
156499,2023-06-28 16:42:23,1182029565,8061,11,41,22,1,40
156503,2023-06-28 16:56:18,1182042044,89342,178,54,38,7,47
156505,2023-06-28 17:02:02,1182047162,146741,374,53,22,17,36
96320,2023-06-28 17:15:23,1182059190,309933,173,85,63,6,79
96320,2023-06-28 17:15:26,1182059229,309933,173,85,63,6,79
156506,2023-06-28 17:22:34,1182065961,19221,106,82,49,4,78
156515,2023-06-28 17:23:58,1182067187,0,0,7,3,0,7
156516,2023-06-28 17:27:26,1182070490,181757,68,21,6,4,17
156517,2023-06-28 17:31:12,1182074130,2083,43,5,2,1,4
156518,2023-06-28 17:46:02,1182088477,37965,137,37,14,6,31
156520,2023-06-28 17:49:46,1182091939,2904,16,2,1,1,1
156522,2023-06-28 17:59:27,1182101007,55050,70,6,3,2,4
156521,2023-06-28 17:59:33,1182101073,18449,61,13,6,3,10
122811,2023-06-28 19:13:12,1182170512,6754,85,31,23,2,29
156166,2023-06-28 20:42:29,1182253641,370449,372,69,20,17,52
156166,2023-06-28 20:42:32,1182253680,370449,372,69,20,17,52
156166,2023-06-28 20:42:34,1182253726,370449,372,69,20,17,52
122709,2023-06-28 20:46:33,1182257218,12212,27,16,12,2,14
156116,2023-06-28 20:55:11,1182264939,0,33,34,22,0,34
156116,2023-06-28 20:55:13,1182264974,0,33,34,22,0,34
156168,2023-06-28 21:00:49,1182269720,2804,38,60,35,1,59
156168,2023-06-28 21:00:51,1182269748,2804,38,60,35,1,59
156577,2023-06-28 21:26:10,1182289549,20724,157,60,57,6,54
156560,2023-06-28 21:32:23,1182294347,24690,35,96,55,2,94
156601,2023-06-28 22:05:03,1182320425,2486,3,10,9,1,9
156604,2023-06-28 22:12:40,1182326734,12858,137,60,48,4,56
156115,2023-06-28 22:20:02,1182332752,17689,136,62,36,5,57
156603,2023-06-28 23:00:14,1182366217,0,0,3,0,0,3
156603,2023-06-28 23:00:16,1182366243,0,0,3,0,0,3
156603,2023-06-28 23:00:18,1182366275,0,0,3,0,0,3
156603,2023-06-28 23:00:19,1182366291,0,0,3,0,0,3
156603,2023-06-28 23:00:20,1182366307,0,0,3,0,0,3
156603,2023-06-28 23:00:21,1182366320,0,0,3,0,0,3
156603,2023-06-28 23:00:25,1182366363,0,0,3,0,0,3
156624,2023-06-29 00:30:10,1182435348,50073,65,11,3,6,5
156624,2023-06-29 00:30:15,1182435403,50073,65,11,3,6,5
156626,2023-06-29 00:47:35,1182445824,2339,9,7,3,3,4
156632,2023-06-29 00:56:16,1182450848,29712,61,25,6,3,22
156625,2023-06-29 01:18:32,1182462677,29642,98,33,13,3,30
156627,2023-06-29 01:18:46,1182462788,176091,163,37,27,6,31
156628,2023-06-29 01:18:59,1182462896,21852,32,22,10,5,17
156631,2023-06-29 01:19:34,1182463209,5151,165,3,2,3,0
156633,2023-06-29 01:19:46,1182463290,140522,148,65,29,8,57
156634,2023-06-29 01:19:54,1182463362,12742,35,2,1,2,0
156636,2023-06-29 01:20:04,1182463434,51215,120,44,23,4,40
156637,2023-06-29 01:20:13,1182463544,53062,62,20,9,3,17
156638,2023-06-29 01:20:21,1182463603,178851,120,48,20,10,38
156639,2023-06-29 01:29:48,1182468053,37965,137,37,14,6,31
142607,2023-06-29 14:06:06,1182714335,112039,221,224,36,10,214
142607,2023-06-29 14:06:09,1182714361,112039,221,224,36,10,214
146261,2023-06-29 14:06:47,1182714508,4021,200,268,15,5,263
146272,2023-06-29 14:07:22,1182714682,3760,32,13,6,3,10
146260,2023-06-29 14:09:12,1182715209,0,0,24,12,0,24
145768,2023-06-29 14:09:55,1182715395,5969,71,59,47,4,55
146263,2023-06-29 14:10:39,1182715627,3626,25,11,6,2,9
145709,2023-06-29 14:12:11,1182716052,0,0,7,0,0,7
146401,2023-06-29 14:12:53,1182716259,10125,104,58,28,7,51
156666,2023-06-29 14:38:16,1182724759,77960,60,26,16,5,21
156665,2023-06-29 14:38:59,1182725003,89341,143,38,28,6,32
156619,2023-06-29 15:44:53,1182759526,137945,149,92,27,26,66
156619,2023-06-29 15:44:56,1182759554,137945,149,92,27,26,66
156619,2023-06-29 15:44:58,1182759575,137945,149,92,27,26,66
156619,2023-06-29 15:44:59,1182759588,137945,149,92,27,26,66
156619,2023-06-29 15:45:01,1182759618,137945,149,92,27,26,66
146956,2023-06-29 15:52:13,1182765055,8068,24,32,14,2,30
146909,2023-06-29 15:52:49,1182765521,33577,30,44,24,1,43
147032,2023-06-29 15:53:24,1182765953,0,0,10,5,0,10
146988,2023-06-29 15:54:07,1182766447,0,2,6,0,0,6
146846,2023-06-29 15:55:13,1182767319,9132,119,53,20,3,50
146652,2023-06-29 15:55:43,1182767719,30842,31,23,20,1,22
156699,2023-06-29 15:55:51,1182767808,32525,46,39,26,3,36
146992,2023-06-29 15:56:04,1182767997,0,3,4,2,0,4
156700,2023-06-29 15:56:30,1182768346,31025,111,49,40,5,44
156715,2023-06-29 16:23:52,1182789282,20724,157,60,57,6,54
156718,2023-06-29 16:34:24,1182798031,12858,137,60,48,4,56
156718,2023-06-29 16:34:29,1182798068,12858,137,60,48,4,56
156716,2023-06-29 16:34:37,1182798171,2486,3,10,9,1,9
147563,2023-06-29 16:39:48,1182802385,65162,215,83,61,9,74
147578,2023-06-29 16:41:12,1182803587,38383,46,38,28,3,35
156616,2023-06-29 16:41:22,1182803718,0,0,8,2,0,8
156616,2023-06-29 16:41:23,1182803733,0,0,8,2,0,8
156616,2023-06-29 16:41:24,1182803760,0,0,8,2,0,8
147559,2023-06-29 16:42:15,1182804414,23078,200,49,25,4,45
147857,2023-06-29 16:42:53,1182804901,21302,71,114,95,4,110
136777,2023-06-29 16:43:39,1182805496,96619,169,176,82,9,167
136777,2023-06-29 16:43:41,1182805532,96619,169,176,82,9,167
137528,2023-06-29 16:44:15,1182806050,19085,19,16,12,2,14
137528,2023-06-29 16:44:18,1182806088,19085,19,16,12,2,14
147915,2023-06-29 16:45:26,1182807013,22057,18,25,7,2,23
156721,2023-06-29 16:53:57,1182814133,370449,372,69,20,17,52
156721,2023-06-29 16:53:58,1182814163,370449,372,69,20,17,52
156721,2023-06-29 16:53:59,1182814164,370449,372,69,20,17,52
156721,2023-06-29 16:54:01,1182814212,370449,372,69,20,17,52
156721,2023-06-29 16:54:02,1182814234,370449,372,69,20,17,52
156731,2023-06-29 17:09:01,1182826640,0,33,34,22,0,34
156734,2023-06-29 17:23:07,1182839193,0,0,7,3,0,7
156736,2023-06-29 17:29:30,1182844973,1141,121,34,15,1,33
156737,2023-06-29 17:31:03,1182846374,2083,43,5,2,1,4
156738,2023-06-29 17:32:51,1182847957,17689,136,62,36,5,57
156738,2023-06-29 17:32:52,1182847978,17689,136,62,36,5,57
156738,2023-06-29 17:32:53,1182847994,17689,136,62,36,5,57
156738,2023-06-29 17:32:54,1182848005,17689,136,62,36,5,57
156738,2023-06-29 17:32:56,1182848042,17689,136,62,36,5,57
156738,2023-06-29 17:32:57,1182848060,17689,136,62,36,5,57
156740,2023-06-29 17:38:19,1182852796,2683,9,18,12,2,16
64153,2023-06-29 17:48:26,1182861291,24073,67,49,33,2,47
156741,2023-06-29 17:49:09,1182861912,8253,28,48,25,1,47
156745,2023-06-29 18:07:24,1182877388,2904,16,2,1,1,1
156763,2023-06-29 18:20:19,1182889150,55050,70,6,3,2,4
156764,2023-06-29 18:24:43,1182892865,8113,55,77,47,3,74
156764,2023-06-29 18:24:47,1182892933,8113,55,77,47,3,74
156775,2023-06-29 18:43:36,1182910021,5530,10,13,7,2,11
156785,2023-06-29 19:11:12,1182934740,9116,68,41,29,2,39
156786,2023-06-29 19:11:48,1182935219,0,1,34,28,0,34
156795,2023-06-29 19:44:14,1182962266,4667,15,17,10,2,15
156796,2023-06-29 19:47:47,1182965336,15756,30,84,57,4,80
156796,2023-06-29 19:47:50,1182965382,15756,30,84,57,4,80
156735,2023-06-29 20:04:36,1182980644,21263,19,9,1,3,6
156754,2023-06-29 20:04:44,1182980760,58867,98,56,9,14,42
156765,2023-06-29 20:04:54,1182980896,185452,88,37,29,7,30
156776,2023-06-29 20:05:01,1182980996,119437,59,20,7,3,17
156789,2023-06-29 20:05:11,1182981173,68394,327,125,20,10,115
156794,2023-06-29 20:05:19,1182981305,163350,86,93,16,5,88
156800,2023-06-29 20:05:28,1182981428,11043,78,6,4,2,4
156802,2023-06-29 20:21:00,1182994796,2804,38,60,35,1,59
156802,2023-06-29 20:21:01,1182994814,2804,38,60,35,1,59
156802,2023-06-29 20:21:02,1182994815,2804,38,60,35,1,59
156802,2023-06-29 20:21:03,1182994832,2804,38,60,35,1,59
156802,2023-06-29 20:21:07,1182994908,2804,38,60,35,1,59
156802,2023-06-29 20:21:08,1182994941,2804,38,60,35,1,59
156802,2023-06-29 20:21:11,1182994986,2804,38,60,35,1,59
156802,2023-06-29 20:21:12,1182994992,2804,38,60,35,1,59
156802,2023-06-29 20:21:14,1182995017,2804,38,60,35,1,59
156802,2023-06-29 20:21:15,1182995038,2804,38,60,35,1,59
156802,2023-06-29 20:21:17,1182995064,2804,38,60,35,1,59
156802,2023-06-29 20:21:18,1182995083,2804,38,60,35,1,59
156804,2023-06-29 20:36:07,1183007201,7479,6,12,7,2,10
156833,2023-06-29 21:27:46,1183050996,14656,65,31,19,4,27
156837,2023-06-29 21:37:11,1183058859,14466,210,59,39,7,52
156837,2023-06-29 21:37:15,1183058917,14466,210,59,39,7,52
156850,2023-06-29 22:10:13,1183085695,19779,78,64,40,5,59
156862,2023-06-29 22:24:20,1183096647,85123,165,22,11,7,15
156862,2023-06-29 22:24:23,1183096679,85123,165,22,11,7,15
156863,2023-06-29 22:31:31,1183102493,4951,26,21,6,3,18
156863,2023-06-29 22:31:33,1183102508,4951,26,21,6,3,18
156871,2023-06-29 22:37:46,1183107465,12684,75,27,15,6,21
156872,2023-06-29 22:39:59,1183109213,205323,61,60,31,4,56
156875,2023-06-29 22:44:11,1183112382,13071,354,89,70,6,83
156834,2023-06-29 22:53:35,1183119764,59170,63,66,49,5,61
156879,2023-06-29 22:53:42,1183119850,118155,168,41,25,7,34
156879,2023-06-29 22:53:44,1183119885,118155,168,41,25,7,34
156881,2023-06-29 23:00:43,1183125554,3875,1,2,0,1,1
156883,2023-06-29 23:06:14,1183130566,52967,46,25,9,5,20
156882,2023-06-29 23:06:48,1183131022,62186,98,21,16,1,20
156876,2023-06-29 23:22:28,1183142906,93634,266,42,29,8,34
156878,2023-06-29 23:22:33,1183142964,2462,17,31,16,1,30
156878,2023-06-29 23:22:34,1183142970,2462,17,31,16,1,30
156884,2023-06-29 23:57:38,1183169097,4746,28,11,4,4,7
156891,2023-06-29 23:57:58,1183169293,76368,86,64,28,7,57
156818,2023-06-30 00:14:48,1183179133,48400,190,81,41,4,77
156816,2023-06-30 00:14:57,1183179224,38840,75,19,7,5,14
156901,2023-06-30 00:35:48,1183192786,155283,365,53,23,10,43
156911,2023-06-30 14:23:24,1183508186,1288,58,152,27,1,151
156913,2023-06-30 15:21:25,1183543480,42792,284,59,22,8,51
156918,2023-06-30 15:28:20,1183549607,130682,304,66,43,13,53
156918,2023-06-30 15:28:23,1183549646,130682,304,66,43,13,53
156915,2023-06-30 15:46:35,1183562090,9703,60,23,17,3,20
156917,2023-06-30 15:46:52,1183562255,45490,108,26,18,3,23
156931,2023-06-30 16:07:12,1183575921,63175,248,16,13,6,10
156940,2023-06-30 16:54:51,1183610167,25957,118,32,27,5,27
156941,2023-06-30 16:54:55,1183610210,155283,365,53,23,10,43
128625,2023-06-30 17:15:04,1183626610,32274,27,64,46,2,62
128618,2023-06-30 17:16:02,1183627453,3776,200,16,4,5,11
128674,2023-06-30 17:16:32,1183627892,109624,76,64,36,8,56
128619,2023-06-30 17:17:16,1183628519,142931,240,75,26,11,64
128630,2023-06-30 17:18:00,1183629085,13467,148,36,13,2,34
128629,2023-06-30 17:18:23,1183629484,2799,9,16,12,1,15
128626,2023-06-30 17:18:45,1183629797,6604,205,62,17,2,60
128627,2023-06-30 17:19:09,1183630155,83525,97,47,34,8,39
128628,2023-06-30 17:19:32,1183630449,14191,275,62,42,4,58
156944,2023-06-30 17:26:40,1183636436,0,0,5,3,0,5
156942,2023-06-30 18:42:53,1183703621,31984,127,29,22,9,20
156971,2023-06-30 18:59:24,1183718372,6574,36,10,1,3,7
156978,2023-06-30 19:14:20,1183731483,60237,129,24,9,5,19
156978,2023-06-30 19:14:23,1183731521,60237,129,24,9,5,19
156953,2023-06-30 19:46:44,1183758702,24740,86,42,16,2,40
157013,2023-06-30 19:55:43,1183766545,148635,85,51,27,7,44
157013,2023-06-30 19:55:47,1183766595,148635,85,51,27,7,44
115775,2023-06-30 19:58:58,1183769483,99340,120,41,34,5,36
115775,2023-06-30 19:59:00,1183769502,99340,120,41,34,5,36
115775,2023-06-30 19:59:01,1183769516,99340,120,41,34,5,36
95165,2023-06-30 20:03:53,1183773709,12978,163,62,30,4,58
95165,2023-06-30 20:03:55,1183773728,12978,163,62,30,4,58
94886,2023-06-30 20:15:50,1183784267,4746,42,45,25,1,44
94886,2023-06-30 20:15:52,1183784291,4746,42,45,25,1,44
94886,2023-06-30 20:15:54,1183784332,4746,42,45,25,1,44
157030,2023-06-30 20:25:14,1183792756,155283,365,53,23,10,43
157011,2023-06-30 20:44:41,1183809928,36600,16,12,5,1,11
157011,2023-06-30 20:44:44,1183809987,36600,16,12,5,1,11
157011,2023-06-30 20:44:45,1183809998,36600,16,12,5,1,11
157020,2023-06-30 21:34:58,1183854802,215740,101,13,11,5,8
157020,2023-06-30 21:35:00,1183854833,215740,101,13,11,5,8
2174,2023-06-30 22:22:06,1183893152,62943,71,19,12,3,16
2174,2023-06-30 22:22:11,1183893221,62943,71,19,12,3,16
157055,2023-06-30 22:51:25,1183914625,66972,159,13,9,8,5
129030,2023-06-30 23:09:56,1183928695,68485,131,74,48,7,67
129030,2023-06-30 23:10:01,1183928732,68485,131,74,48,7,67
157060,2023-06-30 23:13:28,1183931423,13396,46,9,5,2,7
157057,2023-06-30 23:19:51,1183936477,25957,118,32,27,5,27
157058,2023-06-30 23:20:00,1183936577,31984,127,29,22,9,20
157061,2023-06-30 23:20:28,1183936964,53931,24,25,18,4,21
157064,2023-06-30 23:27:52,1183942671,37870,63,12,5,5,7
157084,2023-07-01 00:20:51,1183981897,34970,76,65,47,4,61
157096,2023-07-01 01:12:49,1184020692,59016,63,40,18,5,35
157110,2023-07-01 15:00:37,1184309674,42637,530,76,25,6,70
157110,2023-07-01 15:00:40,1184309701,42637,530,76,25,6,70
157115,2023-07-01 15:25:25,1184322473,32472,161,110,48,7,103
157115,2023-07-01 15:25:27,1184322496,32472,161,110,48,7,103
157119,2023-07-01 15:46:07,1184333737,55086,57,19,16,5,14
157119,2023-07-01 15:46:11,1184333780,55086,57,19,16,5,14
157120,2023-07-01 16:00:09,1184342029,152491,163,25,14,10,15
157123,2023-07-01 17:00:55,1184381289,18449,61,13,6,3,10
157125,2023-07-01 17:05:10,1184384258,181757,68,21,6,4,17
156558,2023-07-01 17:50:08,1184416555,1420,9,62,44,1,61
156558,2023-07-01 17:50:13,1184416645,1420,9,62,44,1,61
157132,2023-07-01 18:59:01,1184468149,20563,141,12,5,4,8
157122,2023-07-03 15:33:48,1185393410,0,1,15,12,0,15
157156,2023-07-03 16:13:09,1185416330,17076,59,17,14,2,15
157162,2023-07-03 16:29:22,1185427065,3467,217,27,4,4,23
157165,2023-07-03 16:56:24,1185446157,62943,72,19,12,3,16
157171,2023-07-03 17:30:48,1185471820,36,22,29,0,1,28
157171,2023-07-03 17:30:54,1185471886,36,22,29,0,1,28
157177,2023-07-03 18:02:38,1185497858,15026,244,23,5,6,17
157177,2023-07-03 18:02:43,1185497924,15026,244,23,5,6,17
157179,2023-07-03 18:08:48,1185502817,76212,76,47,21,9,38
157181,2023-07-03 18:13:36,1185506763,71682,233,29,11,15,14
157181,2023-07-03 18:13:38,1185506798,71682,233,29,11,15,14
157176,2023-07-03 18:14:03,1185507089,718,20,9,0,2,7
157182,2023-07-03 18:21:38,1185513325,27045,71,35,15,8,27
157183,2023-07-03 18:53:40,1185539552,4680,109,21,7,8,13
157183,2023-07-03 18:53:45,1185539624,4680,109,21,7,8,13
157186,2023-07-03 19:05:48,1185549443,0,194,50,12,0,50
157188,2023-07-03 19:16:25,1185557936,6460,0,14,3,1,13
157188,2023-07-03 19:16:26,1185557947,6460,0,14,3,1,13
157188,2023-07-03 19:16:27,1185557964,6460,0,14,3,1,13
157188,2023-07-03 19:16:30,1185558004,6460,0,14,3,1,13
157188,2023-07-03 19:16:31,1185558025,6460,0,14,3,1,13
157188,2023-07-03 19:16:33,1185558052,6460,0,14,3,1,13
157188,2023-07-03 19:16:34,1185558067,6460,0,14,3,1,13
157188,2023-07-03 19:16:36,1185558083,6460,0,14,3,1,13
157199,2023-07-03 20:07:19,1185599901,64861,59,9,5,7,2
157203,2023-07-03 20:18:43,1185609096,36522,93,69,14,6,63
157205,2023-07-03 20:27:11,1185616082,858,12,77,33,1,76
93625,2023-07-03 21:45:24,1185676939,13325,119,132,74,6,126
93622,2023-07-03 21:45:55,1185677297,11389,222,88,36,8,80
157211,2023-07-03 21:46:24,1185677721,36612,188,38,30,4,34
157213,2023-07-03 22:08:41,1185695112,36945,55,22,12,4,18
157213,2023-07-03 22:08:46,1185695170,36945,55,22,12,4,18
157214,2023-07-03 22:08:59,1185695330,74758,147,18,2,6,12
157214,2023-07-03 22:09:03,1185695392,74758,147,18,2,6,12
157216,2023-07-03 22:38:12,1185717417,52243,144,29,23,8,21
157216,2023-07-03 22:38:16,1185717470,52243,144,29,23,8,21
157238,2023-07-04 14:48:00,1186025045,95532,244,24,8,10,14
157238,2023-07-04 14:48:02,1186025066,95532,244,24,8,10,14
157239,2023-07-04 14:57:13,1186028693,210431,191,91,67,7,84
157257,2023-07-04 16:30:07,1186081310,51285,36,17,12,2,15
104226,2023-07-04 17:19:06,1186117075,97691,88,41,6,3,38
93680,2023-07-04 17:22:51,1186120006,0,10,78,54,0,78
157178,2023-07-04 17:29:16,1186124885,0,18,33,4,0,33
157178,2023-07-04 17:29:17,1186124901,0,18,33,4,0,33
157261,2023-07-04 17:30:19,1186125604,0,1,16,12,0,16
157184,2023-07-04 17:46:41,1186138294,15839,64,5,1,1,4
157184,2023-07-04 17:46:42,1186138304,15839,64,5,1,1,4
157184,2023-07-04 17:46:45,1186138328,15839,64,5,1,1,4
157184,2023-07-04 17:46:46,1186138334,15839,64,5,1,1,4
157262,2023-07-04 17:48:31,1186139755,6794,72,4,2,2,2
157267,2023-07-04 18:04:40,1186152737,71670,112,50,25,6,44
157266,2023-07-04 18:05:21,1186153360,43045,81,26,10,3,23
157270,2023-07-04 18:14:12,1186160274,3875,64,7,5,3,4
157271,2023-07-04 18:16:35,1186162131,97691,88,41,6,3,38
157271,2023-07-04 18:16:41,1186162202,97691,88,41,6,3,38
157272,2023-07-04 18:21:13,1186165695,10294,19,18,8,3,15
157185,2023-07-04 18:26:56,1186170284,57213,31,16,9,4,12
157185,2023-07-04 18:26:58,1186170307,57213,31,16,9,4,12
157185,2023-07-04 18:27:01,1186170351,57213,31,16,9,4,12
157185,2023-07-04 18:27:03,1186170381,57213,31,16,9,4,12
157189,2023-07-04 18:37:27,1186178344,0,0,1,0,0,1
157189,2023-07-04 18:37:31,1186178405,0,0,1,0,0,1
157189,2023-07-04 18:37:32,1186178412,0,0,1,0,0,1
157198,2023-07-04 18:39:24,1186179934,29420,140,42,29,2,40
157204,2023-07-04 18:51:40,1186189638,0,1,46,20,0,46
157204,2023-07-04 18:51:41,1186189668,0,1,46,20,0,46
157204,2023-07-04 18:51:45,1186189716,0,1,46,20,0,46
157204,2023-07-04 18:51:46,1186189728,0,1,46,20,0,46
157204,2023-07-04 18:51:47,1186189746,0,1,46,20,0,46
157204,2023-07-04 18:51:48,1186189765,0,1,46,20,0,46
157204,2023-07-04 18:51:52,1186189810,0,1,46,20,0,46
157278,2023-07-04 19:13:51,1186207169,51362,101,22,7,9,13
93615,2023-07-04 19:23:46,1186215341,16587,24,33,23,3,30
157194,2023-07-04 19:29:50,1186220127,6872,39,26,10,2,24
157194,2023-07-04 19:29:54,1186220193,6872,39,26,10,2,24
157194,2023-07-04 19:29:55,1186220201,6872,39,26,10,2,24
157194,2023-07-04 19:29:56,1186220213,6872,39,26,10,2,24
157194,2023-07-04 19:29:57,1186220234,6872,39,26,10,2,24
157194,2023-07-04 19:29:58,1186220254,6872,39,26,10,2,24
157279,2023-07-04 19:30:35,1186220753,1493,49,8,5,1,7
157280,2023-07-04 19:38:10,1186226638,175586,112,20,12,10,10
157282,2023-07-04 19:47:24,1186233889,69211,191,33,15,2,31
157169,2023-07-04 19:58:54,1186242652,0,10,24,20,0,24
157201,2023-07-04 20:00:41,1186243964,426241,338,67,31,15,52
157286,2023-07-04 20:02:16,1186245143,0,0,5,2,0,5
157290,2023-07-04 20:23:03,1186261642,38720,66,9,6,6,3
157292,2023-07-04 20:28:02,1186265819,111956,193,40,35,6,34
157294,2023-07-04 20:33:26,1186270031,8180,79,43,32,3,40
157296,2023-07-04 20:38:21,1186273835,41219,59,9,8,2,7
157297,2023-07-04 20:48:03,1186281441,7769,16,57,33,1,56
157307,2023-07-04 20:57:06,1186288375,7409,36,67,38,3,64
45740,2023-07-04 21:01:44,1186291904,54723,177,109,27,6,103
157308,2023-07-04 21:06:43,1186295765,0,6,30,20,0,30
157285,2023-07-04 21:07:22,1186296290,6240,53,28,10,2,26
157285,2023-07-04 21:07:25,1186296321,6240,53,28,10,2,26
157310,2023-07-04 21:17:36,1186304363,0,1,26,18,0,26
157310,2023-07-04 21:17:37,1186304378,0,1,26,18,0,26
157310,2023-07-04 21:17:40,1186304419,0,1,26,18,0,26
157317,2023-07-04 21:55:43,1186333673,27672,46,12,4,6,6
157316,2023-07-04 21:56:25,1186334172,32935,44,12,7,3,9
157318,2023-07-04 22:02:35,1186339138,15902,47,9,2,3,6
157320,2023-07-04 22:07:44,1186342701,86703,125,60,27,8,52
157323,2023-07-04 22:18:44,1186350414,103788,291,64,36,7,57
157321,2023-07-04 22:24:09,1186354140,34089,49,24,10,4,20
157327,2023-07-04 22:26:35,1186355755,107337,299,116,58,6,110
157329,2023-07-04 22:36:57,1186362903,14486,81,2,2,1,1
157328,2023-07-04 22:39:57,1186365155,124530,73,31,12,7,24
157342,2023-07-05 14:19:34,1186657700,8127,22,22,14,1,21
157291,2023-07-05 15:18:07,1186680363,884,15,99,6,1,98
157312,2023-07-05 15:19:12,1186680987,14110,9,23,1,2,21
157363,2023-07-05 16:28:04,1186723003,55560,30,53,45,3,50
157371,2023-07-05 16:47:05,1186737170,3074,105,16,6,1,15
157371,2023-07-05 16:47:06,1186737191,3074,105,16,6,1,15
157371,2023-07-05 16:47:07,1186737207,3074,105,16,6,1,15
157375,2023-07-05 17:07:37,1186752298,73014,37,130,59,6,124
157373,2023-07-05 17:11:49,1186755633,20408,62,25,3,2,23
157376,2023-07-05 17:12:00,1186755765,56237,112,79,56,4,75
157378,2023-07-05 17:12:09,1186755915,203791,326,72,38,11,61
157382,2023-07-05 17:19:57,1186761743,12627,86,13,6,4,9
157386,2023-07-05 17:44:58,1186781250,390968,377,93,35,17,76
157387,2023-07-05 17:45:36,1186781828,4484,212,13,3,6,7
157398,2023-07-05 17:46:28,1186782478,2024,39,22,7,5,17
157402,2023-07-05 17:59:34,1186792721,52596,297,89,27,6,83
157406,2023-07-05 18:19:18,1186808182,21943,48,5,3,1,4
157407,2023-07-05 18:26:30,1186813821,79148,166,27,17,6,21
157407,2023-07-05 18:26:32,1186813838,79148,166,27,17,6,21
157407,2023-07-05 18:26:36,1186813901,79148,166,27,17,6,21
157383,2023-07-05 18:28:17,1186815213,14409,27,36,10,2,34
157383,2023-07-05 18:28:19,1186815247,14409,27,36,10,2,34
157383,2023-07-05 18:28:20,1186815252,14409,27,36,10,2,34
157383,2023-07-05 18:28:21,1186815269,14409,27,36,10,2,34
157409,2023-07-05 18:39:30,1186824207,59488,67,17,10,10,7
157412,2023-07-05 18:49:34,1186832523,28927,217,44,23,4,40
157414,2023-07-05 18:59:17,1186840480,53652,75,27,15,5,22
157415,2023-07-05 19:02:44,1186843416,24444,83,31,20,5,26
157415,2023-07-05 19:02:47,1186843462,24444,83,31,20,5,26
157415,2023-07-05 19:02:48,1186843467,24444,83,31,20,5,26
104464,2023-07-05 19:02:49,1186843493,6326,80,28,18,5,23
157415,2023-07-05 19:02:50,1186843496,24444,83,31,20,5,26
147227,2023-07-05 19:05:29,1186845737,43523,82,24,18,6,18
147243,2023-07-05 19:06:09,1186846262,16466,9,35,21,2,33
147239,2023-07-05 19:06:40,1186846691,34272,78,47,28,6,41
147231,2023-07-05 19:07:03,1186847040,26342,184,31,14,12,19
147225,2023-07-05 19:11:39,1186850933,26258,159,36,16,3,33
147221,2023-07-05 19:11:58,1186851181,61572,206,81,30,6,75
147216,2023-07-05 19:12:37,1186851724,10684,77,20,3,2,18
147206,2023-07-05 19:12:56,1186851951,12624,6,21,14,3,18
157421,2023-07-05 19:31:52,1186867660,4483,44,44,31,3,41
157421,2023-07-05 19:31:58,1186867724,4483,44,44,31,3,41
157400,2023-07-05 19:53:37,1186885483,133653,250,84,48,14,70
157401,2023-07-05 19:54:11,1186885897,97098,213,90,45,14,76
157410,2023-07-05 19:54:34,1186886216,41024,108,94,54,4,90
157416,2023-07-05 19:54:51,1186886447,86679,49,15,6,3,12
157418,2023-07-05 19:55:05,1186886638,0,0,4,0,0,4
157420,2023-07-05 19:55:16,1186886789,65475,55,13,10,5,8
157434,2023-07-05 19:55:29,1186886955,19458,8,6,4,1,5
156444,2023-07-05 19:56:27,1186887641,181266,140,54,36,6,48
156448,2023-07-05 19:56:56,1186888006,36213,27,15,5,5,10
157435,2023-07-05 20:05:50,1186895137,2220,13,62,52,1,61
157435,2023-07-05 20:05:54,1186895184,2220,13,62,52,1,61
157438,2023-07-05 20:33:36,1186915978,10199,26,18,15,1,17
157441,2023-07-05 21:03:53,1186938519,14711,45,6,1,2,4
157441,2023-07-05 21:03:54,1186938524,14711,45,6,1,2,4
157441,2023-07-05 21:03:57,1186938561,14711,45,6,1,2,4
157440,2023-07-05 21:06:57,1186940716,6693,59,17,8,2,15
157439,2023-07-05 21:07:52,1186941377,8471,29,16,11,2,14
142677,2023-07-05 22:54:55,1187041858,8628,35,56,32,2,54
157455,2023-07-06 14:34:34,1187437400,12454,85,7,0,1,6
157477,2023-07-06 14:58:45,1187461341,31194,28,14,6,2,12
143274,2023-07-06 15:10:05,1187473287,92354,172,125,65,8,117
143274,2023-07-06 15:10:08,1187473326,92354,172,125,65,8,117
143669,2023-07-06 15:35:07,1187502687,786,14,16,12,1,15
157479,2023-07-06 15:36:24,1187503902,49145,71,17,13,2,15
89586,2023-07-06 15:43:15,1187512975,2679,254,128,39,2,126
157483,2023-07-06 15:57:50,1187532125,157913,38,17,15,2,15
157483,2023-07-06 15:57:54,1187532160,157913,38,17,15,2,15
98105,2023-07-06 15:58:44,1187532891,3229,10,11,5,1,10
98124,2023-07-06 15:59:57,1187534089,11815,55,58,50,4,54
98131,2023-07-06 16:00:52,1187535048,30124,193,24,20,5,19
157485,2023-07-06 16:03:21,1187538514,12131,233,41,21,7,34
157404,2023-07-06 16:04:32,1187540186,66376,99,20,13,6,14
157404,2023-07-06 16:04:33,1187540188,66376,99,20,13,6,14
157404,2023-07-06 16:04:34,1187540235,66376,99,20,13,6,14
157404,2023-07-06 16:04:36,1187540325,66376,99,20,13,6,14
157404,2023-07-06 16:04:37,1187540346,66376,99,20,13,6,14
157404,2023-07-06 16:04:38,1187540366,66376,99,20,13,6,14
157404,2023-07-06 16:04:39,1187540387,66376,99,20,13,6,14
157404,2023-07-06 16:04:40,1187540423,66376,99,20,13,6,14
157404,2023-07-06 16:04:41,1187540441,66376,99,20,13,6,14
157447,2023-07-06 16:15:45,1187556553,30899,118,42,16,5,37
157487,2023-07-06 16:28:24,1187573783,0,4,47,19,0,47
72585,2023-07-06 16:34:06,1187580340,154071,267,90,68,13,77
72585,2023-07-06 16:34:08,1187580361,154071,267,90,68,13,77
72585,2023-07-06 16:34:09,1187580386,154071,267,90,68,13,77
72585,2023-07-06 16:34:11,1187580419,154071,267,90,68,13,77
72585,2023-07-06 16:34:13,1187580466,154071,267,90,68,13,77
72585,2023-07-06 16:34:15,1187580497,154071,267,90,68,13,77
157488,2023-07-06 16:35:19,1187582015,31376,184,56,15,4,52
157489,2023-07-06 16:36:08,1187583022,18627,8,40,29,2,38
157491,2023-07-06 16:45:02,1187592810,0,0,24,9,0,24
157486,2023-07-06 16:49:46,1187597897,108384,107,35,27,8,27
157492,2023-07-06 17:03:32,1187613037,3659,20,40,21,3,37
157504,2023-07-06 17:24:21,1187636218,25594,141,38,16,7,31
113714,2023-07-06 17:29:17,1187641702,32626,128,20,3,3,17
113722,2023-07-06 17:33:14,1187646090,29937,79,15,2,2,13
113695,2023-07-06 17:33:36,1187646458,117823,428,69,15,13,56
113810,2023-07-06 17:33:58,1187646922,9986,41,26,4,2,24
113728,2023-07-06 17:34:12,1187647196,57355,48,25,8,4,21
130871,2023-07-06 17:43:02,1187657846,14337,48,22,16,3,19
157509,2023-07-06 17:57:40,1187675157,288142,170,81,33,6,75
157508,2023-07-06 18:05:22,1187684162,57487,183,43,30,9,34
157510,2023-07-06 18:10:04,1187689652,0,0,9,7,0,9
157511,2023-07-06 18:27:53,1187710157,160530,71,46,28,4,42
157520,2023-07-06 18:40:55,1187725082,11010,16,18,6,2,16
157522,2023-07-06 18:58:22,1187745760,137134,168,40,23,6,34
157523,2023-07-06 19:01:21,1187749226,9217,129,43,26,8,35
157525,2023-07-06 19:06:43,1187755283,2262,4,18,12,1,17
157524,2023-07-06 19:10:40,1187760005,0,0,1,0,0,1
157527,2023-07-06 19:10:49,1187760159,978,60,75,53,1,74
157529,2023-07-06 19:14:14,1187763971,0,0,1,0,0,1
157530,2023-07-06 19:29:20,1187781467,16265,50,7,1,3,4
157531,2023-07-06 19:35:44,1187788954,48611,69,43,20,9,34
157534,2023-07-06 19:43:09,1187797519,0,5,21,11,0,21
157536,2023-07-06 20:19:27,1187840237,67303,193,50,19,7,43
157537,2023-07-06 20:20:01,1187840846,7077,215,41,12,3,38
157538,2023-07-06 20:20:25,1187841379,13953,9,11,9,1,10
157541,2023-07-06 20:31:07,1187853802,0,0,2,1,0,2
157507,2023-07-06 20:47:32,1187872337,52122,353,43,12,5,38
143346,2023-07-06 21:15:19,1187903345,16153,23,50,36,3,47
157554,2023-07-06 21:24:47,1187914042,69075,133,13,7,5,8
157554,2023-07-06 21:24:51,1187914123,69075,133,13,7,5,8
157551,2023-07-06 21:27:45,1187917251,30680,35,84,35,2,82
157551,2023-07-06 21:27:48,1187917310,30680,35,84,35,2,82
157557,2023-07-06 21:38:07,1187928840,2986,73,6,2,2,4
157556,2023-07-06 21:40:35,1187931607,13744,10,27,6,2,25
157558,2023-07-06 22:03:08,1187956856,8272,25,20,15,2,18
157558,2023-07-06 22:03:10,1187956878,8272,25,20,15,2,18
157558,2023-07-06 22:03:12,1187956933,8272,25,20,15,2,18
157560,2023-07-06 22:19:38,1187974210,0,0,3,2,0,3
157560,2023-07-06 22:19:45,1187974313,0,0,3,2,0,3
157561,2023-07-06 22:24:08,1187978543,17495,22,9,9,2,7
157563,2023-07-06 22:41:48,1187997581,245533,144,21,8,11,10
157565,2023-07-06 22:49:09,1188004688,7959,62,30,17,2,28
157565,2023-07-06 22:49:14,1188004742,7959,62,30,17,2,28
104313,2023-07-07 00:09:10,1188087445,15975,39,86,43,2,84
104851,2023-07-07 00:09:27,1188087745,39648,197,65,36,15,50
104311,2023-07-07 00:09:42,1188087968,18129,47,75,53,2,73
104665,2023-07-07 00:10:01,1188088288,22826,88,89,50,6,83
124433,2023-07-07 00:10:18,1188088616,42766,128,48,17,7,41
145700,2023-07-07 00:11:14,1188089504,10027,20,48,26,4,44
157586,2023-07-07 15:01:33,1188466182,94123,58,42,31,3,39
157587,2023-07-07 15:10:45,1188470547,0,0,3,0,0,3
86586,2023-07-07 15:23:49,1188476604,51281,124,168,78,3,165
86588,2023-07-07 15:24:30,1188476970,762,202,82,12,3,79
86840,2023-07-07 15:26:53,1188478158,40186,44,98,54,3,95
86840,2023-07-07 15:26:55,1188478189,40186,44,98,54,3,95
86840,2023-07-07 15:26:56,1188478196,40186,44,98,54,3,95
86840,2023-07-07 15:26:57,1188478203,40186,44,98,54,3,95
86591,2023-07-07 15:32:37,1188481292,16554,62,24,2,2,22
147495,2023-07-07 15:37:44,1188484984,0,0,6,3,0,6
147495,2023-07-07 15:37:45,1188484996,0,0,6,3,0,6
147495,2023-07-07 15:37:46,1188484998,0,0,6,3,0,6
146148,2023-07-07 15:42:33,1188488892,11502,92,26,17,3,23
86616,2023-07-07 15:44:38,1188490165,13084,150,42,24,4,38
86616,2023-07-07 15:44:40,1188490188,13084,150,42,24,4,38
157591,2023-07-07 15:45:31,1188490702,88585,33,9,3,3,6
86604,2023-07-07 15:49:05,1188492665,0,4,60,37,0,60
86604,2023-07-07 15:49:06,1188492681,0,4,60,37,0,60
86604,2023-07-07 15:49:07,1188492689,0,4,60,37,0,60
145560,2023-07-07 16:04:27,1188501754,3324,18,3,2,2,1
157594,2023-07-07 16:14:33,1188508098,38952,130,28,21,5,23
118775,2023-07-07 16:19:17,1188511023,4411,15,5,3,2,3
156504,2023-07-07 16:20:44,1188511970,10741,30,47,13,1,46
156504,2023-07-07 16:20:47,1188512009,10741,30,47,13,1,46
157598,2023-07-07 16:30:13,1188518334,5812,325,37,19,3,34
157600,2023-07-07 16:40:22,1188525407,6810,23,4,3,1,3
157604,2023-07-07 17:06:53,1188542819,249827,139,35,20,9,26
157604,2023-07-07 17:06:55,1188542844,249827,139,35,20,9,26
157604,2023-07-07 17:06:58,1188542874,249827,139,35,20,9,26
157607,2023-07-07 17:17:55,1188550760,440281,195,76,63,9,67
157601,2023-07-07 17:18:29,1188551166,315707,113,53,24,10,43
157602,2023-07-07 17:18:34,1188551231,10348,77,9,6,2,7
157608,2023-07-07 17:19:23,1188551795,10171,79,16,3,1,15
157597,2023-07-07 17:28:02,1188558232,52287,39,21,11,5,16
157609,2023-07-07 17:28:44,1188558734,70113,60,93,48,3,90
157611,2023-07-07 17:29:08,1188559030,76847,88,64,28,7,57
157612,2023-07-07 17:29:23,1188559185,74346,59,15,7,4,11
157613,2023-07-07 17:29:32,1188559278,115826,179,56,37,5,51
114616,2023-07-07 17:49:15,1188575878,55229,71,45,23,6,39
114616,2023-07-07 17:49:21,1188575972,55229,71,45,23,6,39
114616,2023-07-07 17:49:25,1188576015,55229,71,45,23,6,39
114612,2023-07-07 17:52:29,1188578333,136498,95,39,24,8,31
114612,2023-07-07 17:52:31,1188578359,136498,95,39,24,8,31
114612,2023-07-07 17:52:32,1188578363,136498,95,39,24,8,31
127663,2023-07-07 17:53:20,1188578976,61882,133,23,14,7,16
127663,2023-07-07 17:53:22,1188578990,61882,133,23,14,7,16
127663,2023-07-07 17:53:23,1188579004,61882,133,23,14,7,16
127663,2023-07-07 17:53:24,1188579022,61882,133,23,14,7,16
157640,2023-07-07 21:14:45,1188776238,2000,24,3,2,1,2
78042,2023-07-07 21:43:15,1188804700,611752,101,40,29,9,31
78042,2023-07-07 21:43:18,1188804737,611752,101,40,29,9,31
78042,2023-07-07 21:43:21,1188804782,611752,101,40,29,9,31
78042,2023-07-07 21:43:24,1188804815,611752,101,40,29,9,31
157643,2023-07-07 21:44:13,1188805469,202191,302,38,20,13,25
157644,2023-07-07 21:50:05,1188810136,81240,266,41,32,11,30
157645,2023-07-07 21:57:09,1188815678,69256,85,53,31,6,47
114670,2023-07-07 22:02:03,1188819617,5837,19,23,13,2,21
114670,2023-07-07 22:02:05,1188819653,5837,19,23,13,2,21
157654,2023-07-07 22:16:27,1188830968,30915,89,107,6,7,100
93733,2023-07-07 22:17:44,1188831986,92424,87,43,27,4,39
93733,2023-07-07 22:17:47,1188832023,92424,87,43,27,4,39
93733,2023-07-07 22:17:50,1188832061,92424,87,43,27,4,39
95473,2023-07-07 22:18:41,1188832725,66410,97,90,46,4,86
95473,2023-07-07 22:18:47,1188832812,66410,97,90,46,4,86
95605,2023-07-07 22:19:42,1188833561,1549,13,40,6,1,39
95376,2023-07-07 22:20:42,1188834343,92513,463,108,44,13,95
95376,2023-07-07 22:20:47,1188834402,92513,463,108,44,13,95
95748,2023-07-07 22:21:28,1188834958,63576,100,13,1,8,5
147887,2023-07-07 22:22:16,1188835601,0,0,1,0,0,1
157657,2023-07-07 22:44:25,1188853488,74174,220,75,58,11,64
157656,2023-07-07 22:48:09,1188856236,252888,91,56,32,7,49
157655,2023-07-07 22:55:40,1188861810,17029,51,25,8,2,23
157658,2023-07-07 23:12:24,1188874320,0,0,5,0,0,5
157659,2023-07-08 00:51:37,1188933548,11162,98,56,41,2,54
157659,2023-07-08 00:51:39,1188933568,11162,98,56,41,2,54
157662,2023-07-08 00:52:33,1188934015,5494,58,59,41,2,57
157667,2023-07-08 15:14:26,1189104454,21446,66,11,8,1,10
157672,2023-07-08 15:27:38,1189109213,32632,294,48,27,6,42
157672,2023-07-08 15:27:42,1189109243,32632,294,48,27,6,42
157673,2023-07-08 16:03:55,1189123923,52122,353,46,12,5,41
157674,2023-07-08 16:04:46,1189124306,102920,76,60,24,6,54
157677,2023-07-08 16:39:16,1189140436,61391,318,135,71,10,125
157677,2023-07-08 16:39:17,1189140460,61391,318,135,71,10,125
119782,2023-07-08 16:43:04,1189142344,16859,46,44,29,4,40
119992,2023-07-08 16:43:39,1189142642,18478,101,42,11,4,38
157679,2023-07-08 16:44:24,1189143016,34001,137,59,38,4,55
119829,2023-07-08 16:44:32,1189143070,2700,13,27,18,1,26
145997,2023-07-08 16:44:52,1189143233,3181,242,49,17,3,46
119935,2023-07-08 16:45:28,1189143516,39359,149,179,17,5,174
119780,2023-07-08 16:45:53,1189143702,1168,310,26,9,5,21
119777,2023-07-08 16:46:33,1189144018,226966,140,46,17,9,37
126742,2023-07-08 16:46:44,1189144103,20702,67,19,13,3,16
126740,2023-07-08 16:47:13,1189144332,53883,109,41,14,3,38
157682,2023-07-08 16:51:45,1189146515,80649,28,24,15,4,20
157682,2023-07-08 16:51:48,1189146537,80649,28,24,15,4,20
157675,2023-07-08 16:54:06,1189147745,7606,155,62,35,5,57
157680,2023-07-08 16:55:20,1189148422,55854,127,56,26,6,50
157680,2023-07-08 16:55:23,1189148450,55854,127,56,26,6,50
157683,2023-07-08 16:56:10,1189148896,246600,464,81,43,13,68
157676,2023-07-08 16:56:27,1189149052,33132,98,10,6,4,6
157684,2023-07-08 17:00:58,1189151429,6186,58,100,61,3,97
157684,2023-07-08 17:01:02,1189151461,6186,58,100,61,3,97
119830,2023-07-08 17:02:18,1189152114,19277,434,70,41,6,64
157685,2023-07-08 17:06:23,1189154239,43239,18,7,0,1,6
147223,2023-07-08 17:07:00,1189154535,3066,39,12,0,5,7
126736,2023-07-08 17:07:37,1189154893,48789,23,43,34,1,42
157694,2023-07-08 17:28:08,1189166702,10260,36,7,3,2,5
157690,2023-07-08 18:16:42,1189193705,46055,78,39,29,5,34
157690,2023-07-08 18:16:44,1189193722,46055,78,39,29,5,34
157698,2023-07-08 18:30:21,1189201872,215154,89,30,21,5,25
157706,2023-07-10 14:52:14,1189952905,0,4,10,8,0,10
157706,2023-07-10 14:52:17,1189952922,0,4,10,8,0,10
157707,2023-07-10 14:53:30,1189953383,126957,25,40,29,3,37
157714,2023-07-10 15:35:22,1189973352,8127,103,47,12,8,39
157711,2023-07-10 15:45:35,1189979380,0,0,7,5,0,7
157711,2023-07-10 15:45:40,1189979429,0,0,7,5,0,7
157718,2023-07-10 15:51:18,1189982745,54006,38,18,14,3,15
157717,2023-07-10 15:52:25,1189983394,57112,64,36,23,3,33
157716,2023-07-10 15:52:46,1189983574,8168,82,32,20,3,29
157719,2023-07-10 15:58:30,1189986772,21936,67,67,35,4,63
157681,2023-07-10 16:08:57,1189993093,33494,134,50,33,6,44
157661,2023-07-10 16:11:49,1189994842,33109,305,70,44,6,64
157728,2023-07-10 16:22:04,1190001629,3224,100,159,61,5,154
157728,2023-07-10 16:22:09,1190001695,3224,100,159,61,5,154
157745,2023-07-10 17:04:07,1190029590,0,1,5,2,0,5
157746,2023-07-10 17:04:12,1190029633,21018,300,73,47,6,67
157748,2023-07-10 17:13:25,1190035978,5142,64,8,3,2,6
157751,2023-07-10 17:23:36,1190043547,69836,26,26,4,3,23
157764,2023-07-10 18:45:16,1190112460,322901,290,60,46,14,46
157766,2023-07-10 18:45:32,1190112680,12301,57,28,15,3,25
157770,2023-07-10 18:56:59,1190122399,16893,16,12,7,3,9
157783,2023-07-10 19:32:25,1190155337,163589,62,29,23,3,26
157783,2023-07-10 19:32:29,1190155387,163589,62,29,23,3,26
157791,2023-07-10 19:40:12,1190162244,0,1,33,9,0,33
157791,2023-07-10 19:40:17,1190162306,0,1,33,9,0,33
157789,2023-07-10 19:40:28,1190162450,5188,36,13,0,3,10
157787,2023-07-10 19:40:42,1190162645,195317,265,38,9,12,26
157786,2023-07-10 19:40:55,1190162842,0,0,3,1,0,3
157785,2023-07-10 19:41:11,1190163078,12357,126,60,17,4,56
157788,2023-07-10 20:09:51,1190191699,57330,532,151,45,9,142
157788,2023-07-10 20:09:58,1190191822,57330,532,151,45,9,142
157790,2023-07-10 20:10:04,1190191903,72914,203,99,36,14,85
157790,2023-07-10 20:10:08,1190192023,72914,203,99,36,14,85
157794,2023-07-10 20:10:17,1190192214,8486,74,20,10,1,19
157795,2023-07-10 20:10:27,1190192397,44952,178,88,27,11,77
157801,2023-07-10 20:49:26,1190224787,11151,131,21,13,2,19
157803,2023-07-10 21:08:26,1190239919,0,5,29,20,0,29
157818,2023-07-10 22:04:54,1190283709,0,0,4,1,0,4
157819,2023-07-10 22:06:16,1190284731,73478,383,37,20,5,32
107998,2023-07-10 22:26:39,1190300237,64077,210,68,39,4,64
108698,2023-07-10 22:26:53,1190300407,10398,11,6,4,1,5
147198,2023-07-10 22:27:26,1190300839,48906,24,6,2,1,5
147198,2023-07-10 22:27:28,1190300885,48906,24,6,2,1,5
157830,2023-07-10 22:39:51,1190309929,0,2,6,0,0,6
90041,2023-07-10 22:43:30,1190312459,208576,258,126,70,11,115
122613,2023-07-10 22:44:09,1190312913,0,0,3,0,0,3
157843,2023-07-11 15:32:06,1190594815,118377,145,57,28,10,47
147515,2023-07-11 16:23:07,1190623497,0,0,12,2,0,12
146804,2023-07-11 16:28:47,1190627175,5296,8,9,5,1,8
147537,2023-07-11 16:32:12,1190629507,1030,3,5,1,1,4
146616,2023-07-11 16:36:03,1190632476,0,72,17,10,0,17
157908,2023-07-11 17:41:55,1190685967,45932,71,34,25,3,31
157912,2023-07-11 18:15:56,1190713661,41592,68,67,41,2,65
157911,2023-07-11 18:23:57,1190719993,32693,73,37,18,4,33
157915,2023-07-11 18:30:20,1190725031,0,4,11,4,0,11
157926,2023-07-11 18:55:46,1190745322,16347,24,2,1,1,1
157926,2023-07-11 18:55:47,1190745329,16347,24,2,1,1,1
157926,2023-07-11 18:55:48,1190745337,16347,24,2,1,1,1
157926,2023-07-11 18:55:49,1190745355,16347,24,2,1,1,1
157926,2023-07-11 18:55:52,1190745405,16347,24,2,1,1,1
157926,2023-07-11 18:55:53,1190745424,16347,24,2,1,1,1
157926,2023-07-11 18:55:54,1190745449,16347,24,2,1,1,1
157925,2023-07-11 19:01:08,1190749766,0,0,2,0,0,2
157927,2023-07-11 19:08:32,1190755923,1062,10,5,3,1,4
146742,2023-07-11 19:10:53,1190757879,41192,102,64,47,3,61
146489,2023-07-11 19:11:17,1190758192,12170,32,13,10,3,10
157928,2023-07-11 19:19:44,1190765141,0,0,2,1,0,2
157929,2023-07-11 19:20:16,1190765592,0,0,2,1,0,2
157931,2023-07-11 19:20:41,1190765913,1167,27,4,2,1,3
157934,2023-07-11 19:35:20,1190777707,6593,37,20,13,2,18
157937,2023-07-11 19:45:15,1190785775,222540,251,55,22,7,48
157937,2023-07-11 19:45:21,1190785857,222540,251,55,22,7,48
157936,2023-07-11 19:46:16,1190786591,0,0,2,0,0,2
157945,2023-07-11 19:50:37,1190790242,15687,42,9,1,2,7
157946,2023-07-11 19:52:40,1190791895,3668,10,7,5,1,6
157948,2023-07-11 20:04:22,1190801042,87169,72,24,8,8,16
157949,2023-07-11 20:16:35,1190810475,98621,118,30,23,6,24
157951,2023-07-11 20:17:05,1190810822,38094,125,40,24,7,33
157952,2023-07-11 20:17:22,1190811033,5701,11,49,40,2,47
157932,2023-07-11 20:22:56,1190815284,81776,305,99,16,6,93
25860,2023-07-11 20:29:54,1190820356,109787,397,98,63,15,83
25860,2023-07-11 20:30:04,1190820475,109787,397,98,63,15,83
115652,2023-07-11 20:30:47,1190821024,14440,204,173,94,3,170
115652,2023-07-11 20:30:49,1190821047,14440,204,173,94,3,170
147778,2023-07-11 20:31:55,1190821897,8504,280,40,11,2,38
147778,2023-07-11 20:31:56,1190821907,8504,280,40,11,2,38
115664,2023-07-11 20:38:29,1190826867,67944,57,137,91,3,134
115664,2023-07-11 20:38:35,1190826950,67944,57,137,91,3,134
157957,2023-07-11 20:51:39,1190837065,10015,68,21,12,3,18
157957,2023-07-11 20:51:40,1190837080,10015,68,21,12,3,18
157957,2023-07-11 20:51:42,1190837119,10015,68,21,12,3,18
157966,2023-07-11 20:56:20,1190840675,20699,61,13,1,4,9
157971,2023-07-11 21:07:47,1190849130,4438,9,34,27,1,33
157968,2023-07-11 21:08:42,1190849872,30910,151,14,6,9,5
157968,2023-07-11 21:08:47,1190849925,30910,151,14,6,9,5
157973,2023-07-11 21:18:02,1190856789,11618,181,26,4,1,25
157975,2023-07-11 21:28:56,1190865074,1127,11,8,0,1,7
147801,2023-07-11 21:46:55,1190878170,59810,40,50,41,3,47
147804,2023-07-11 21:47:25,1190878555,12671,49,31,24,4,27
148070,2023-07-11 21:47:55,1190878882,0,2,18,17,0,18
147826,2023-07-11 21:48:19,1190879191,1050,5,6,3,1,5
157933,2023-07-11 21:49:52,1190880431,85484,108,24,20,2,22
157935,2023-07-11 21:50:07,1190880672,14353,87,16,14,2,14
157947,2023-07-11 21:50:16,1190880814,194783,182,38,34,6,32
157950,2023-07-11 21:50:28,1190880990,72157,108,27,20,6,21
157953,2023-07-11 21:51:03,1190881398,13316,133,8,1,7,1
157977,2023-07-11 21:51:05,1190881431,1400,7,35,21,1,34
157955,2023-07-11 21:51:12,1190881506,531,12,38,30,1,37
157972,2023-07-11 21:51:23,1190881642,0,16,52,29,0,52
157974,2023-07-11 21:51:32,1190881745,76047,138,59,46,7,52
157976,2023-07-11 21:51:39,1190881835,29469,73,35,23,4,31
157978,2023-07-11 21:52:39,1190882604,0,0,1,1,0,1
157979,2023-07-11 21:58:01,1190886647,108020,299,72,47,9,63
157980,2023-07-11 22:01:24,1190889286,15945,36,11,9,2,9
157981,2023-07-11 22:04:11,1190891227,13097,128,136,38,6,130
157982,2023-07-11 22:07:11,1190893466,8305,111,11,3,4,7
157984,2023-07-11 22:15:04,1190899340,43299,51,10,4,2,8
157985,2023-07-11 22:28:23,1190908834,16819,60,41,32,4,37
157987,2023-07-11 22:29:28,1190909618,26803,35,18,9,3,15
157986,2023-07-11 22:29:49,1190909853,33853,100,13,4,10,3
157988,2023-07-11 22:34:34,1190913037,103377,121,28,22,7,21
157989,2023-07-11 22:35:24,1190913603,20407,33,37,2,2,35
136805,2023-07-11 22:36:05,1190914101,27670,58,24,21,2,22
136805,2023-07-11 22:36:08,1190914151,27670,58,24,21,2,22
157990,2023-07-11 22:57:50,1190929038,15605,43,14,10,2,12
157983,2023-07-11 23:59:31,1190971359,9861,29,11,6,3,8
157983,2023-07-11 23:59:35,1190971396,9861,29,11,6,3,8
157993,2023-07-12 00:32:31,1190991520,0,0,7,0,0,7
157995,2023-07-12 00:32:39,1190991578,38380,167,70,38,9,61
157996,2023-07-12 00:32:47,1190991663,17322,180,27,16,9,18
157997,2023-07-12 00:32:55,1190991720,36925,113,100,27,6,94
157999,2023-07-12 00:33:10,1190991912,35763,48,16,8,3,13
157998,2023-07-12 00:33:33,1190992130,13347,24,21,8,1,20
136804,2023-07-12 14:02:43,1191470356,239,20,12,4,1,11
136264,2023-07-12 14:03:31,1191470586,19253,17,10,4,5,5
136834,2023-07-12 14:04:23,1191470804,0,0,4,2,0,4
136262,2023-07-12 14:05:00,1191470920,15426,28,17,10,4,13
147434,2023-07-12 14:05:34,1191471051,60226,48,32,5,12,20
147436,2023-07-12 14:06:09,1191471195,17457,90,19,12,5,14
89990,2023-07-12 14:08:46,1191471931,8189,26,8,4,3,5
105326,2023-07-12 14:11:18,1191472619,20210,31,44,23,2,42
105429,2023-07-12 14:11:41,1191472720,15764,43,11,3,2,9
117789,2023-07-12 14:12:31,1191472972,46778,158,65,50,10,55
148005,2023-07-12 14:13:22,1191473240,0,0,9,7,0,9
148005,2023-07-12 14:13:25,1191473247,0,0,9,7,0,9
148436,2023-07-12 14:13:58,1191473413,702,42,37,9,1,36
158012,2023-07-12 14:27:24,1191477268,3405,7,10,7,1,9
158013,2023-07-12 14:37:05,1191480546,32352,90,37,20,2,35
158022,2023-07-12 14:59:10,1191489154,1194,30,21,19,1,20
158036,2023-07-12 15:54:48,1191519992,217661,215,98,75,7,91
158036,2023-07-12 15:54:50,1191520016,217661,215,98,75,7,91
158037,2023-07-12 16:00:13,1191523469,67416,32,4,3,2,2
158039,2023-07-12 16:27:44,1191541861,6355,72,4,1,3,1
158040,2023-07-12 16:28:22,1191542315,7507,102,8,3,2,6
49352,2023-07-12 17:06:38,1191568834,0,2,42,13,0,42
119122,2023-07-12 17:10:00,1191571239,60158,34,15,6,6,9
119122,2023-07-12 17:10:03,1191571282,60158,34,15,6,6,9
158050,2023-07-12 17:26:23,1191583306,43862,182,24,13,5,19
158050,2023-07-12 17:26:33,1191583429,43862,182,24,13,5,19
117024,2023-07-12 17:28:08,1191584638,13664,51,135,63,3,132
116808,2023-07-12 17:28:35,1191585025,18967,60,86,38,6,80
116809,2023-07-12 17:29:03,1191585416,28168,46,79,32,4,75
116811,2023-07-12 17:29:46,1191585976,38448,205,49,15,6,43
148431,2023-07-12 17:30:37,1191586699,6861,52,9,1,6,3
158056,2023-07-12 18:11:35,1191627518,5897,25,126,6,3,123
158066,2023-07-12 19:24:35,1191728060,56991,26,4,1,4,0
158068,2023-07-12 19:32:59,1191734640,28609,63,25,16,4,21
158069,2023-07-12 19:38:52,1191739128,5469,34,24,20,5,19
158079,2023-07-12 20:09:04,1191762350,0,0,22,8,0,22
158082,2023-07-12 20:25:32,1191774586,99602,166,40,14,21,19
158084,2023-07-12 20:46:30,1191790334,688,8,1,0,1,0
158084,2023-07-12 20:46:31,1191790353,688,8,1,0,1,0
158084,2023-07-12 20:46:32,1191790355,688,8,1,0,1,0
135148,2023-07-12 21:52:03,1191839102,141767,96,67,39,8,59
158090,2023-07-12 21:56:20,1191842209,8670,3,30,26,1,29
158092,2023-07-12 22:00:48,1191845249,10203,34,10,2,3,7
158089,2023-07-12 22:01:49,1191845916,8213,31,4,2,3,1
158093,2023-07-12 22:03:52,1191847295,14572,58,11,8,2,9
134875,2023-07-12 22:10:49,1191852249,14685,43,51,38,2,49
135203,2023-07-12 22:15:13,1191855388,0,9,18,13,0,18
134858,2023-07-12 22:17:40,1191857094,0,4,4,1,0,4
158078,2023-07-12 22:36:59,1191870751,98707,101,50,39,8,42
158095,2023-07-12 22:46:04,1191876828,41081,5,8,3,2,6
158105,2023-07-12 22:59:59,1191886296,40371,66,18,10,4,14
158106,2023-07-12 23:07:57,1191891534,19851,68,46,6,4,42
158108,2023-07-12 23:12:43,1191894639,54545,142,19,11,8,11
158109,2023-07-12 23:17:23,1191897898,25723,31,13,7,2,11
158122,2023-07-13 14:54:25,1192128527,41269,138,5,3,4,1
158124,2023-07-13 15:09:25,1192134609,3041,34,18,12,2,16
111206,2023-07-13 15:13:50,1192136606,34154,116,82,60,9,73
158125,2023-07-13 15:14:42,1192137052,63594,96,49,6,3,46
158123,2023-07-13 15:15:19,1192137364,165333,29,66,30,2,64
158126,2023-07-13 15:20:33,1192139992,22562,40,32,23,3,29
158131,2023-07-13 15:44:02,1192152466,7337,10,6,4,1,5
158130,2023-07-13 15:45:34,1192153372,10956,95,13,11,1,12
158129,2023-07-13 15:51:49,1192156906,8933,48,11,9,2,9
158134,2023-07-13 15:59:22,1192161092,110126,101,34,27,6,28
158143,2023-07-13 16:05:24,1192164713,125244,96,63,21,7,56
158144,2023-07-13 16:16:09,1192171041,1122,96,62,17,1,61
158144,2023-07-13 16:16:14,1192171089,1122,96,62,17,1,61
158128,2023-07-13 16:23:37,1192175429,0,20,18,13,0,18
158132,2023-07-13 16:34:00,1192181696,10793,25,14,7,2,12
158132,2023-07-13 16:34:03,1192181725,10793,25,14,7,2,12
158132,2023-07-13 16:34:04,1192181750,10793,25,14,7,2,12
122173,2023-07-13 16:50:25,1192193018,0,123,50,24,0,50
145993,2023-07-13 16:51:04,1192193456,60263,80,50,38,5,45
125986,2023-07-13 17:00:42,1192200136,13264,8,9,6,1,8
126018,2023-07-13 17:01:23,1192200657,200979,256,55,28,9,46
137297,2023-07-13 17:02:23,1192201377,0,1,25,18,0,25
115644,2023-07-13 17:19:04,1192212686,142914,68,14,9,4,10
115028,2023-07-13 17:19:38,1192213029,60972,82,42,27,5,37
158167,2023-07-13 17:24:19,1192216129,27717,230,25,11,3,22
158171,2023-07-13 17:35:35,1192223908,23355,35,20,9,2,18
158164,2023-07-13 17:51:22,1192235358,4680,19,26,20,2,24
158164,2023-07-13 17:51:25,1192235386,4680,19,26,20,2,24
158165,2023-07-13 17:52:53,1192236349,3120,18,45,38,1,44
158165,2023-07-13 17:52:56,1192236388,3120,18,45,38,1,44
158166,2023-07-13 17:53:43,1192236957,6950,14,25,17,4,21
158166,2023-07-13 17:53:46,1192236992,6950,14,25,17,4,21
158169,2023-07-13 17:54:40,1192237660,0,0,3,3,0,3
158169,2023-07-13 17:54:45,1192237699,0,0,3,3,0,3
158172,2023-07-13 17:57:38,1192239708,40074,17,3,2,2,1
147756,2023-07-13 18:13:34,1192251392,0,0,9,5,0,9
131520,2023-07-13 18:33:17,1192265761,7532,24,38,21,1,37
131520,2023-07-13 18:33:18,1192265781,7532,24,38,21,1,37
131520,2023-07-13 18:33:21,1192265816,7532,24,38,21,1,37
158209,2023-07-13 18:59:32,1192285842,8431,22,10,1,2,8
158210,2023-07-13 19:03:08,1192288559,21034,96,8,3,5,3
112961,2023-07-13 19:29:27,1192308301,26725,46,92,74,2,90
147603,2023-07-13 19:30:02,1192308683,12264,77,77,53,3,74
147596,2023-07-13 19:30:33,1192309077,22640,41,16,12,5,11
158216,2023-07-13 19:47:10,1192321212,142976,41,26,18,4,22
158221,2023-07-13 20:39:27,1192357590,10405,20,12,4,3,9
158227,2023-07-13 21:15:58,1192382526,0,1,3,2,0,3
158228,2023-07-13 21:16:07,1192382636,56104,19,6,5,1,5
158231,2023-07-13 21:47:35,1192402795,287028,144,50,16,5,45
158226,2023-07-13 21:54:09,1192406979,153112,58,31,23,3,28
147116,2023-07-13 22:06:11,1192414979,158801,400,171,61,22,149
147121,2023-07-13 22:08:10,1192416232,13593,44,13,9,3,10
147115,2023-07-13 22:12:57,1192419117,132350,131,54,33,7,47
147115,2023-07-13 22:12:59,1192419148,132350,131,54,33,7,47
147117,2023-07-13 22:13:13,1192419320,0,3,35,9,0,35
106681,2023-07-13 22:16:44,1192421576,35274,169,68,44,7,61
158232,2023-07-13 22:32:32,1192431578,142368,67,19,7,5,14
158234,2023-07-13 22:44:23,1192439015,9442,8,12,9,1,11
158233,2023-07-13 23:15:05,1192456796,39083,227,15,7,4,11
158237,2023-07-13 23:33:17,1192467432,143812,230,31,8,15,16
158240,2023-07-13 23:55:55,1192479852,77182,126,37,23,9,28
158240,2023-07-13 23:55:58,1192479870,77182,126,37,23,9,28
158240,2023-07-13 23:55:59,1192479876,77182,126,37,23,9,28
158240,2023-07-13 23:56:01,1192479898,77182,126,37,23,9,28
158245,2023-07-14 00:34:30,1192499383,3870,116,83,44,1,82
158245,2023-07-14 00:34:34,1192499411,3870,116,83,44,1,82
158245,2023-07-14 00:34:35,1192499419,3870,116,83,44,1,82
158238,2023-07-14 14:43:17,1192657992,45693,47,22,13,6,16
158238,2023-07-14 14:43:18,1192658000,45693,47,22,13,6,16
158238,2023-07-14 14:43:20,1192658011,45693,47,22,13,6,16
158238,2023-07-14 14:43:21,1192658012,45693,47,22,13,6,16
158238,2023-07-14 14:43:22,1192658024,45693,47,22,13,6,16
158238,2023-07-14 14:43:23,1192658032,45693,47,22,13,6,16
158238,2023-07-14 14:43:24,1192658036,45693,47,22,13,6,16
158238,2023-07-14 14:43:25,1192658045,45693,47,22,13,6,16
158246,2023-07-14 14:56:44,1192663004,21206,11,13,1,1,12
158246,2023-07-14 14:56:46,1192663013,21206,11,13,1,1,12
158246,2023-07-14 14:56:52,1192663048,21206,11,13,1,1,12
158246,2023-07-14 14:56:54,1192663064,21206,11,13,1,1,12
158265,2023-07-14 15:20:04,1192673165,24705,62,18,4,2,16
158247,2023-07-14 15:51:02,1192689000,7256,173,95,58,2,93
158247,2023-07-14 15:51:10,1192689051,20,172,79,44,1,78
158247,2023-07-14 15:51:08,1192689090,7256,173,95,58,2,93
147757,2023-07-14 15:59:28,1192693536,76988,226,102,53,4,98
147733,2023-07-14 16:00:02,1192693788,37572,77,74,41,6,68
147760,2023-07-14 16:00:33,1192694062,1675,26,39,14,1,38
158268,2023-07-14 16:06:29,1192697304,25160,93,83,60,5,78
158268,2023-07-14 16:06:34,1192697370,25160,93,83,60,5,78
158292,2023-07-14 17:31:54,1192752629,0,0,34,8,0,34
122184,2023-07-14 17:35:55,1192755483,4320,48,128,76,3,125
122172,2023-07-14 17:43:50,1192761297,10540,33,121,79,5,116
121222,2023-07-14 18:00:23,1192773066,30721,76,27,10,5,22
121222,2023-07-14 18:00:25,1192773093,30721,76,27,10,5,22
121222,2023-07-14 18:00:26,1192773109,30721,76,27,10,5,22
121222,2023-07-14 18:00:27,1192773114,30721,76,27,10,5,22
121222,2023-07-14 18:00:28,1192773136,30721,76,27,10,5,22
121222,2023-07-14 18:00:29,1192773148,30721,76,27,10,5,22
121222,2023-07-14 18:00:31,1192773164,30721,76,27,10,5,22
158308,2023-07-14 18:24:32,1192790720,7611,30,16,7,1,15
158311,2023-07-14 18:30:21,1192794835,27327,45,10,6,3,7
158320,2023-07-14 18:30:28,1192794908,40622,92,46,32,5,41
158309,2023-07-14 18:30:59,1192795265,2688,33,21,14,1,20
158307,2023-07-14 18:31:35,1192795658,3255,46,3,0,2,1
158306,2023-07-14 18:32:21,1192796187,22701,53,23,11,4,19
158296,2023-07-14 18:33:18,1192796828,18097,91,20,11,4,16
158321,2023-07-14 18:35:27,1192798316,16600,55,17,8,2,15
158322,2023-07-14 18:37:25,1192799827,1223,12,22,19,1,21
134877,2023-07-14 18:42:29,1192803591,39515,70,70,57,6,64
158354,2023-07-14 19:19:18,1192829893,4270,45,14,3,2,12
158355,2023-07-14 19:22:09,1192831874,82428,95,10,4,4,6
158356,2023-07-14 19:25:38,1192834284,5690,32,9,1,1,8
158357,2023-07-14 19:30:37,1192837798,4683,74,5,5,2,3
158360,2023-07-14 19:45:42,1192848226,0,8,23,8,0,23
158362,2023-07-14 20:35:08,1192882395,11349,44,51,22,3,48
158366,2023-07-14 21:37:10,1192923624,9888,12,19,11,2,17
158366,2023-07-14 21:37:14,1192923685,9888,12,19,11,2,17
158368,2023-07-14 22:16:14,1192948887,47599,64,52,35,6,46
158369,2023-07-14 22:35:45,1192961967,5187,50,21,9,2,19
158367,2023-07-14 22:35:53,1192962099,0,0,2,2,0,2
158370,2023-07-14 22:36:02,1192962204,124255,77,30,17,5,25
158377,2023-07-14 22:36:12,1192962362,29864,37,21,2,3,18
158378,2023-07-14 22:36:25,1192962531,127529,142,32,16,7,25
158379,2023-07-14 22:47:54,1192972575,7165,204,35,20,2,33
158380,2023-07-14 22:54:02,1192977890,8550,19,84,38,1,83
158381,2023-07-14 22:58:04,1192981362,0,9,64,34,0,64
158385,2023-07-14 23:11:53,1192993095,7158,84,11,7,1,10
158385,2023-07-14 23:11:57,1192993161,7158,84,11,7,1,10
158387,2023-07-14 23:30:17,1193007587,43681,52,23,9,2,21
158388,2023-07-14 23:30:23,1193007675,126475,129,62,45,7,55
158386,2023-07-15 00:06:43,1193035099,0,0,1,0,0,1
158382,2023-07-15 16:15:29,1193492774,0,1,7,0,0,7
158403,2023-07-15 17:01:37,1193530231,19006,28,11,5,1,10
158404,2023-07-15 17:01:53,1193530439,30273,84,17,9,3,14
158405,2023-07-15 17:01:59,1193530521,73415,183,17,10,8,9
158406,2023-07-15 17:09:14,1193536018,160293,156,99,40,8,91
158407,2023-07-15 17:16:10,1193541227,112886,52,44,17,2,42
158415,2023-07-15 17:24:49,1193548007,0,6,68,36,0,68
133305,2023-07-15 17:34:16,1193555513,48191,110,37,19,5,32
158416,2023-07-15 17:36:41,1193557535,5145,88,29,27,2,27
158416,2023-07-15 17:36:43,1193557573,5145,88,29,27,2,27
158417,2023-07-15 17:45:50,1193564621,6113,94,44,31,2,42
158418,2023-07-15 18:11:16,1193585233,687393,209,31,14,11,20
158420,2023-07-15 18:11:26,1193585377,58921,29,15,10,5,10
158421,2023-07-15 18:11:32,1193585461,25533,76,2,1,2,0
158419,2023-07-15 18:15:13,1193588625,539,16,16,8,1,15
158422,2023-07-15 18:15:42,1193589047,48827,69,45,20,4,41
158423,2023-07-15 18:16:10,1193589421,83505,281,30,19,9,21
148242,2023-07-17 16:47:25,1194658272,6800,42,35,13,3,32
148069,2023-07-17 16:48:12,1194658821,18037,125,21,11,4,17
148088,2023-07-17 16:49:04,1194659443,60851,176,111,64,4,107
148275,2023-07-17 16:53:00,1194662314,49001,101,42,33,2,40
148085,2023-07-17 16:53:36,1194662801,51826,56,100,53,4,96
148536,2023-07-17 17:18:38,1194681612,0,39,52,23,0,52
148540,2023-07-17 17:19:22,1194682158,0,17,39,28,0,39
148537,2023-07-17 17:19:52,1194682499,937,18,17,10,1,16
148542,2023-07-17 17:20:21,1194682856,0,0,4,1,0,4
158389,2023-07-17 17:20:32,1194682986,30334,34,31,17,1,30
148638,2023-07-17 17:20:49,1194683178,30,185,52,29,1,51
148538,2023-07-17 17:21:09,1194683418,34908,48,15,9,4,11
148795,2023-07-17 17:21:33,1194683691,0,2,51,17,0,51
158478,2023-07-17 18:19:29,1194738157,2277,117,12,3,2,10
158497,2023-07-17 19:49:38,1194882514,11459,6,7,2,1,6
158510,2023-07-17 20:27:39,1194927311,161534,137,18,7,6,12
147386,2023-07-17 21:31:21,1195007861,2824,6,8,4,2,6
147256,2023-07-17 21:32:52,1195009650,5691,11,9,7,1,8
147281,2023-07-17 21:34:15,1195011396,15425,49,23,16,2,21
147792,2023-07-17 21:35:32,1195012949,0,0,13,8,0,13
147888,2023-07-17 21:36:31,1195014122,7661,25,5,3,2,3
158523,2023-07-17 22:32:44,1195084125,34265,34,40,29,3,37
158527,2023-07-17 22:52:43,1195108393,7058,9,12,2,3,9
158527,2023-07-17 22:52:45,1195108411,7058,9,12,2,3,9
158531,2023-07-17 23:01:42,1195119375,111860,173,34,21,11,23
158543,2023-07-18 02:40:48,1195293032,4378,42,46,14,2,44
158542,2023-07-18 02:43:35,1195294030,21425,50,31,20,7,24
158541,2023-07-18 02:46:19,1195294933,30141,106,45,27,5,40
158574,2023-07-18 15:34:52,1195801497,10589,96,28,7,4,24
158582,2023-07-18 15:50:12,1195814143,12014,17,35,17,3,32
158584,2023-07-18 15:50:29,1195814393,6068,9,10,5,1,9
158595,2023-07-18 16:12:31,1195833697,32823,71,10,4,2,8
158578,2023-07-18 16:32:21,1195852033,12976,27,17,13,1,16
158578,2023-07-18 16:32:24,1195852069,12976,27,17,13,1,16
158598,2023-07-18 16:32:33,1195852207,74450,202,42,22,12,30
158599,2023-07-18 16:32:42,1195852364,0,0,8,5,0,8
158580,2023-07-18 16:41:09,1195860360,54624,179,109,27,5,104
158607,2023-07-18 17:46:03,1196002279,3866,26,30,9,2,28
158608,2023-07-18 17:51:35,1196018508,22440,75,19,14,5,14
158611,2023-07-18 18:00:41,1196045392,7279,8,39,15,4,35
158612,2023-07-18 18:24:12,1196117275,1058,1,2,1,1,1
158610,2023-07-18 18:52:13,1196182844,10821,4,9,2,2,7
158610,2023-07-18 18:52:18,1196182992,10821,4,9,2,2,7
158609,2023-07-18 19:03:31,1196195957,424119,97,28,11,6,22
158626,2023-07-18 19:41:06,1196259447,48689,112,123,18,7,116
158627,2023-07-18 19:41:10,1196259609,15466,67,20,16,4,16
140068,2023-07-18 20:32:57,1196335509,0,2,15,9,0,15
140076,2023-07-18 20:33:31,1196336063,404,12,14,9,1,13
140196,2023-07-18 20:34:41,1196337181,5823,143,13,8,2,11
158666,2023-07-18 21:03:25,1196365964,18627,8,40,29,2,38
122289,2023-07-18 21:17:45,1196381839,0,0,3,1,0,3
158669,2023-07-18 21:41:57,1196406254,76848,91,10,6,6,4
158669,2023-07-18 21:41:58,1196406279,76848,91,10,6,6,4
158625,2023-07-18 21:41:59,1196406284,141767,96,67,39,8,59
158673,2023-07-18 22:20:22,1196443682,190074,47,49,29,4,45
158674,2023-07-18 22:22:00,1196445284,67618,105,54,31,8,46
158675,2023-07-18 22:22:34,1196445867,2029,22,28,24,2,26
158677,2023-07-18 22:23:02,1196446287,2601,15,6,5,2,4
158678,2023-07-18 22:23:25,1196446674,12712,113,61,39,4,57
158687,2023-07-18 22:28:26,1196451341,6075,22,10,1,8,2
158695,2023-07-18 23:23:20,1196513382,57928,64,46,18,6,40
158693,2023-07-18 23:23:24,1196513485,46569,114,25,16,6,19
158697,2023-07-18 23:31:43,1196523935,101775,29,12,5,3,9
158697,2023-07-18 23:31:48,1196524038,101775,29,12,5,3,9
158700,2023-07-18 23:49:54,1196546549,61129,225,13,5,4,9
158700,2023-07-18 23:49:55,1196546562,61129,225,13,5,4,9
158700,2023-07-18 23:49:58,1196546629,61129,225,13,5,4,9
158700,2023-07-18 23:49:59,1196546643,61129,225,13,5,4,9
158698,2023-07-18 23:50:08,1196546831,21514,148,24,21,4,20
158702,2023-07-19 00:17:46,1196576227,11489,34,5,5,3,2
158702,2023-07-19 00:17:52,1196576307,11489,34,5,5,3,2
158715,2023-07-19 14:27:45,1196983789,0,32,11,8,0,11
158664,2023-07-19 15:04:44,1197002219,238932,109,24,22,3,21
158692,2023-07-19 15:10:31,1197004740,18737,48,76,23,3,73
152364,2023-07-19 15:36:32,1197017853,117482,360,41,17,10,31
158717,2023-07-19 16:13:13,1197039223,1544,16,71,7,2,69
158739,2023-07-19 18:03:35,1197121637,0,0,2,0,0,2
158739,2023-07-19 18:03:39,1197121678,0,0,2,0,0,2
158742,2023-07-19 18:03:43,1197121740,0,0,6,5,0,6
158746,2023-07-19 18:49:25,1197158426,0,21,105,72,0,105
158755,2023-07-19 19:38:12,1197196235,47811,100,83,65,7,76
131521,2023-07-19 19:39:38,1197197347,63430,80,126,97,7,119
126145,2023-07-19 20:46:02,1197247003,17848,62,60,25,3,57
158769,2023-07-19 20:46:27,1197247316,0,0,1,0,0,1
126148,2023-07-19 20:46:34,1197247389,11479,115,100,56,8,92
126151,2023-07-19 20:46:55,1197247656,132764,96,70,38,4,66
126151,2023-07-19 20:46:59,1197247691,132764,96,70,38,4,66
136266,2023-07-19 20:47:19,1197247917,11496,55,32,14,3,29
149704,2023-07-19 20:48:06,1197248478,18063,25,24,22,1,23
158782,2023-07-19 22:25:50,1197318903,2564,19,42,16,1,41
158784,2023-07-19 22:41:49,1197329628,74372,187,180,23,5,175
158785,2023-07-19 22:46:31,1197332891,11349,48,51,22,3,48
158787,2023-07-19 22:51:44,1197336409,29923,197,47,26,5,42
158788,2023-07-19 23:00:18,1197342215,74626,87,35,24,6,29
158789,2023-07-19 23:01:18,1197342885,4949,30,14,4,3,11
158705,2023-07-19 23:47:05,1197372781,16961,28,19,12,4,15
158705,2023-07-19 23:47:06,1197372799,16961,28,19,12,4,15
158705,2023-07-19 23:47:07,1197372815,16961,28,19,12,4,15
158705,2023-07-19 23:47:10,1197372854,16961,28,19,12,4,15
158705,2023-07-19 23:47:11,1197372864,16961,28,19,12,4,15
158705,2023-07-19 23:47:12,1197372883,16961,28,19,12,4,15
158705,2023-07-19 23:47:13,1197372886,16961,28,19,12,4,15
158705,2023-07-19 23:47:14,1197372906,16961,28,19,12,4,15
158705,2023-07-19 23:47:16,1197372923,16961,28,19,12,4,15
158694,2023-07-19 23:56:02,1197378465,69702,178,32,16,5,27
158696,2023-07-19 23:56:46,1197378945,62908,236,23,14,4,19
158696,2023-07-19 23:56:47,1197378950,62908,236,23,14,4,19
158703,2023-07-20 00:00:20,1197381073,1324,2,4,1,1,3
158703,2023-07-20 00:00:21,1197381079,1324,2,4,1,1,3
158796,2023-07-20 00:52:40,1197409090,34845,75,8,5,3,5
158800,2023-07-20 01:12:06,1197418197,59391,61,14,5,2,12
158808,2023-07-20 14:44:25,1197571491,21893,62,31,14,3,28
158809,2023-07-20 14:44:56,1197571648,32779,86,52,31,5,47
158813,2023-07-20 15:55:11,1197606000,17093,67,22,14,6,16
158706,2023-07-20 15:55:56,1197606366,12164,39,17,6,5,12
158818,2023-07-20 16:13:34,1197617259,66443,31,29,19,3,26
158820,2023-07-20 16:54:00,1197644373,15362,72,32,21,3,29
158820,2023-07-20 16:54:03,1197644419,15362,72,32,21,3,29
158828,2023-07-20 17:08:34,1197654478,7906,57,15,9,3,12
147910,2023-07-20 17:11:23,1197656320,0,1,45,36,0,45
158819,2023-07-20 17:30:19,1197669926,164878,357,72,34,17,55
158819,2023-07-20 17:30:21,1197669951,164878,357,72,34,17,55
158823,2023-07-20 17:30:30,1197670077,26784,91,28,16,6,22
158829,2023-07-20 17:30:37,1197670146,36679,84,16,13,4,12
158829,2023-07-20 17:30:39,1197670183,36679,84,16,13,4,12
158832,2023-07-20 17:30:50,1197670332,94166,164,68,50,9,59
158832,2023-07-20 17:30:52,1197670355,94166,164,68,50,9,59
158833,2023-07-20 17:31:00,1197670430,67790,126,83,52,5,78
158838,2023-07-20 17:31:24,1197670790,46513,67,10,5,4,6
158839,2023-07-20 17:31:32,1197670881,117573,295,55,36,9,46
158843,2023-07-20 17:46:08,1197681734,57521,14,32,25,2,30
158844,2023-07-20 17:51:16,1197685536,26499,144,17,7,5,12
158846,2023-07-20 17:56:18,1197689340,7811,52,45,9,2,43
158791,2023-07-20 17:56:56,1197689775,292188,194,72,42,9,63
158825,2023-07-20 17:57:04,1197689891,165,5,8,4,1,7
158831,2023-07-20 17:57:28,1197690199,15168,142,19,16,2,17
158834,2023-07-20 17:57:39,1197690316,0,0,6,3,0,6
158841,2023-07-20 17:57:52,1197690471,117795,157,65,37,8,57
158845,2023-07-20 17:58:02,1197690579,170327,164,64,41,8,56
158847,2023-07-20 18:03:09,1197694441,20059,130,14,8,7,7
158849,2023-07-20 18:03:27,1197694679,18462,3,3,2,2,1
158848,2023-07-20 18:03:29,1197694695,128625,241,30,21,8,22
158862,2023-07-20 18:23:28,1197709723,87126,108,25,11,9,16
158866,2023-07-20 18:37:25,1197720542,25895,100,40,26,3,37
100988,2023-07-20 18:39:22,1197722046,12588,28,33,22,2,31
100985,2023-07-20 18:40:28,1197722822,23409,103,91,49,4,87
100982,2023-07-20 18:40:52,1197723118,0,5,64,28,0,64
100990,2023-07-20 18:41:22,1197723516,55,13,26,17,1,25
131434,2023-07-20 18:41:46,1197723783,810,42,37,8,2,35
158868,2023-07-20 18:42:36,1197724425,52914,110,47,22,6,41
158836,2023-07-20 18:44:35,1197725997,10440,30,6,3,2,4
158860,2023-07-20 18:56:07,1197734931,88824,301,51,27,10,41
158860,2023-07-20 18:56:09,1197734979,88824,301,51,27,10,41
158865,2023-07-20 18:56:21,1197735121,161774,108,58,32,5,53
158867,2023-07-20 18:56:29,1197735238,63142,108,45,25,12,33
158869,2023-07-20 18:56:37,1197735323,114364,117,18,15,7,11
158871,2023-07-20 18:56:46,1197735427,1205,8,11,5,1,10
158880,2023-07-20 18:56:53,1197735520,0,0,11,6,0,11
158882,2023-07-20 19:04:45,1197741670,62748,336,52,30,7,45
158888,2023-07-20 19:27:16,1197758932,0,2,41,5,0,41
158881,2023-07-20 19:32:35,1197762927,9076,8,2,0,1,1
158884,2023-07-20 19:32:47,1197763076,0,38,32,30,0,32
158889,2023-07-20 19:33:08,1197763352,1480,66,44,28,1,43
158890,2023-07-20 19:34:11,1197764133,25877,146,31,2,12,19
158901,2023-07-20 20:14:53,1197793697,19326,40,16,12,4,12
115504,2023-07-20 20:15:07,1197793905,12281,97,51,33,5,46
158900,2023-07-20 20:16:26,1197794889,46800,141,86,37,11,75
158903,2023-07-20 20:34:40,1197807923,101484,102,43,26,10,33
158902,2023-07-20 20:36:45,1197809523,436,5,3,0,3,0
158904,2023-07-20 20:39:18,1197811424,11973,18,7,0,2,5
158905,2023-07-20 20:41:02,1197812597,44505,124,35,10,5,30
158907,2023-07-20 21:16:29,1197837994,1418,12,9,4,1,8
158908,2023-07-20 21:39:14,1197854316,122557,203,79,27,6,73
158794,2023-07-20 21:59:08,1197868132,2588,35,41,17,2,39
158920,2023-07-20 23:13:11,1197917116,3109,14,10,8,2,8
158945,2023-07-21 14:28:00,1198137142,138337,259,45,31,8,37
158946,2023-07-21 14:30:14,1198137813,91687,194,86,46,13,73
158910,2023-07-21 15:04:36,1198149828,92447,48,54,17,5,49
158910,2023-07-21 15:04:38,1198149838,92447,48,54,17,5,49
97780,2023-07-21 15:45:13,1198169030,140729,153,85,61,9,76
97780,2023-07-21 15:45:20,1198169089,140729,153,85,61,9,76
98285,2023-07-21 15:52:31,1198173108,12936,28,107,67,4,103
98288,2023-07-21 15:52:58,1198173319,82760,128,39,17,8,31
97777,2023-07-21 15:53:43,1198173742,107373,336,164,33,11,153
98276,2023-07-21 15:54:22,1198174154,62159,116,20,10,5,15
108975,2023-07-21 15:55:03,1198174562,15296,54,17,5,3,14
149818,2023-07-21 15:55:48,1198174975,5426,5,18,6,3,15
149817,2023-07-21 15:56:30,1198175344,28617,169,48,4,6,42
149293,2023-07-21 15:57:07,1198175718,7814,108,86,39,9,77
112434,2023-07-21 16:08:58,1198182364,48572,61,78,50,3,75
158949,2023-07-21 16:29:05,1198195125,23926,166,9,4,4,5
158976,2023-07-21 17:58:50,1198259288,24682,60,21,15,4,17
158977,2023-07-21 17:58:59,1198259421,26657,12,16,5,3,13
158978,2023-07-21 17:59:09,1198259586,140222,207,62,37,15,47
158979,2023-07-21 17:59:14,1198259657,74844,157,21,14,10,11
159000,2023-07-21 18:37:22,1198289106,37366,25,31,18,1,30
158981,2023-07-21 18:55:13,1198303318,25433,209,39,25,6,33
158981,2023-07-21 18:55:16,1198303365,25433,209,39,25,6,33
159003,2023-07-21 18:57:57,1198305456,7625,50,12,8,3,9
159004,2023-07-21 18:58:06,1198305611,36828,327,29,7,13,16
159006,2023-07-21 19:09:52,1198314973,97488,283,18,12,9,9
159022,2023-07-21 20:23:22,1198370489,69317,25,40,31,1,39
159023,2023-07-21 20:28:19,1198374003,72250,62,48,42,3,45
148600,2023-07-21 20:32:17,1198376894,23850,42,31,12,3,28
148488,2023-07-21 20:32:44,1198377203,176310,219,117,54,10,107
148506,2023-07-21 20:33:11,1198377561,117372,238,95,64,6,89
148594,2023-07-21 20:33:39,1198377894,10682,26,57,37,2,55
148598,2023-07-21 20:34:05,1198378218,3024,38,32,21,2,30
159027,2023-07-21 20:50:17,1198389631,0,0,10,3,0,10
159026,2023-07-21 20:50:51,1198390016,0,5,6,3,0,6
159016,2023-07-21 20:51:15,1198390339,19537,13,5,1,3,2
159019,2023-07-21 20:51:25,1198390458,3464,4,4,0,1,3
159025,2023-07-21 20:51:29,1198390518,0,0,1,0,0,1
159020,2023-07-21 20:51:41,1198390649,119538,229,30,17,16,14
159028,2023-07-21 20:51:47,1198390719,20958,45,6,6,2,4
159024,2023-07-21 20:51:54,1198390790,9839,25,4,2,1,3
94881,2023-07-21 21:06:32,1198401064,2726,24,15,7,1,14
159029,2023-07-21 21:36:23,1198436715,230804,101,17,5,3,14
159030,2023-07-21 21:36:33,1198436948,95410,280,19,10,14,5
159031,2023-07-21 21:36:45,1198437252,49298,196,18,10,2,16
159032,2023-07-21 21:36:57,1198437548,93875,151,20,16,5,15
159051,2023-07-21 22:00:41,1198472438,23681,53,56,32,5,51
159050,2023-07-21 22:00:45,1198472562,0,0,20,16,0,20
159052,2023-07-21 22:06:10,1198480269,3111,25,18,9,3,15
159053,2023-07-21 22:11:11,1198487553,33955,30,78,66,2,76
159057,2023-07-21 22:29:14,1198502530,3970,93,21,10,5,16
138470,2023-07-21 22:30:35,1198503477,10193,65,65,20,2,63
159055,2023-07-21 22:45:34,1198513537,37472,42,38,28,4,34
159058,2023-07-21 22:45:47,1198513665,141863,32,32,27,3,29
159061,2023-07-21 22:45:55,1198513737,23033,127,46,34,8,38
159061,2023-07-21 22:45:58,1198513769,23033,127,46,34,8,38
159062,2023-07-21 22:46:05,1198513856,2753,17,30,20,3,27
159063,2023-07-21 23:06:42,1198527226,18367,115,38,24,7,31
159007,2023-07-21 23:07:23,1198527741,53544,47,67,16,5,62
159056,2023-07-21 23:09:17,1198528930,42099,139,83,45,10,73
159065,2023-07-21 23:18:18,1198534624,15275,30,32,27,4,28
159066,2023-07-21 23:23:41,1198538064,96418,85,50,39,8,42
159068,2023-07-21 23:49:13,1198553061,145895,101,40,28,5,35
159069,2023-07-22 00:00:08,1198559155,289,9,25,17,1,24
159067,2023-07-22 00:37:37,1198578593,39888,10,22,21,1,21
159070,2023-07-22 00:45:07,1198582144,45805,131,76,26,9,67
159071,2023-07-22 01:00:29,1198587503,34027,74,182,45,15,167
159075,2023-07-22 15:14:17,1198752006,4914,101,15,4,2,13
159076,2023-07-22 15:17:20,1198753033,5330,14,13,8,3,10
159077,2023-07-22 15:23:28,1198755221,30479,121,76,23,1,75
159079,2023-07-22 15:42:14,1198762369,15811,88,36,21,6,30
159080,2023-07-22 15:46:05,1198763806,116044,143,115,49,24,91
159083,2023-07-22 15:57:08,1198768312,7331,51,57,21,3,54
97715,2023-07-22 16:27:22,1198781461,50186,140,78,58,6,72
97715,2023-07-22 16:27:27,1198781498,50186,140,78,58,6,72
97770,2023-07-22 16:28:00,1198781745,13590,102,51,31,4,47
159110,2023-07-22 16:29:08,1198782306,9878,92,22,16,2,20
159114,2023-07-22 16:36:45,1198785940,45950,131,12,7,6,6
159113,2023-07-22 16:37:12,1198786183,46323,77,16,9,5,11
159112,2023-07-22 16:37:48,1198786468,34626,147,28,23,5,23
159111,2023-07-22 16:38:15,1198786735,165253,118,37,15,11,26
159115,2023-07-22 16:38:23,1198786801,30520,102,58,14,9,49
159109,2023-07-22 16:39:00,1198787117,749,14,11,8,1,10
159116,2023-07-22 16:39:01,1198787127,2856,7,14,10,1,13
159124,2023-07-22 16:57:26,1198796563,22553,51,30,16,2,28
159125,2023-07-22 17:02:10,1198798928,108693,102,26,11,8,18
159126,2023-07-22 17:07:05,1198801511,39249,142,13,7,4,9
159128,2023-07-22 17:13:44,1198805140,53157,58,92,30,4,88
159129,2023-07-22 17:19:35,1198808308,25170,85,49,28,2,47
159131,2023-07-22 19:04:33,1198868166,221659,372,49,7,7,42
159142,2023-07-24 14:27:47,1199535133,11879,28,5,0,2,3
159142,2023-07-24 14:27:49,1199535146,11879,28,5,0,2,3
159144,2023-07-24 14:51:41,1199543172,0,0,2,2,0,2
159144,2023-07-24 14:51:44,1199543187,0,0,2,2,0,2
159145,2023-07-24 14:56:23,1199544849,41561,68,4,3,3,1
159145,2023-07-24 14:56:24,1199544855,41561,68,4,3,3,1
159084,2023-07-24 15:08:49,1199549516,622300,310,126,31,17,109
107939,2023-07-24 15:43:08,1199567344,97880,111,34,20,9,25
107939,2023-07-24 15:43:15,1199567406,97880,111,34,20,9,25
137964,2023-07-24 15:44:01,1199567784,6861,13,22,11,2,20
159151,2023-07-24 15:48:40,1199570525,2960,13,30,17,1,29
159151,2023-07-24 15:48:43,1199570550,2960,13,30,17,1,29
159150,2023-07-24 15:48:58,1199570706,0,3,20,3,0,20
159152,2023-07-24 15:49:21,1199570953,13495,94,10,7,2,8
159153,2023-07-24 15:56:36,1199575122,0,0,6,5,0,6
159154,2023-07-24 16:05:33,1199580462,102409,308,62,34,5,57
108874,2023-07-24 16:05:52,1199580669,9861,29,11,6,3,8
114575,2023-07-24 16:20:13,1199589805,1282,1,2,1,1,1
159155,2023-07-24 16:36:15,1199600878,51602,79,30,14,4,26
159155,2023-07-24 16:36:20,1199600932,51602,79,30,14,4,26
159078,2023-07-24 17:15:21,1199630174,36100,172,84,40,4,80
159173,2023-07-24 17:25:48,1199638006,26002,94,100,51,8,92
159082,2023-07-24 17:27:42,1199639399,50330,76,43,24,4,39
159177,2023-07-24 18:15:08,1199677885,89725,139,11,4,6,5
159181,2023-07-24 18:36:36,1199695286,12294,44,12,6,2,10
159181,2023-07-24 18:36:39,1199695330,12294,44,12,6,2,10
159181,2023-07-24 18:36:41,1199695369,12294,44,12,6,2,10
159192,2023-07-24 19:26:46,1199738002,95357,297,265,47,6,259
159195,2023-07-24 19:36:06,1199745863,56348,162,34,18,9,25
159194,2023-07-24 19:36:32,1199746188,10696,77,13,6,2,11
159193,2023-07-24 19:36:57,1199746538,0,4,30,28,0,30
159205,2023-07-24 20:09:29,1199773424,3400,3,19,3,1,18
159207,2023-07-24 20:57:13,1199815066,8026,176,33,7,3,30
159208,2023-07-24 21:07:01,1199823454,51248,146,24,3,10,14
159208,2023-07-24 21:07:04,1199823510,51248,146,24,3,10,14
159208,2023-07-24 21:07:06,1199823563,51248,146,24,3,10,14
159215,2023-07-24 22:17:12,1199885418,28811,62,39,26,7,32
159220,2023-07-24 22:24:58,1199891520,26498,52,70,28,5,65
159236,2023-07-24 22:46:11,1199908261,27202,50,49,30,3,46
143185,2023-07-24 22:47:40,1199909449,18962,114,31,24,5,26
143185,2023-07-24 22:47:42,1199909489,18962,114,31,24,5,26
159238,2023-07-24 23:12:39,1199927966,34853,310,55,36,10,45
159264,2023-07-25 15:52:30,1201271800,58346,166,70,34,4,66
159267,2023-07-25 16:00:19,1201276422,2737,14,2,0,2,0
159269,2023-07-25 16:16:04,1201286668,314068,351,201,93,22,179
159269,2023-07-25 16:16:08,1201286734,314068,351,201,93,22,179
159270,2023-07-25 16:18:01,1201288103,41126,25,25,6,7,18
123105,2023-07-25 16:44:20,1201309344,83744,98,35,30,3,32
123106,2023-07-25 16:45:10,1201310035,198059,208,45,35,9,36
123107,2023-07-25 16:45:43,1201310487,44897,110,79,35,8,71
135929,2023-07-25 16:46:35,1201311205,6237,5,8,6,3,5
159301,2023-07-25 17:01:26,1201323323,0,0,22,21,0,22
159301,2023-07-25 17:01:36,1201323438,0,0,22,21,0,22
159297,2023-07-25 17:04:16,1201325612,213239,244,53,24,11,42
159297,2023-07-25 17:04:19,1201325647,213239,244,53,24,11,42
159302,2023-07-25 17:04:49,1201326051,5482,128,84,9,6,78
135856,2023-07-25 17:12:56,1201332793,6792,21,21,14,2,19
159300,2023-07-25 17:24:41,1201342922,0,16,27,11,0,27
159299,2023-07-25 17:25:15,1201343547,15414,104,20,9,3,17
159298,2023-07-25 17:25:47,1201344003,0,28,2,2,0,2
159308,2023-07-25 17:43:13,1201357745,30411,9,10,2,1,9
159307,2023-07-25 17:43:17,1201357790,25313,153,21,9,4,17
159312,2023-07-25 17:51:39,1201363996,15456,32,116,56,4,112
159306,2023-07-25 18:40:19,1201408668,96344,76,101,61,2,99
159306,2023-07-25 18:40:22,1201408701,96344,76,101,61,2,99
159320,2023-07-25 18:40:40,1201408933,31478,87,67,57,3,64
159320,2023-07-25 18:40:43,1201408995,31478,87,67,57,3,64
159321,2023-07-25 18:40:52,1201409149,750,24,10,6,1,9
159322,2023-07-25 18:41:08,1201409440,16669,43,15,6,3,12
159322,2023-07-25 18:41:11,1201409488,16669,43,15,6,3,12
159328,2023-07-25 18:41:21,1201409660,33819,202,21,15,4,17
159332,2023-07-25 19:58:47,1201490359,70406,115,84,54,7,77
159360,2023-07-25 22:35:53,1201620649,66072,80,9,4,4,5
159370,2023-07-25 22:51:43,1201633142,37929,80,30,19,5,25
159368,2023-07-25 22:52:12,1201633544,60566,66,37,30,3,34
159371,2023-07-25 22:59:30,1201639381,89577,90,13,11,3,10
159372,2023-07-25 23:02:34,1201641797,82270,234,27,22,11,16
159373,2023-07-25 23:29:06,1201662777,13582,22,4,3,1,3
138907,2023-07-26 15:22:14,1201929874,7179,18,29,22,1,28
138910,2023-07-26 15:23:00,1201930276,2878,7,4,2,1,3
138912,2023-07-26 15:23:38,1201930641,15062,64,31,13,4,27
159404,2023-07-26 15:24:59,1201931412,10224,88,9,3,2,7
159406,2023-07-26 15:32:18,1201935635,67303,195,51,20,7,44
159147,2023-07-26 15:33:36,1201936368,69151,180,75,22,5,70
159407,2023-07-26 15:39:03,1201939597,11099,68,13,7,3,10
111272,2023-07-26 16:21:55,1201967118,37779,98,35,29,6,29
159427,2023-07-26 16:29:54,1201972744,4853,49,18,8,2,16
159438,2023-07-26 16:57:56,1201993646,11185,284,9,4,2,7
159385,2023-07-26 16:58:51,1201994344,47269,138,73,41,11,62
159386,2023-07-26 16:59:01,1201994482,29203,0,17,14,1,16
159387,2023-07-26 16:59:08,1201994598,11555,28,6,4,2,4
159396,2023-07-26 17:00:13,1201995402,245495,93,17,10,5,12
159405,2023-07-26 17:00:22,1201995502,1548,37,35,21,2,33
108672,2023-07-26 17:15:22,1202007069,80770,129,45,28,5,40
108501,2023-07-26 17:15:58,1202007488,41939,91,89,57,6,83
108499,2023-07-26 17:16:24,1202007865,99564,106,90,38,5,85
108479,2023-07-26 17:16:58,1202008275,28276,23,119,58,4,115
149779,2023-07-26 17:17:28,1202008662,15492,168,44,26,9,35
149448,2023-07-26 17:17:54,1202008990,69309,55,34,15,5,29
116529,2023-07-26 17:41:17,1202028049,61373,131,61,28,12,49
114831,2023-07-26 17:41:48,1202028467,640,21,25,8,1,24
127117,2023-07-26 17:42:22,1202028962,55847,129,57,15,3,54
116412,2023-07-26 17:42:40,1202029183,11918,5,14,6,3,11
159441,2023-07-26 17:55:36,1202047555,67418,78,67,57,5,62
159442,2023-07-26 17:55:44,1202047847,25383,115,23,15,3,20
159444,2023-07-26 17:55:50,1202048026,86315,127,20,10,6,14
116409,2023-07-26 17:58:02,1202052705,39426,27,15,3,4,11
148992,2023-07-26 17:58:26,1202053470,65462,236,25,14,5,20
159408,2023-07-26 18:11:55,1202076502,0,0,7,5,0,7
159452,2023-07-26 18:21:47,1202092875,50363,71,141,123,5,136
159460,2023-07-26 18:50:55,1202117013,54290,129,88,25,6,82
149629,2023-07-26 19:53:51,1202172391,91459,305,76,52,11,65
150081,2023-07-26 19:54:21,1202172802,70497,172,46,25,7,39
149640,2023-07-26 19:54:42,1202173095,11687,24,14,3,4,10
149858,2023-07-26 19:55:08,1202173432,10957,55,23,13,5,18
159497,2023-07-26 20:41:31,1202215604,10878,63,22,20,5,17
159498,2023-07-26 20:41:41,1202215724,117366,135,84,22,7,77
159510,2023-07-26 21:42:25,1202277202,32660,38,19,12,4,15
159509,2023-07-26 21:42:57,1202277681,95263,26,92,54,4,88
159507,2023-07-26 21:43:29,1202278270,12026,39,21,10,3,18
159506,2023-07-26 21:43:55,1202278732,85820,143,35,31,5,30
159505,2023-07-26 21:44:17,1202279123,1,1,15,9,1,14
159502,2023-07-26 21:44:40,1202279535,113,2,10,5,2,8
159501,2023-07-26 21:44:57,1202279816,48164,151,30,10,7,23
159500,2023-07-26 21:45:19,1202280172,68975,257,55,41,9,46
159499,2023-07-26 21:45:44,1202280530,47001,29,68,50,4,64
132158,2023-07-26 22:13:41,1202308404,8923,8,28,19,2,26
132152,2023-07-26 22:14:52,1202309451,3952,10,45,19,2,43
132153,2023-07-26 22:15:20,1202309870,4329,2,22,15,1,21
140796,2023-07-26 22:15:49,1202310271,202871,12,24,16,1,23
132164,2023-07-26 22:16:32,1202310889,23774,91,108,60,7,101
132160,2023-07-26 22:16:57,1202311242,0,0,19,14,0,19
159513,2023-07-26 22:20:35,1202314202,20344,88,38,8,6,32
139595,2023-07-26 22:26:29,1202319387,4093,26,20,15,1,19
139595,2023-07-26 22:26:32,1202319482,4093,26,20,15,1,19
139530,2023-07-26 22:26:59,1202320278,139721,157,91,66,12,79
139530,2023-07-26 22:27:02,1202320374,139721,157,91,66,12,79
149270,2023-07-26 22:30:07,1202326080,7224,24,20,6,1,19
159504,2023-07-26 22:40:16,1202345487,58779,64,33,21,3,30
159517,2023-07-26 23:07:06,1202395375,24028,36,11,9,2,9
159518,2023-07-26 23:07:16,1202395746,16684,10,53,33,2,51
159525,2023-07-26 23:07:23,1202395969,65903,297,74,42,6,68
139526,2023-07-26 23:09:21,1202399642,1432,17,63,36,2,61
139526,2023-07-26 23:09:22,1202399691,1432,17,63,36,2,61
139526,2023-07-26 23:09:23,1202399715,1432,17,63,36,2,61
159527,2023-07-26 23:43:31,1202452144,116739,29,22,17,3,19
159529,2023-07-26 23:43:38,1202452305,20594,17,23,17,2,21
159532,2023-07-26 23:45:05,1202454390,17424,198,36,14,4,32
159612,2023-07-27 18:45:24,1202919297,46450,33,19,12,2,17
159612,2023-07-27 18:45:29,1202919342,46450,33,19,12,2,17
159613,2023-07-27 18:47:58,1202921821,43855,53,24,10,6,18
159613,2023-07-27 18:48:02,1202921877,43855,53,24,10,6,18
159652,2023-07-27 21:05:21,1203056705,2773,16,12,3,2,10
159653,2023-07-27 21:05:54,1203057151,57624,168,59,38,5,54
159654,2023-07-27 21:06:19,1203057565,31970,177,41,25,5,36
159657,2023-07-27 21:15:17,1203066422,7368,12,4,1,2,2
159665,2023-07-27 21:54:31,1203103370,876479,420,135,49,15,120
130084,2023-07-27 22:00:17,1203108715,0,0,7,2,0,7
159666,2023-07-27 22:02:59,1203111189,9490,25,43,31,1,42
159669,2023-07-27 22:16:30,1203124110,26377,119,7,3,3,4
159675,2023-07-27 22:56:26,1203164473,10908,50,17,2,2,15
159674,2023-07-27 22:56:51,1203164834,18767,44,76,23,4,72
159673,2023-07-27 22:57:07,1203165076,0,0,14,0,0,14
159681,2023-07-27 23:29:24,1203192461,42410,141,83,45,10,73
159684,2023-07-27 23:37:08,1203197812,40857,197,151,39,11,140
159682,2023-07-27 23:37:15,1203197894,4658,2,10,8,1,9
159680,2023-07-27 23:37:25,1203198038,49611,131,37,12,9,28
159679,2023-07-27 23:37:34,1203198138,11836,23,14,8,2,12
159668,2023-07-27 23:38:28,1203198764,15047,146,6,3,4,2
159670,2023-07-27 23:38:45,1203198981,19596,93,49,32,2,47
147130,2023-07-28 04:26:22,1203325430,718,15,19,14,1,18
147129,2023-07-28 04:27:15,1203325599,54013,141,54,32,6,48
159700,2023-07-28 04:35:05,1203327138,98254,25,11,8,1,10
159701,2023-07-28 04:40:13,1203328127,1500,25,52,40,1,51
159703,2023-07-28 14:24:46,1203408481,24524,130,20,18,3,17
159714,2023-07-28 14:57:06,1203420145,57646,135,20,10,7,13
159715,2023-07-28 14:57:28,1203420269,29090,100,43,32,6,37
159715,2023-07-28 14:57:29,1203420280,29090,100,43,32,6,37
159597,2023-07-28 15:22:25,1203431346,79560,167,48,24,6,42
159597,2023-07-28 15:22:31,1203431394,79560,167,48,24,6,42
159717,2023-07-28 15:30:59,1203435839,0,0,3,2,0,3
159720,2023-07-28 15:38:33,1203440142,55443,71,60,19,6,54
159676,2023-07-28 15:39:48,1203440881,34252,152,57,38,5,52
159722,2023-07-28 15:55:10,1203450102,23716,55,4,3,4,0
159723,2023-07-28 15:55:41,1203450384,31234,71,83,40,4,79
159724,2023-07-28 15:58:32,1203452211,24637,8,8,5,3,5
132793,2023-07-28 16:18:22,1203464809,72953,50,120,81,6,114
133107,2023-07-28 16:20:47,1203466493,111515,98,72,43,10,62
133015,2023-07-28 16:21:11,1203466767,60586,98,23,12,4,19
159727,2023-07-28 16:26:59,1203470444,86157,179,51,6,4,47
159736,2023-07-28 18:09:12,1203543062,4894,32,39,21,5,34
159744,2023-07-28 18:53:55,1203576873,21363,107,19,15,2,17
159745,2023-07-28 18:59:20,1203580672,95626,40,75,51,6,69
159746,2023-07-28 19:01:35,1203582448,152531,125,41,23,10,31
159747,2023-07-28 19:06:16,1203586038,37418,101,33,10,6,27
159748,2023-07-28 19:14:35,1203592051,48595,51,39,23,3,36
159749,2023-07-28 19:20:36,1203596524,70222,71,64,25,3,61
159750,2023-07-28 19:26:14,1203600798,42715,38,12,3,2,10
159751,2023-07-28 19:31:59,1203604932,112081,235,46,25,7,39
159741,2023-07-28 19:36:27,1203608438,27810,26,37,23,3,34
159743,2023-07-28 19:36:42,1203608637,32429,56,36,26,3,33
159760,2023-07-28 20:16:47,1203638450,5232,47,9,6,1,8
159769,2023-07-28 20:17:02,1203638590,25538,308,289,43,7,282
159770,2023-07-28 20:25:54,1203644952,97981,289,113,77,12,101
159772,2023-07-28 20:33:00,1203650039,1954,140,19,8,2,17
159773,2023-07-28 21:06:32,1203673529,13981,31,34,17,3,31
159782,2023-07-28 21:15:41,1203679555,56504,58,10,7,6,4
159785,2023-07-28 21:15:48,1203679629,32871,71,20,9,5,15
159791,2023-07-28 22:03:41,1203712428,71466,82,90,47,7,83
159793,2023-07-28 22:13:23,1203718780,112864,164,47,29,7,40
159797,2023-07-28 22:23:57,1203725933,117704,208,89,57,13,76
159797,2023-07-28 22:23:59,1203725962,117704,208,89,57,13,76
159797,2023-07-28 22:24:03,1203726014,117704,208,89,57,13,76
147488,2023-07-28 22:27:41,1203728401,41294,235,131,84,13,118
147489,2023-07-28 22:31:33,1203730849,166,4,5,0,1,4
159792,2023-07-28 22:32:44,1203731639,225990,77,47,11,6,41
159792,2023-07-28 22:32:48,1203731691,225990,77,47,11,6,41
159794,2023-07-28 23:07:43,1203761662,118858,200,90,27,11,79
159794,2023-07-28 23:07:48,1203761736,118858,200,90,27,11,79
159820,2023-07-29 14:26:11,1203994160,156853,193,25,14,5,20
159821,2023-07-29 14:30:59,1203995323,0,0,5,4,0,5
159822,2023-07-29 14:40:56,1203997976,102547,77,36,14,6,30
159822,2023-07-29 14:40:59,1203997985,102547,77,36,14,6,30
159822,2023-07-29 14:41:00,1203997987,102547,77,36,14,6,30
159822,2023-07-29 14:41:02,1203997992,102547,77,36,14,6,30
159823,2023-07-29 14:49:20,1204000368,0,0,10,6,0,10
159823,2023-07-29 14:49:22,1204000378,0,0,10,6,0,10
159824,2023-07-29 14:53:43,1204001592,17006,153,7,4,2,5
159824,2023-07-29 14:53:44,1204001599,17006,153,7,4,2,5
159828,2023-07-29 15:20:26,1204009906,363,4,23,9,2,21
159828,2023-07-29 15:20:27,1204009923,363,4,23,9,2,21
159825,2023-07-29 15:24:04,1204011360,124483,75,13,7,5,8
159829,2023-07-29 15:26:11,1204012282,39809,274,13,4,4,9
159830,2023-07-29 15:31:06,1204014902,13428,213,37,28,6,31
159830,2023-07-29 15:31:08,1204014923,13428,213,37,28,6,31
159830,2023-07-29 15:31:09,1204014938,13428,213,37,28,6,31
128875,2023-07-29 15:43:36,1204021899,0,11,16,5,0,16
159831,2023-07-29 15:51:05,1204025922,0,0,2,1,0,2
147487,2023-07-29 15:53:41,1204027479,14545,87,83,62,5,78
159833,2023-07-29 16:23:41,1204045722,13607,40,50,3,3,47
159835,2023-07-29 16:25:22,1204046772,47268,166,11,6,3,8
159834,2023-07-29 16:25:47,1204047001,2879,20,12,3,2,10
159832,2023-07-29 16:26:14,1204047306,3111,11,17,13,1,16
159836,2023-07-29 16:27:46,1204048144,93994,240,68,44,16,52
159836,2023-07-29 16:27:50,1204048185,93994,240,68,44,16,52
147492,2023-07-29 16:39:05,1204054453,10142,79,17,13,5,12
147492,2023-07-29 16:39:07,1204054481,10142,79,17,13,5,12
159838,2023-07-29 16:56:06,1204064841,77312,169,56,37,9,47
159838,2023-07-29 16:56:09,1204064881,77312,169,56,37,9,47
159837,2023-07-29 16:58:03,1204065988,6989,144,26,11,6,20
159837,2023-07-29 16:58:07,1204066030,6989,144,26,11,6,20
147125,2023-07-29 17:43:39,1204092430,17506,63,69,50,3,66
147125,2023-07-29 17:43:44,1204092486,17506,63,69,50,3,66
147146,2023-07-29 17:44:42,1204093107,12991,77,64,42,3,61
159847,2023-07-29 17:57:25,1204100986,32139,40,13,2,4,9
159858,2023-07-29 18:08:55,1204107977,15405,36,23,16,4,19
159858,2023-07-29 18:08:58,1204108015,15405,36,23,16,4,19
159859,2023-07-29 18:14:02,1204111098,77162,83,51,33,4,47
159827,2023-07-29 18:17:35,1204113187,122154,172,116,59,11,105
159827,2023-07-29 18:17:38,1204113211,122154,172,116,59,11,105
159827,2023-07-29 18:17:39,1204113227,122154,172,116,59,11,105
159860,2023-07-29 18:20:35,1204115047,160765,605,263,84,30,233
159860,2023-07-29 18:20:39,1204115076,160765,605,263,84,30,233
126185,2023-07-29 18:25:04,1204118828,8936,8,7,4,1,6
126189,2023-07-29 18:25:35,1204119535,166715,129,36,23,9,27
133748,2023-07-29 18:26:05,1204120066,14003,212,13,7,4,9
126191,2023-07-29 18:26:41,1204120889,103032,50,15,8,3,12
126191,2023-07-29 18:26:45,1204121058,103032,50,15,8,3,12
133749,2023-07-29 18:27:16,1204121631,72743,292,50,25,9,41
159862,2023-07-29 18:58:42,1204139900,1710,41,8,3,1,7
159870,2023-07-29 19:16:35,1204150124,16677,143,36,15,6,30
159871,2023-07-29 19:38:19,1204162868,0,0,1,0,0,1
159872,2023-07-29 19:38:27,1204162954,3927,34,31,2,3,28
159874,2023-07-29 19:38:39,1204163053,46423,47,13,5,1,12
159875,2023-07-29 19:39:04,1204163293,10635,70,12,4,1,11
159876,2023-07-29 19:39:22,1204163506,0,17,5,5,0,5
125079,2023-07-31 14:29:44,1204865143,24867,67,34,23,6,28
159887,2023-07-31 14:31:39,1204865711,58806,160,6,3,5,1
125081,2023-07-31 14:31:44,1204865727,39025,149,114,84,6,108
125081,2023-07-31 14:31:51,1204865757,39025,149,114,84,6,108
148983,2023-07-31 14:31:56,1204865782,65089,55,35,28,5,30
144011,2023-07-31 14:32:08,1204865844,75735,36,83,61,4,79
148953,2023-07-31 14:32:19,1204865904,568,80,19,12,1,18
128864,2023-07-31 14:44:15,1204872885,7429,16,29,12,2,27
128864,2023-07-31 14:44:17,1204872932,7429,16,29,12,2,27
159894,2023-07-31 15:19:29,1204915763,16840,45,17,9,2,15
159902,2023-07-31 15:42:13,1204940392,72984,34,18,12,2,16
159901,2023-07-31 15:42:31,1204940562,0,19,3,1,0,3
159915,2023-07-31 15:53:35,1204947153,106103,302,68,40,5,63
159917,2023-07-31 15:57:53,1204949863,71890,66,101,38,3,98
149899,2023-07-31 16:09:54,1204958011,6503,81,28,5,6,22
150184,2023-07-31 16:10:21,1204958311,113449,55,31,21,3,28
159930,2023-07-31 16:20:26,1204965827,40715,41,12,2,3,9
159941,2023-07-31 16:52:46,1204992863,6594,5,35,17,2,33
159943,2023-07-31 16:54:57,1204994771,0,10,252,31,0,252
159944,2023-07-31 16:57:07,1204996651,29661,53,156,14,5,151
159946,2023-07-31 17:00:08,1204999148,0,0,4,2,0,4
130073,2023-07-31 17:08:59,1205006273,57977,38,298,34,3,295
159949,2023-07-31 17:11:34,1205008470,288,2,236,32,1,235
159950,2023-07-31 17:14:34,1205011046,225,15,17,4,2,15
159951,2023-07-31 17:24:08,1205019684,52369,95,26,16,8,18
159952,2023-07-31 17:27:34,1205023040,20436,10,63,29,3,60
159960,2023-07-31 17:29:35,1205025151,55102,90,38,22,6,32
159964,2023-07-31 17:32:21,1205028072,19190,89,64,44,5,59
125456,2023-07-31 17:43:18,1205039035,6685,210,29,15,5,24
125234,2023-07-31 17:43:47,1205039558,70963,26,19,13,4,15
125231,2023-07-31 17:44:18,1205040079,36153,93,112,73,6,106
125229,2023-07-31 17:44:45,1205040463,4407,147,11,9,2,9
125227,2023-07-31 17:45:11,1205040917,6508,19,14,10,1,13
125092,2023-07-31 17:45:45,1205041441,41593,114,32,13,4,28
124841,2023-07-31 17:46:25,1205042130,58675,110,103,35,9,94
159965,2023-07-31 17:46:36,1205042300,95322,146,64,16,17,47
124826,2023-07-31 17:46:59,1205042676,10794,31,56,24,1,55
18392,2023-07-31 17:50:12,1205045826,0,0,45,21,0,45
159969,2023-07-31 18:00:51,1205055793,117494,159,21,11,10,11
159973,2023-07-31 18:05:28,1205060459,73901,56,51,20,5,46
159986,2023-07-31 18:18:23,1205073387,46685,155,9,5,7,2
159996,2023-07-31 18:23:32,1205078275,63261,100,43,14,10,33
159885,2023-07-31 18:28:19,1205082939,0,0,45,21,0,45
109809,2023-07-31 18:44:06,1205096455,10063,62,44,17,3,41
109801,2023-07-31 18:44:38,1205096909,18111,217,56,24,4,52
159998,2023-07-31 18:44:40,1205096951,64977,64,4,1,3,1
160001,2023-07-31 18:52:27,1205105935,42414,73,45,28,6,39
148645,2023-07-31 19:05:44,1205126672,0,47,116,106,0,116
160007,2023-07-31 19:49:05,1205191206,6143,108,12,11,2,10
147539,2023-07-31 19:50:23,1205192412,15670,113,53,31,5,48
160010,2023-07-31 20:06:07,1205206268,27045,87,45,24,3,42
160011,2023-07-31 20:11:36,1205210748,0,4,42,37,0,42
160012,2023-07-31 20:31:47,1205227401,0,3,25,20,0,25
160015,2023-07-31 20:37:28,1205231900,2171,40,88,48,1,87
160016,2023-07-31 20:41:39,1205234998,5181,5,15,9,1,14
160020,2023-07-31 20:45:12,1205237646,0,2,157,80,0,157
160021,2023-07-31 20:48:51,1205240216,66695,86,16,14,5,11
160021,2023-07-31 20:48:54,1205240253,66695,86,16,14,5,11
160022,2023-07-31 20:56:48,1205248038,66892,192,69,52,9,60
160009,2023-07-31 21:03:13,1205257045,11682,123,42,25,7,35
160008,2023-07-31 21:11:11,1205268719,56436,72,38,13,4,34
160024,2023-07-31 21:17:33,1205278072,131334,37,32,11,2,30
160043,2023-07-31 22:40:55,1205352932,0,4,17,5,0,17
160043,2023-07-31 22:40:56,1205352943,0,4,17,5,0,17
160058,2023-07-31 22:52:37,1205361531,18020,97,12,9,3,9
160023,2023-08-01 14:13:32,1205695598,75569,157,24,12,7,17
160023,2023-08-01 14:13:35,1205695629,75569,157,24,12,7,17
160097,2023-08-01 14:18:52,1205698582,160765,605,263,84,30,233
160097,2023-08-01 14:18:57,1205698610,160765,605,263,84,30,233
160107,2023-08-01 15:26:37,1205740584,81146,342,69,46,11,58
160108,2023-08-01 15:38:06,1205750307,56634,170,43,30,8,35
160115,2023-08-01 16:45:20,1205797404,2540,7,7,5,1,6
160121,2023-08-01 17:07:04,1205811356,17326,46,16,7,3,13
76387,2023-08-01 17:25:38,1205824746,57616,419,89,51,17,72
160133,2023-08-01 17:28:32,1205826965,25996,89,32,13,4,28
160142,2023-08-01 18:04:28,1205853127,2002,11,6,3,1,5
160143,2023-08-01 18:12:13,1205858944,9983,34,43,29,3,40
160148,2023-08-01 18:39:29,1205879882,52598,145,55,31,9,46
160150,2023-08-01 18:58:17,1205894097,1390,39,95,64,2,93
160161,2023-08-01 19:18:56,1205910519,156059,184,57,17,9,48
160163,2023-08-01 19:29:30,1205920486,0,188,19,17,0,19
94649,2023-08-01 19:33:03,1205923495,9259,29,10,6,2,8
94091,2023-08-01 19:33:28,1205923882,0,0,21,3,0,21
94088,2023-08-01 19:33:50,1205924231,92633,275,105,42,18,87
128881,2023-08-01 19:34:15,1205924685,0,0,3,0,0,3
149566,2023-08-01 19:34:35,1205924961,9883,100,9,7,1,8
149484,2023-08-01 19:35:00,1205925324,13389,89,29,7,2,27
149568,2023-08-01 19:35:31,1205925845,2624,17,36,5,4,32
106920,2023-08-01 19:39:33,1205929419,30013,1,33,14,1,32
106886,2023-08-01 19:39:55,1205929740,30013,8,71,41,1,70
117345,2023-08-01 19:40:17,1205930099,19209,112,8,3,2,6
129501,2023-08-01 19:40:39,1205930396,0,1,3,1,0,3
131017,2023-08-01 19:41:22,1205931011,38043,251,51,18,5,46
131141,2023-08-01 19:41:52,1205931463,10226,44,10,9,2,8
134773,2023-08-01 20:00:56,1205947276,61387,195,225,22,4,221
160169,2023-08-01 20:50:03,1205988388,800,3,10,3,1,9
160170,2023-08-01 20:56:27,1205994002,3073,15,2,0,1,1
160171,2023-08-01 20:59:54,1205996883,3159,2,1,0,1,0
160172,2023-08-01 21:56:48,1206040454,42900,13,10,2,4,6
160181,2023-08-01 22:49:01,1206078863,0,37,5,2,0,5
160190,2023-08-02 14:32:48,1206423853,102487,95,59,21,9,50
160193,2023-08-02 14:57:58,1206434889,108720,109,43,18,15,28
160196,2023-08-02 15:10:38,1206441173,80852,247,112,63,10,102
160196,2023-08-02 15:10:42,1206441209,80852,247,112,63,10,102
160198,2023-08-02 15:14:49,1206443343,0,6,3,0,0,3
160199,2023-08-02 15:18:05,1206445187,109148,160,14,9,7,7
160200,2023-08-02 15:20:48,1206446619,49628,50,30,10,3,27
160201,2023-08-02 15:21:21,1206446896,108143,262,49,35,5,44
160202,2023-08-02 15:25:30,1206449327,112943,73,24,17,4,20
160210,2023-08-02 15:45:05,1206461956,4300,22,12,9,2,10
160211,2023-08-02 15:46:20,1206462766,73773,380,166,32,29,137
160211,2023-08-02 15:46:21,1206462776,73773,380,166,32,29,137
160223,2023-08-02 15:57:14,1206470189,14378,28,17,15,1,16
160227,2023-08-02 16:00:47,1206472325,211785,191,60,26,15,45
160229,2023-08-02 16:12:08,1206479914,0,88,14,0,0,14
160230,2023-08-02 16:17:43,1206483738,10863,26,15,11,2,13
160231,2023-08-02 16:30:18,1206492632,13187,124,8,5,2,6
160232,2023-08-02 16:30:42,1206492937,7250,18,5,2,1,4
160233,2023-08-02 16:33:36,1206495025,16558,31,9,2,1,8
160233,2023-08-02 16:33:38,1206495044,16558,31,9,2,1,8
29193,2023-08-02 16:38:01,1206498215,0,4,41,22,0,41
160237,2023-08-02 16:50:17,1206513439,11153,29,11,2,2,9
160237,2023-08-02 16:50:22,1206513520,11153,29,11,2,2,9
160241,2023-08-02 17:11:31,1206541986,60001,87,34,23,2,32
160241,2023-08-02 17:11:35,1206542068,60001,87,34,23,2,32
160244,2023-08-02 17:33:31,1206573256,100674,85,60,16,4,56
160245,2023-08-02 17:34:21,1206574500,14133,134,23,12,4,19
148550,2023-08-02 17:54:32,1206597709,7940,19,63,52,2,61
148524,2023-08-02 17:55:02,1206598113,26679,61,26,19,4,22
148521,2023-08-02 17:55:21,1206598430,12885,41,24,15,2,22
149119,2023-08-02 17:55:40,1206598690,1095,7,5,1,1,4
148520,2023-08-02 17:55:57,1206598910,8460,16,27,18,2,25
148548,2023-08-02 17:56:20,1206599280,82197,115,12,4,5,7
149118,2023-08-02 17:56:37,1206599475,50450,105,23,10,7,16
160268,2023-08-02 18:53:52,1206649189,0,0,8,3,0,8
160253,2023-08-02 19:02:26,1206656903,2338,53,8,3,2,6
160264,2023-08-02 19:21:10,1206673157,0,4,41,22,0,41
160246,2023-08-02 19:21:57,1206673770,4257,101,155,58,1,154
160271,2023-08-02 19:28:35,1206679395,18428,84,39,32,5,34
160271,2023-08-02 19:28:36,1206679418,18428,84,39,32,5,34
160273,2023-08-02 19:45:33,1206693681,47724,237,31,23,6,25
130077,2023-08-02 20:22:34,1206726324,9432,21,37,22,3,34
130081,2023-08-02 20:23:21,1206727107,42776,59,63,38,7,56
130081,2023-08-02 20:23:23,1206727153,42776,59,63,38,7,56
130088,2023-08-02 20:24:44,1206728387,14571,145,62,41,5,57
130088,2023-08-02 20:24:48,1206728442,14571,145,62,41,5,57
130078,2023-08-02 20:25:28,1206729011,11975,195,54,41,5,49
130085,2023-08-02 20:25:54,1206729421,12370,36,130,81,4,126
90453,2023-08-02 20:39:30,1206741587,7498,23,10,3,3,7
90451,2023-08-02 20:40:07,1206742117,103330,174,64,42,7,57
149894,2023-08-02 20:42:22,1206744129,12995,25,29,21,2,27
150376,2023-08-02 20:43:25,1206744947,0,3,55,18,0,55
160295,2023-08-02 20:51:24,1206751730,10166,56,33,23,2,31
160305,2023-08-02 22:23:46,1206832729,0,0,22,16,0,22
160304,2023-08-02 22:24:04,1206832994,0,19,14,10,0,14
160325,2023-08-02 22:45:40,1206850645,33445,260,192,40,6,186
160328,2023-08-02 22:46:11,1206851088,8942,135,108,42,3,105
160335,2023-08-02 23:13:10,1206873022,0,25,12,3,0,12
160334,2023-08-02 23:13:24,1206873242,0,0,5,1,0,5
160340,2023-08-02 23:34:40,1206890608,10546,20,6,1,3,3
160318,2023-08-03 14:37:59,1207224148,40888,96,130,62,6,124
160362,2023-08-03 15:30:31,1207253604,226726,255,103,55,10,93
160362,2023-08-03 15:30:35,1207253652,226726,255,103,55,10,93
160369,2023-08-03 15:40:33,1207260811,113166,50,11,5,8,3
160330,2023-08-03 15:54:07,1207270510,27847,223,55,23,6,49
160336,2023-08-03 15:54:38,1207270824,344669,188,27,15,9,18
160332,2023-08-03 15:54:45,1207270880,39180,51,27,11,4,23
160337,2023-08-03 15:55:12,1207271212,64562,80,83,68,3,80
160338,2023-08-03 15:55:29,1207271443,11694,56,13,5,2,11
160375,2023-08-03 16:17:33,1207286353,170944,92,43,23,8,35
160377,2023-08-03 16:26:41,1207292862,11193,109,28,9,1,27
126019,2023-08-03 16:33:29,1207297938,473583,702,238,41,60,178
160379,2023-08-03 16:40:22,1207303063,13548,61,31,27,2,29
160381,2023-08-03 17:10:31,1207326296,17996,260,104,34,9,95
160380,2023-08-03 17:11:27,1207327111,16278,145,4,2,2,2
160382,2023-08-03 17:20:36,1207334258,13543,149,5,4,3,2
123227,2023-08-03 18:01:08,1207368207,81279,193,72,53,9,63
124950,2023-08-03 18:02:32,1207369451,85553,142,46,31,9,37
149711,2023-08-03 18:17:17,1207382235,60382,426,37,21,6,31
149712,2023-08-03 18:22:37,1207387029,19151,233,34,19,4,30
124955,2023-08-03 18:27:44,1207391378,6507,155,28,24,3,25
148356,2023-08-03 18:44:18,1207406714,73603,452,153,48,14,139
160389,2023-08-03 18:49:52,1207412403,113238,24,24,20,1,23
160392,2023-08-03 19:12:45,1207432797,0,0,7,0,0,7
160396,2023-08-03 19:25:33,1207445514,51738,395,58,42,10,48
160395,2023-08-03 19:25:55,1207445875,1709,48,13,10,1,12
160394,2023-08-03 19:26:18,1207446294,14824,118,4,2,3,1
160393,2023-08-03 19:26:40,1207446636,16942,120,7,2,1,6
150374,2023-08-03 19:49:11,1207466750,12766,102,15,12,3,12
150374,2023-08-03 19:49:15,1207466812,12766,102,15,12,3,12
125140,2023-08-03 19:57:17,1207473794,2062,46,49,40,2,47
160390,2023-08-03 20:20:26,1207492825,0,5,11,4,0,11
150428,2023-08-03 20:44:19,1207512163,13768,122,48,8,3,45
150427,2023-08-03 20:44:45,1207512548,9389,212,55,18,4,51
150440,2023-08-03 20:45:13,1207512945,0,72,31,12,0,31
150430,2023-08-03 20:45:51,1207513427,22021,175,67,21,5,62
150566,2023-08-03 20:46:19,1207513820,17973,45,33,18,3,30
150511,2023-08-03 20:46:38,1207514047,46409,64,116,30,2,114
160401,2023-08-03 20:54:22,1207520481,29972,264,70,24,16,54
160406,2023-08-03 21:48:33,1207563268,25440,44,97,17,4,93
160403,2023-08-03 21:53:48,1207567983,92530,153,37,14,7,30
160407,2023-08-03 22:00:37,1207573771,109550,195,34,22,9,25
160409,2023-08-03 22:06:22,1207578950,40137,67,55,36,6,49
160411,2023-08-03 22:22:30,1207592490,193963,306,44,28,11,33
160411,2023-08-03 22:22:36,1207592557,193963,306,44,28,11,33
160303,2023-08-03 23:30:12,1207647097,14644,161,62,28,2,60
160422,2023-08-04 14:41:34,1207985064,30654,104,85,56,7,78
160238,2023-08-04 15:31:00,1208011454,20,12,57,26,1,56
160445,2023-08-04 16:14:00,1208041061,12925,53,11,2,7,4
160445,2023-08-04 16:14:05,1208041126,12925,53,11,2,7,4
160432,2023-08-04 16:38:24,1208060127,91772,132,38,16,4,34
160448,2023-08-04 16:49:21,1208068829,17267,220,59,31,4,55
160451,2023-08-04 17:04:05,1208080960,0,0,15,12,0,15
160455,2023-08-04 17:11:02,1208086870,24881,113,27,18,3,24
160454,2023-08-04 17:11:22,1208087187,38440,101,14,7,5,9
160453,2023-08-04 17:11:43,1208087478,228,17,18,9,4,14
160452,2023-08-04 17:12:03,1208087757,10952,40,78,61,3,75
160456,2023-08-04 17:40:37,1208112555,19805,79,6,4,1,5
160458,2023-08-04 17:46:39,1208117895,206044,261,99,52,10,89
129758,2023-08-04 18:13:20,1208141344,6565,34,92,77,2,90
129755,2023-08-04 18:13:40,1208141660,19469,125,74,54,5,69
129761,2023-08-04 18:14:01,1208141976,15967,170,35,31,4,31
129760,2023-08-04 18:14:20,1208142285,3591,2,5,3,1,4
129763,2023-08-04 18:14:44,1208142705,5063,2,4,2,1,3
150621,2023-08-04 18:15:05,1208142975,24575,43,18,4,5,13
160463,2023-08-04 18:36:59,1208166330,3600,24,19,10,1,18
135940,2023-08-04 18:48:50,1208177334,0,5,8,6,0,8
160470,2023-08-04 19:17:00,1208203255,1235,19,22,19,1,21
160302,2023-08-04 19:55:02,1208237475,52514,69,29,23,3,26
160285,2023-08-04 20:04:04,1208245468,6961,73,29,26,2,27
160272,2023-08-04 20:12:01,1208252432,20325,150,25,18,3,22
160269,2023-08-04 20:17:23,1208257132,1632,8,14,10,1,13
160415,2023-08-04 21:08:46,1208301046,70932,155,49,36,10,39
130033,2023-08-04 21:42:27,1208329186,18683,95,56,29,4,52
130030,2023-08-04 21:42:59,1208329620,25638,118,27,16,7,20
160413,2023-08-04 21:51:20,1208336654,29031,106,16,6,4,12
160496,2023-08-04 21:58:15,1208342438,31572,4,5,3,2,3
160412,2023-08-04 22:49:56,1208383508,4597,32,12,9,1,11
160410,2023-08-04 22:51:08,1208384482,77926,181,28,6,8,20
160400,2023-08-04 23:04:47,1208395069,121680,16,29,23,2,27
160501,2023-08-04 23:51:56,1208430505,56187,110,31,18,5,26
160512,2023-08-05 16:52:18,1208853824,24593,28,4,1,2,2
160513,2023-08-05 16:52:26,1208853917,22210,57,11,7,3,8
160516,2023-08-05 16:52:33,1208853973,41002,298,44,15,18,26
160450,2023-08-05 17:50:34,1208891488,10696,5,4,2,2,2
160465,2023-08-05 18:07:10,1208902540,1481,16,2,1,2,0
71670,2023-08-05 18:08:06,1208903139,0,46,43,6,0,43
160316,2023-08-05 18:20:52,1208911743,1235,20,8,4,1,7
160308,2023-08-05 18:21:10,1208911979,4835,17,14,9,2,12
160527,2023-08-05 18:37:32,1208923113,27267,146,65,37,3,62
160526,2023-08-05 18:37:53,1208923410,25048,20,39,28,2,37
160525,2023-08-05 18:40:31,1208925008,20797,86,67,37,4,63
160528,2023-08-05 18:40:37,1208925085,0,138,19,10,0,19
113818,2023-08-05 19:19:21,1208948304,80080,139,15,6,4,11
114621,2023-08-05 19:20:09,1208948827,126618,142,31,11,8,23
114622,2023-08-05 19:20:21,1208948949,56998,294,48,20,14,34
123076,2023-08-05 19:20:50,1208949204,27836,38,75,40,2,73
123395,2023-08-05 19:27:12,1208952956,16859,32,77,48,2,75
160469,2023-08-07 14:31:16,1209655914,0,0,1,0,0,1
123320,2023-08-07 15:03:40,1209668859,31704,69,32,21,5,27
160543,2023-08-07 15:19:58,1209678003,27018,146,33,18,5,28
160543,2023-08-07 15:20:00,1209678023,27018,146,33,18,5,28
160543,2023-08-07 15:20:01,1209678030,27018,146,33,18,5,28
160544,2023-08-07 15:37:36,1209689332,27837,153,23,17,6,17
160547,2023-08-07 15:56:29,1209702007,14187,26,32,24,4,28
114623,2023-08-07 15:57:38,1209702757,0,4,13,7,0,13
130866,2023-08-07 16:57:39,1209749572,16643,38,20,13,2,18
130869,2023-08-07 17:11:23,1209760812,28403,30,69,64,2,67
150323,2023-08-07 17:43:17,1209788547,192034,102,86,57,10,76
150322,2023-08-07 17:45:48,1209790769,20665,193,35,10,6,29
150324,2023-08-07 17:46:07,1209791099,3280,278,43,4,7,36
123226,2023-08-07 17:46:16,1209791240,8634,48,15,12,3,12
150330,2023-08-07 17:46:28,1209791391,7387,28,52,29,2,50
150328,2023-08-07 17:46:45,1209791638,190477,103,34,24,5,29
150326,2023-08-07 17:47:07,1209791973,20691,29,21,13,4,17
160562,2023-08-07 17:51:05,1209795620,7370,52,90,41,1,89
160562,2023-08-07 17:51:07,1209795672,7370,52,90,41,1,89
160563,2023-08-07 18:00:56,1209804522,4900,19,14,7,1,13
158798,2023-08-07 18:53:32,1209853432,835,35,7,1,1,6
160570,2023-08-07 20:22:49,1209937059,7979,163,59,46,4,55
160573,2023-08-07 20:47:50,1209959995,222777,78,77,70,9,68
160577,2023-08-07 21:30:39,1209997651,23596,151,54,26,7,47
160583,2023-08-07 21:42:29,1210010589,11314,43,29,16,3,26
160581,2023-08-07 21:42:52,1210011078,2434,12,54,44,3,51
160579,2023-08-07 21:43:12,1210011407,273159,138,66,30,7,59
160582,2023-08-07 21:43:36,1210011793,0,2,9,3,0,9
135757,2023-08-08 15:01:34,1210428704,12006,41,25,22,2,23
150118,2023-08-08 15:02:09,1210428995,15893,119,19,9,3,16
149781,2023-08-08 15:12:22,1210433955,6219,16,22,15,3,19
149781,2023-08-08 15:12:28,1210434002,6219,16,22,15,3,19
149778,2023-08-08 15:12:50,1210434155,1960,23,26,20,1,25
137455,2023-08-08 15:13:24,1210434443,2371,13,7,5,1,6
160613,2023-08-08 15:46:21,1210454322,59818,163,72,45,7,65
160613,2023-08-08 15:46:26,1210454363,59818,163,72,45,7,65
160615,2023-08-08 15:59:37,1210463288,59677,164,44,29,5,39
160668,2023-08-08 22:12:51,1210790457,5700,12,57,32,3,54
160673,2023-08-08 22:16:38,1210793814,38442,39,65,54,3,62
160683,2023-08-08 22:21:58,1210798584,2039,12,3,1,1,2
160687,2023-08-09 00:02:39,1210874676,522,28,22,19,1,21
160695,2023-08-09 00:50:07,1210906143,113841,192,49,22,9,40
160694,2023-08-09 00:51:41,1210907309,86060,130,37,19,5,32
160693,2023-08-09 00:51:56,1210907451,5799,31,8,3,2,6
160691,2023-08-09 00:52:16,1210907696,77864,92,25,15,5,20
160691,2023-08-09 00:52:18,1210907724,77864,92,25,15,5,20
160686,2023-08-09 00:52:41,1210907986,104983,132,15,5,7,8
160696,2023-08-09 00:53:17,1210908390,65650,164,74,22,10,64
160715,2023-08-09 15:09:06,1211187664,10197,42,2,2,1,1
160715,2023-08-09 15:09:07,1211187676,10197,42,2,2,1,1
160716,2023-08-09 15:17:06,1211191397,747,13,8,3,2,6
160717,2023-08-09 15:26:12,1211195830,9444,13,4,1,1,3
160718,2023-08-09 15:34:47,1211200408,112834,143,42,20,9,33
120431,2023-08-09 15:41:36,1211204247,13954,65,29,21,3,26
120431,2023-08-09 15:41:40,1211204288,13954,65,29,21,3,26
160719,2023-08-09 15:43:52,1211205519,23755,137,67,53,5,62
160719,2023-08-09 15:43:56,1211205576,14722,117,66,53,4,62
120497,2023-08-09 15:44:13,1211205782,6601,27,13,8,3,10
120435,2023-08-09 15:45:11,1211206346,3592,18,26,11,2,24
120674,2023-08-09 15:49:01,1211208633,5188,19,7,2,1,6
120668,2023-08-09 15:51:48,1211210388,4321,34,47,33,2,45
160728,2023-08-09 15:52:16,1211210714,37390,29,56,33,2,54
160731,2023-08-09 15:52:23,1211210795,106414,140,53,42,6,47
120507,2023-08-09 15:57:32,1211213933,22655,165,13,9,6,7
142574,2023-08-09 16:00:27,1211215751,35175,75,83,41,3,80
142678,2023-08-09 16:00:54,1211216056,15287,18,36,27,2,34
149886,2023-08-09 16:01:26,1211216424,5355,226,49,16,9,40
142676,2023-08-09 16:01:54,1211216715,21456,164,33,20,6,27
141399,2023-08-09 16:03:56,1211217937,19402,59,12,5,5,7
160732,2023-08-09 16:05:59,1211219271,2906,36,44,36,1,43
160733,2023-08-09 16:06:07,1211219380,0,0,43,37,0,43
160734,2023-08-09 16:06:15,1211219479,0,24,1,1,0,1
160735,2023-08-09 16:06:22,1211219540,0,10,36,33,0,36
160737,2023-08-09 16:15:36,1211225550,192728,261,75,39,11,64
160741,2023-08-09 16:29:58,1211235361,24694,96,27,11,3,24
160739,2023-08-09 16:36:44,1211240192,168152,324,25,21,10,15
160743,2023-08-09 16:41:26,1211243553,2683,53,27,13,2,25
160743,2023-08-09 16:41:28,1211243593,2683,53,27,13,2,25
160743,2023-08-09 16:41:30,1211243628,2683,53,27,13,2,25
160745,2023-08-09 17:09:54,1211264451,7897,55,25,21,2,23
160747,2023-08-09 17:51:58,1211299142,7277,51,16,4,2,14
160747,2023-08-09 17:52:00,1211299184,7277,51,16,4,2,14
160749,2023-08-09 17:52:11,1211299345,53001,180,42,27,7,35
160749,2023-08-09 17:52:12,1211299370,53001,180,42,27,7,35
160750,2023-08-09 17:59:01,1211305494,0,0,4,3,0,4
160751,2023-08-09 18:12:00,1211318163,13158,67,27,14,1,26
160730,2023-08-09 18:16:50,1211322786,43191,90,21,14,7,14
160752,2023-08-09 18:20:33,1211326291,0,1,4,1,0,4
160753,2023-08-09 18:38:37,1211343069,0,4,50,34,0,50
160756,2023-08-09 19:01:42,1211363633,0,0,11,2,0,11
160757,2023-08-09 19:04:00,1211365736,107080,74,10,6,4,6
160758,2023-08-09 19:16:39,1211377765,0,3,23,15,0,23
160761,2023-08-09 19:28:54,1211388867,0,0,18,5,0,18
160755,2023-08-09 19:41:29,1211399797,5997,106,27,10,1,26
160774,2023-08-09 19:56:10,1211412926,2564,12,26,19,1,25
160775,2023-08-09 20:01:32,1211417628,0,23,68,45,0,68
160782,2023-08-09 20:08:45,1211423628,44201,124,58,26,7,51
160788,2023-08-09 21:19:50,1211481391,78631,241,62,37,9,53
160788,2023-08-09 21:19:53,1211481437,78631,241,62,37,9,53
160788,2023-08-09 21:19:54,1211481440,78631,241,62,37,9,53
160792,2023-08-09 21:51:49,1211506655,82144,200,58,23,5,53
160792,2023-08-09 21:51:53,1211506702,82144,200,58,23,5,53
160793,2023-08-09 22:04:42,1211516144,0,17,21,9,0,21
160804,2023-08-09 22:44:43,1211545955,15268,35,82,25,2,80
160805,2023-08-09 22:51:18,1211550813,0,0,2,0,0,2
160806,2023-08-09 23:06:52,1211562125,1432,14,10,7,1,9
160813,2023-08-10 14:24:14,1211795508,0,0,36,19,0,36
160814,2023-08-10 14:27:35,1211796467,48068,47,56,43,2,54
143039,2023-08-10 14:45:30,1211802466,2275,29,7,2,2,5
160827,2023-08-10 15:24:02,1211819384,15363,24,31,26,1,30
160829,2023-08-10 15:29:56,1211822593,45149,110,33,29,2,31
160875,2023-08-10 17:48:13,1211922502,83525,185,22,12,5,17
135469,2023-08-10 17:51:02,1211924727,81022,151,749,67,4,745
151133,2023-08-10 17:54:31,1211927490,13143,114,63,22,6,57
160884,2023-08-10 18:05:11,1211936412,64649,233,51,27,9,42
160884,2023-08-10 18:05:17,1211936496,64649,233,51,27,9,42
105234,2023-08-10 18:54:34,1211978209,13560,59,66,34,4,62
116844,2023-08-10 18:54:57,1211978533,42976,56,66,46,3,63
116128,2023-08-10 18:55:30,1211979051,15136,83,53,32,2,51
116128,2023-08-10 18:55:37,1211979155,15136,83,53,32,2,51
150698,2023-08-10 18:57:24,1211980646,12136,44,92,60,4,88
143344,2023-08-10 19:18:45,1211998975,0,9,47,28,0,47
160892,2023-08-10 19:42:12,1212018428,25168,118,267,21,1,266
160899,2023-08-10 19:49:49,1212024279,63081,116,80,57,5,75
160900,2023-08-10 20:13:30,1212043000,78931,208,37,19,9,28
93493,2023-08-10 20:32:39,1212059707,66203,94,76,47,6,70
93494,2023-08-10 20:40:40,1212066339,57006,70,107,53,3,104
93485,2023-08-10 20:47:34,1212072179,53748,48,78,38,4,74
93481,2023-08-10 20:51:15,1212075251,29156,31,54,27,3,51
93486,2023-08-10 21:09:44,1212089453,505869,199,102,63,10,92
160824,2023-08-10 21:12:24,1212091442,50519,155,8,5,4,4
160903,2023-08-10 21:13:32,1212092263,29238,40,58,23,4,54
160904,2023-08-10 21:13:50,1212092466,34952,80,51,18,7,44
160905,2023-08-10 21:31:11,1212105243,118683,107,34,31,5,29
160905,2023-08-10 21:31:14,1212105278,118683,107,34,31,5,29
160905,2023-08-10 21:31:21,1212105362,118683,107,34,31,5,29
160905,2023-08-10 21:31:25,1212105403,118683,107,34,31,5,29
160909,2023-08-10 21:42:06,1212113505,1235,32,50,37,1,49
160908,2023-08-10 22:21:50,1212142613,24974,64,80,40,4,76
160908,2023-08-10 22:21:53,1212142639,24974,64,80,40,4,76
160908,2023-08-10 22:21:55,1212142658,24974,64,80,40,4,76
160908,2023-08-10 22:21:57,1212142681,24974,64,80,40,4,76
160910,2023-08-10 22:22:45,1212143256,0,7,34,11,0,34
160910,2023-08-10 22:22:47,1212143287,0,7,34,11,0,34
160910,2023-08-10 22:22:49,1212143313,0,7,34,11,0,34
160911,2023-08-10 22:23:28,1212143730,26104,120,93,67,4,89
160911,2023-08-10 22:23:32,1212143766,26104,120,93,67,4,89
160911,2023-08-10 22:23:35,1212143799,26104,120,93,67,4,89
160913,2023-08-10 22:24:03,1212144182,21570,68,16,14,4,12
160916,2023-08-10 22:25:51,1212145287,60363,69,97,61,4,93
160916,2023-08-10 22:25:54,1212145305,60363,69,97,61,4,93
160917,2023-08-10 22:26:58,1212146049,3981,78,44,38,2,42
160917,2023-08-10 22:26:59,1212146063,3981,78,44,38,2,42
160917,2023-08-10 22:27:01,1212146091,3981,78,44,38,2,42
160917,2023-08-10 22:27:04,1212146126,3981,78,44,38,2,42
160922,2023-08-10 22:27:49,1212146700,10846,12,40,29,1,39
150532,2023-08-10 22:51:17,1212162570,25171,40,66,42,2,64
131142,2023-08-10 22:51:43,1212162838,30893,81,73,22,6,67
131484,2023-08-10 22:52:39,1212163507,30061,74,50,35,5,45
141473,2023-08-10 22:53:03,1212163746,35706,218,44,23,5,39
131485,2023-08-10 22:53:50,1212164284,92856,234,92,28,10,82
160935,2023-08-10 23:01:10,1212169280,3374,6,3,1,1,2
160934,2023-08-10 23:18:48,1212182037,16215,82,21,11,7,14
160933,2023-08-10 23:19:04,1212182217,61338,74,32,21,3,29
160932,2023-08-10 23:19:26,1212182483,0,22,23,20,0,23
160936,2023-08-10 23:58:42,1212209891,9452,26,31,21,1,30
160938,2023-08-11 00:12:43,1212218445,3898,40,33,25,2,31
160939,2023-08-11 00:24:36,1212225200,0,1,6,1,0,6
160941,2023-08-11 00:33:17,1212230270,27850,86,120,82,4,116
160942,2023-08-11 00:46:03,1212237440,15041,31,10,7,2,8
160943,2023-08-11 00:46:27,1212237674,28856,174,56,19,8,48
129839,2023-08-11 01:20:39,1212254976,2689,37,36,21,2,34
129836,2023-08-11 01:21:24,1212255330,37386,184,89,25,7,82
129840,2023-08-11 01:22:20,1212255761,40309,175,27,24,4,23
129841,2023-08-11 01:25:21,1212257181,45854,73,73,31,3,70
160950,2023-08-11 14:53:47,1212436328,15620,69,42,20,1,41
160953,2023-08-11 15:18:18,1212446947,2435,3,20,16,1,19
160947,2023-08-11 15:34:31,1212455812,93949,269,37,17,9,28
160963,2023-08-11 15:44:26,1212461656,10531,84,13,8,3,10
160964,2023-08-11 15:46:56,1212463198,13986,27,5,2,3,2
160965,2023-08-11 15:49:55,1212464946,18797,63,9,5,4,5
112988,2023-08-11 15:53:06,1212466758,8850,105,54,14,2,52
99151,2023-08-11 15:53:51,1212467185,75226,140,40,20,7,33
150331,2023-08-11 15:54:17,1212467481,985,193,53,18,3,50
149906,2023-08-11 15:54:48,1212467751,141608,302,122,57,7,115
149869,2023-08-11 15:55:09,1212467946,48311,106,73,33,4,69
160967,2023-08-11 16:17:26,1212481839,2030,34,29,20,1,28
151308,2023-08-11 16:20:30,1212484020,70201,57,64,27,5,59
151309,2023-08-11 16:20:49,1212484172,94228,58,50,38,8,42
151551,2023-08-11 16:21:09,1212484394,21232,79,42,29,6,36
151554,2023-08-11 16:21:22,1212484560,8183,11,20,17,2,18
151797,2023-08-11 16:21:37,1212484722,56894,53,41,32,7,34
160969,2023-08-11 17:01:15,1212513239,2401,92,2,1,1,1
160971,2023-08-11 17:01:36,1212513555,8324,72,15,3,2,13
160972,2023-08-11 17:01:54,1212513787,34438,84,95,38,7,88
160973,2023-08-11 17:02:13,1212514050,63169,234,126,91,13,113
160973,2023-08-11 17:02:18,1212514100,63169,234,126,91,13,113
160974,2023-08-11 17:10:24,1212520076,51055,96,44,11,4,40
129835,2023-08-11 17:10:37,1212520242,70297,348,67,41,5,62
129838,2023-08-11 17:16:33,1212524729,0,0,19,15,0,19
160976,2023-08-11 17:28:34,1212534024,47180,61,35,19,7,28
160984,2023-08-11 17:41:37,1212544523,211524,290,108,62,11,97
160986,2023-08-11 17:44:24,1212546754,19612,26,10,5,4,6
160977,2023-08-11 17:44:48,1212547109,35891,37,5,3,2,3
160987,2023-08-11 18:01:19,1212560595,61640,140,122,71,9,113
160987,2023-08-11 18:01:26,1212560677,61640,140,122,71,9,113
160988,2023-08-11 18:07:52,1212566218,0,3,20,14,0,20
160988,2023-08-11 18:07:53,1212566246,0,3,20,14,0,20
160988,2023-08-11 18:07:54,1212566254,0,3,20,14,0,20
149962,2023-08-11 18:15:07,1212572232,161567,32,13,4,3,10
149965,2023-08-11 18:15:33,1212572581,241725,24,7,2,1,6
149964,2023-08-11 18:15:47,1212572770,12908,42,15,0,7,8
149963,2023-08-11 18:16:08,1212573064,26160,7,11,8,1,10
149959,2023-08-11 18:16:26,1212573322,13588,48,4,0,2,2
149958,2023-08-11 18:16:44,1212573512,1461,2,436,21,1,435
149960,2023-08-11 18:17:02,1212573813,0,9,5,2,0,5
150102,2023-08-11 18:43:52,1212603056,50798,123,124,79,4,120
150250,2023-08-11 18:44:43,1212604723,25400,42,20,13,2,18
160993,2023-08-11 18:45:12,1212605647,74752,114,58,29,3,55
150106,2023-08-11 18:45:17,1212605788,140727,247,144,78,9,135
160992,2023-08-11 18:45:28,1212606227,7600,7,1,0,1,0
150098,2023-08-11 18:45:45,1212606741,6837,65,14,10,1,13
160991,2023-08-11 18:46:28,1212608112,311,66,13,2,1,12
160994,2023-08-11 19:00:46,1212635628,336,39,18,13,1,17
97558,2023-08-11 19:03:38,1212641137,5879,28,45,30,3,42
97557,2023-08-11 19:29:20,1212689837,6729,10,48,30,1,47
160997,2023-08-11 20:05:28,1212757429,26718,44,25,16,5,20
160997,2023-08-11 20:05:37,1212757702,26718,44,25,16,5,20
160999,2023-08-11 20:09:59,1212765826,852583,451,99,30,18,81
161000,2023-08-11 20:19:03,1212782902,0,1,26,24,0,26
149907,2023-08-11 20:27:22,1212798100,20051,150,85,52,3,82
149907,2023-08-11 20:27:24,1212798165,20051,150,85,52,3,82
149907,2023-08-11 20:27:27,1212798263,20051,150,85,52,3,82
149860,2023-08-11 20:27:59,1212799242,0,2,24,4,0,24
150045,2023-08-11 20:28:34,1212800386,53904,146,15,13,7,8
150045,2023-08-11 20:28:37,1212800476,53904,146,15,13,7,8
161001,2023-08-11 20:29:11,1212801553,2723,244,52,19,3,49
149898,2023-08-11 20:29:11,1212801558,6255,7,9,5,2,7
149898,2023-08-11 20:29:13,1212801644,6255,7,9,5,2,7
150049,2023-08-11 20:30:08,1212803297,0,56,39,24,0,39
149864,2023-08-11 20:31:30,1212805866,0,93,50,38,0,50
149949,2023-08-11 20:32:18,1212807363,11517,26,33,15,1,32
161009,2023-08-11 21:36:11,1212926585,75387,46,48,14,8,40
161015,2023-08-11 22:15:56,1213001375,0,0,8,5,0,8
161010,2023-08-11 22:20:56,1213010826,87663,123,10,5,4,6
161023,2023-08-11 22:47:29,1213059111,44684,59,38,30,4,34
161024,2023-08-11 22:53:32,1213069746,46591,25,59,25,3,56
161025,2023-08-11 22:57:45,1213077459,416,2,28,22,1,27
161026,2023-08-11 23:04:21,1213088419,17200,72,13,6,5,8
161027,2023-08-11 23:07:42,1213092508,43458,113,36,29,3,33
161028,2023-08-11 23:11:00,1213097018,17795,30,54,45,2,52
161029,2023-08-11 23:15:39,1213103829,73655,160,39,23,6,33
161042,2023-08-12 15:29:36,1213389982,5334,9,73,36,1,72
161045,2023-08-12 16:10:50,1213406879,33408,78,49,37,7,42
161046,2023-08-12 16:14:16,1213408589,64534,78,24,4,4,20
151214,2023-08-12 16:19:23,1213411003,46843,25,54,7,2,52
161044,2023-08-12 16:19:35,1213411085,53956,80,25,18,4,21
161047,2023-08-12 16:20:27,1213411532,80027,244,23,18,8,15
151224,2023-08-12 16:23:54,1213413125,17369,131,23,13,4,19
161016,2023-08-12 16:27:15,1213414827,0,5,7,4,0,7
161048,2023-08-12 17:13:44,1213438720,25149,182,71,19,6,65
161048,2023-08-12 17:13:45,1213438726,25149,182,71,19,6,65
161051,2023-08-12 17:20:56,1213442472,36914,70,119,67,4,115
161050,2023-08-12 17:21:16,1213442657,220040,227,220,115,3,217
161049,2023-08-12 17:21:37,1213442857,2153,97,149,90,1,148
129834,2023-08-12 17:54:58,1213461468,41316,38,51,37,2,49
161059,2023-08-12 18:25:20,1213478946,183106,221,120,52,12,108
161060,2023-08-12 18:36:57,1213485601,143146,48,25,14,2,23
161061,2023-08-12 18:42:44,1213489090,82195,323,64,43,8,56
97678,2023-08-12 18:53:55,1213495840,4436,42,122,97,4,118
161078,2023-08-14 15:14:16,1214227380,44644,147,4,3,3,1
161080,2023-08-14 15:51:16,1214248647,19135,191,173,91,4,169
161081,2023-08-14 16:07:05,1214259021,23809,44,60,23,6,54
125981,2023-08-14 16:13:25,1214263117,14431,35,38,13,6,32
122047,2023-08-14 16:17:35,1214265944,75502,199,30,24,5,25
111835,2023-08-14 16:17:47,1214266084,59523,63,97,53,3,94
126598,2023-08-14 16:33:03,1214276348,38105,120,117,6,6,111
161083,2023-08-14 16:35:32,1214278052,21572,228,37,22,9,28
161086,2023-08-14 16:55:54,1214292851,16000,47,21,15,2,19
161087,2023-08-14 17:07:04,1214301173,0,0,3,2,0,3
161089,2023-08-14 17:07:19,1214301378,102254,329,37,26,13,24
161088,2023-08-14 17:07:24,1214301457,17762,16,3,3,1,2
161091,2023-08-14 17:14:09,1214306450,15107,72,7,4,1,6
161090,2023-08-14 17:14:38,1214306835,36839,253,30,9,8,22
161092,2023-08-14 17:26:14,1214316328,4513,14,6,3,3,3
161092,2023-08-14 17:26:20,1214316417,4513,14,6,3,3,3
161102,2023-08-14 17:35:04,1214323725,0,2,40,22,0,40
161104,2023-08-14 17:41:11,1214328928,49996,272,40,17,10,30
161107,2023-08-14 17:51:44,1214337549,19734,20,23,11,1,22
161108,2023-08-14 17:57:30,1214342393,3481,2,7,1,1,6
161108,2023-08-14 17:57:33,1214342426,3481,2,7,1,1,6
161105,2023-08-14 18:13:23,1214354877,0,1,2,1,0,2
161113,2023-08-14 18:31:37,1214369819,15025,9,14,4,1,13
161113,2023-08-14 18:31:42,1214369899,15025,9,14,4,1,13
161113,2023-08-14 18:31:45,1214369946,15025,9,14,4,1,13
161117,2023-08-14 18:50:07,1214387628,27879,16,21,12,2,19
161115,2023-08-14 18:59:00,1214396824,0,33,33,14,0,33
161111,2023-08-14 19:02:38,1214400639,116439,137,67,30,7,60
161122,2023-08-14 19:12:10,1214410096,14642,28,15,5,2,13
161130,2023-08-14 19:51:15,1214445449,25620,64,32,8,3,29
161130,2023-08-14 19:51:21,1214445529,25620,64,32,8,3,29
161135,2023-08-14 20:04:13,1214457055,12759,27,3,3,2,1
161135,2023-08-14 20:04:18,1214457151,12759,27,3,3,2,1
161144,2023-08-14 20:59:04,1214503273,20479,24,15,10,1,14
161144,2023-08-14 20:59:11,1214503402,20479,24,15,10,1,14
161145,2023-08-14 21:16:40,1214517638,0,1,1,0,0,1
161145,2023-08-14 21:16:44,1214517696,0,1,1,0,0,1
118742,2023-08-14 22:42:07,1214582795,0,0,54,39,0,54
118606,2023-08-14 22:42:44,1214583162,0,7,64,28,0,64
130217,2023-08-14 22:43:13,1214583487,21979,348,14,4,3,11
150578,2023-08-14 22:43:36,1214583707,15693,110,52,34,1,51
150463,2023-08-14 22:44:04,1214583997,55738,10,42,33,2,40
161175,2023-08-14 22:45:13,1214584616,159997,47,81,50,2,79
161179,2023-08-14 23:00:32,1214595668,94266,176,80,36,10,70
161178,2023-08-14 23:00:43,1214595816,67542,105,56,30,7,49
161188,2023-08-14 23:14:32,1214607213,19321,53,20,15,2,18
161191,2023-08-15 00:05:19,1214644456,385637,93,62,35,6,56
161192,2023-08-15 00:05:48,1214644743,381264,103,41,19,9,32
161193,2023-08-15 00:06:22,1214645109,10226,25,4,1,1,3
161195,2023-08-15 00:06:57,1214645470,399770,138,27,16,7,20
161196,2023-08-15 00:09:10,1214647037,387489,64,77,15,5,72
161197,2023-08-15 00:09:36,1214647334,3076,34,15,5,5,10
161198,2023-08-15 00:10:49,1214648174,9250,25,3,1,1,2
161199,2023-08-15 00:11:10,1214648481,76372,225,69,9,11,58
161200,2023-08-15 00:11:48,1214648935,428517,88,31,22,6,25
161201,2023-08-15 00:12:10,1214649167,380778,131,58,39,7,51
161207,2023-08-15 02:25:27,1214722391,26613,47,12,3,3,9
161208,2023-08-15 02:39:17,1214727794,48177,116,13,3,10,3
161208,2023-08-15 02:39:21,1214727818,48177,116,13,3,10,3
161202,2023-08-15 14:35:24,1214867473,9146,210,45,17,6,39
161213,2023-08-15 15:09:58,1214883281,7757,263,32,23,2,30
161223,2023-08-15 15:46:10,1214905400,16666,22,6,4,3,3
161224,2023-08-15 15:46:21,1214905526,16088,62,62,53,3,59
161228,2023-08-15 15:46:28,1214905617,4527,13,71,64,1,70
161228,2023-08-15 15:46:33,1214905684,4527,13,71,64,1,70
161225,2023-08-15 15:49:02,1214907390,19536,68,43,25,4,39
161227,2023-08-15 15:49:14,1214907532,2352,15,10,4,1,9
130170,2023-08-15 15:51:14,1214908742,24313,50,42,31,3,39
125990,2023-08-15 15:57:03,1214912704,28490,188,116,36,4,112
161226,2023-08-15 16:02:50,1214916646,75104,42,87,24,3,84
126124,2023-08-15 16:07:55,1214920162,82291,80,13,5,8,5
161232,2023-08-15 16:20:43,1214929136,0,23,50,31,0,50
161222,2023-08-15 16:23:02,1214930775,21124,23,47,18,5,42
161235,2023-08-15 16:26:07,1214932999,3779,8,4,2,1,3
161235,2023-08-15 16:26:08,1214933031,3779,8,4,2,1,3
141845,2023-08-15 16:26:55,1214933565,6380,7,29,19,1,28
141850,2023-08-15 16:27:23,1214933924,0,0,6,2,0,6
141871,2023-08-15 16:28:09,1214934556,43026,119,43,28,7,36
142543,2023-08-15 16:29:07,1214935284,10962,290,56,38,4,52
143034,2023-08-15 16:29:37,1214935638,11154,63,14,11,1,13
140592,2023-08-15 16:39:17,1214942854,149,4,19,15,1,18
161238,2023-08-15 16:47:15,1214948993,0,2,6,2,0,6
161239,2023-08-15 16:53:04,1214953383,240,5,17,12,1,16
161234,2023-08-15 16:55:04,1214954978,69266,57,22,17,7,15
161246,2023-08-15 16:55:12,1214955091,28645,34,48,37,5,43
161247,2023-08-15 16:57:34,1214957035,10467,147,67,40,4,63
161248,2023-08-15 17:20:11,1214976176,19745,52,46,17,3,43
161249,2023-08-15 17:50:33,1215001499,0,0,7,4,0,7
161252,2023-08-15 17:53:19,1215003771,75982,178,14,9,10,4
161253,2023-08-15 17:53:25,1215003832,54182,105,26,19,4,22
129845,2023-08-15 17:55:46,1215005737,15059,50,42,24,5,37
149935,2023-08-15 17:56:07,1215006074,0,0,2,0,0,2
130115,2023-08-15 17:56:19,1215006215,19751,39,140,74,3,137
129849,2023-08-15 17:56:29,1215006374,0,70,18,3,0,18
130165,2023-08-15 17:56:40,1215006458,4669,4,21,16,1,20
129850,2023-08-15 17:57:09,1215006859,38129,172,59,37,5,54
149973,2023-08-15 17:57:45,1215007370,0,0,6,5,0,6
161256,2023-08-15 18:07:23,1215015117,20334,67,21,11,4,17
161251,2023-08-15 18:18:54,1215024911,221347,284,70,26,14,56
161266,2023-08-15 18:42:56,1215045914,0,0,29,20,0,29
161269,2023-08-15 18:49:35,1215051855,60168,81,43,21,9,34
150370,2023-08-15 18:51:12,1215053200,1884,128,37,20,2,35
149854,2023-08-15 18:58:59,1215060104,178865,145,87,36,12,75
149759,2023-08-15 18:59:32,1215060644,2761,69,28,10,6,22
149842,2023-08-15 19:00:04,1215061139,21799,38,39,23,1,38
149839,2023-08-15 19:01:02,1215062025,9239,19,47,29,1,46
149855,2023-08-15 19:01:35,1215062530,37358,137,45,29,1,44
161270,2023-08-15 19:07:18,1215067407,18105,108,60,38,2,58
161283,2023-08-15 20:08:38,1215119870,19269,21,3,3,2,1
161285,2023-08-15 20:14:00,1215124258,30110,31,19,10,2,17
161286,2023-08-15 20:17:27,1215127115,75266,67,31,20,4,27
161286,2023-08-15 20:17:33,1215127187,75266,67,31,20,4,27
99362,2023-08-15 20:19:49,1215128989,12940,19,20,11,1,19
99361,2023-08-15 20:20:54,1215129884,7866,25,14,7,3,11
93600,2023-08-15 20:39:24,1215144971,15150,63,27,15,2,25
105564,2023-08-15 20:39:43,1215145190,37293,58,44,28,5,39
93586,2023-08-15 20:43:41,1215148291,113809,67,42,35,5,37
161296,2023-08-15 21:34:25,1215191463,11450,25,70,24,2,68
161296,2023-08-15 21:34:23,1215191477,11450,36,76,24,2,74
150468,2023-08-15 22:03:58,1215214980,6717,119,29,18,1,28
150468,2023-08-15 22:04:04,1215215064,6717,119,29,18,1,28
18377,2023-08-15 22:24:27,1215231533,34972,31,65,36,1,64
161305,2023-08-15 22:50:06,1215251840,0,1,22,20,0,22
161303,2023-08-15 22:50:24,1215252077,60190,48,21,16,3,18
161299,2023-08-15 22:50:33,1215252208,61127,108,17,14,2,15
161298,2023-08-15 22:50:46,1215252366,0,2,14,12,0,14
161297,2023-08-15 22:50:55,1215252484,157750,133,57,35,8,49
161295,2023-08-15 23:04:45,1215263089,34972,31,65,36,1,64
98847,2023-08-15 23:58:13,1215302115,40174,200,52,28,6,46
109795,2023-08-16 00:00:13,1215303580,4579,63,39,20,2,37
98815,2023-08-16 00:02:38,1215305245,4746,32,74,50,2,72
151065,2023-08-16 00:04:27,1215306519,15044,55,41,25,3,38
151065,2023-08-16 00:04:29,1215306559,15044,55,41,25,3,38
100087,2023-08-16 00:59:04,1215342969,140446,157,109,34,8,101
100087,2023-08-16 00:59:08,1215343046,144670,184,114,36,9,105
100094,2023-08-16 01:00:11,1215343675,124028,104,92,49,10,82
100546,2023-08-16 01:00:57,1215344148,104223,136,65,25,6,59
100474,2023-08-16 01:02:05,1215344780,78053,42,76,30,4,72
110572,2023-08-16 01:03:15,1215345492,60871,78,25,4,5,20
110573,2023-08-16 01:04:43,1215346245,42309,95,88,51,8,80
116673,2023-08-16 01:05:09,1215346536,14728,43,47,32,4,43
98814,2023-08-16 01:32:33,1215361619,15252,65,47,31,4,43
161338,2023-08-16 14:36:41,1215891696,6593,38,20,13,2,18
161361,2023-08-16 16:03:24,1215942561,0,17,50,36,0,50
130868,2023-08-16 16:26:42,1215959971,61855,86,122,84,8,114
130990,2023-08-16 16:27:07,1215960271,79431,119,40,21,3,37
161371,2023-08-16 17:26:54,1216009661,5361,53,29,18,3,26
161375,2023-08-16 17:49:14,1216029376,0,1,21,11,0,21
161374,2023-08-16 18:11:56,1216049671,0,0,46,34,0,46
161385,2023-08-16 18:12:06,1216049828,51354,130,26,22,4,22
161386,2023-08-16 18:12:14,1216049945,66239,379,31,17,5,26
161387,2023-08-16 18:46:43,1216080943,51555,72,125,68,12,113
161394,2023-08-16 18:51:35,1216085207,1602,8,18,10,2,16
161443,2023-08-16 19:48:09,1216142774,9551,222,86,30,3,83
161440,2023-08-16 19:48:38,1216143222,0,1,50,13,0,50
161445,2023-08-16 20:09:21,1216164871,177170,265,49,31,13,36
161449,2023-08-16 20:36:57,1216200148,8610,25,20,6,1,19
161449,2023-08-16 20:36:58,1216200159,8610,25,20,6,1,19
161449,2023-08-16 20:37:03,1216200312,8610,25,20,6,1,19
161462,2023-08-16 20:42:17,1216205873,11819,19,16,4,5,11
161453,2023-08-16 20:51:08,1216215069,5273,32,53,15,2,51
161453,2023-08-16 20:51:12,1216215206,5273,32,53,15,2,51
161450,2023-08-16 20:58:01,1216222378,36254,70,26,16,7,19
161467,2023-08-16 21:03:31,1216228242,24675,29,16,9,3,13
161473,2023-08-16 21:34:22,1216260051,34785,53,28,13,5,23
161473,2023-08-16 21:34:26,1216260110,34785,53,28,13,5,23
161484,2023-08-16 22:02:21,1216287961,288528,150,49,25,11,38
161392,2023-08-16 22:07:09,1216292745,5578,53,63,30,3,60
161487,2023-08-16 22:14:21,1216299741,125113,222,38,24,12,26
161493,2023-08-16 22:35:24,1216319695,49955,57,31,15,3,28
161504,2023-08-16 22:47:45,1216331371,27761,107,54,12,10,44
124679,2023-08-16 23:00:10,1216342572,2067,14,9,4,1,8
124716,2023-08-16 23:00:42,1216343017,47102,127,19,10,3,16
124647,2023-08-16 23:01:34,1216343813,352,15,14,9,1,13
124647,2023-08-16 23:01:41,1216343921,352,15,14,9,1,13
124647,2023-08-16 23:01:49,1216344037,352,15,14,9,1,13
124649,2023-08-16 23:02:10,1216344337,54643,245,122,26,5,117
124678,2023-08-16 23:02:47,1216344936,35912,212,73,28,10,63
161506,2023-08-16 23:09:10,1216350580,938,5,7,4,1,6
141878,2023-08-16 23:09:37,1216350968,117713,396,68,53,13,55
161519,2023-08-17 14:32:51,1216691394,110106,73,14,7,6,8
150338,2023-08-17 14:38:27,1216693691,25090,97,53,22,6,47
150770,2023-08-17 14:38:57,1216693928,4047,24,22,11,2,20
150414,2023-08-17 14:39:36,1216694148,35769,72,37,18,4,33
150267,2023-08-17 14:40:04,1216694366,3849,12,25,16,1,24
150417,2023-08-17 14:40:30,1216694537,0,4,6,0,0,6
161522,2023-08-17 14:50:42,1216698941,1095,16,12,3,2,10
161523,2023-08-17 14:57:43,1216702239,2308,8,27,26,1,26
161524,2023-08-17 14:59:06,1216702857,0,1,31,15,0,31
76453,2023-08-17 15:39:14,1216725515,0,36,59,32,0,59
130395,2023-08-17 15:40:27,1216726305,10528,44,77,56,4,73
140152,2023-08-17 15:40:40,1216726468,8945,40,7,5,1,6
130392,2023-08-17 15:40:50,1216726580,30268,42,26,13,6,20
130392,2023-08-17 15:40:55,1216726664,30268,42,26,13,6,20
130394,2023-08-17 15:41:15,1216726870,28355,107,111,70,4,107
140640,2023-08-17 15:45:52,1216729853,5938,7,7,2,1,6
150950,2023-08-17 15:45:56,1216729888,22176,130,48,43,2,46
150950,2023-08-17 15:45:59,1216729913,22176,130,48,43,2,46
131308,2023-08-17 15:47:41,1216731011,28902,48,111,81,2,109
131308,2023-08-17 15:47:44,1216731043,28902,48,111,81,2,109
131308,2023-08-17 15:47:49,1216731088,28902,48,111,81,2,109
161538,2023-08-17 15:51:45,1216733792,90122,115,56,38,8,48
161540,2023-08-17 15:52:23,1216734260,5281,89,33,25,2,31
161541,2023-08-17 15:57:49,1216738014,584007,496,34,26,16,18
161494,2023-08-17 16:04:46,1216742746,4734,48,51,25,2,49
161545,2023-08-17 16:18:52,1216753011,0,4,1,1,0,1
139963,2023-08-17 16:23:15,1216756482,15087,14,218,8,2,216
161539,2023-08-17 16:23:22,1216756600,43605,84,72,37,5,67
161539,2023-08-17 16:23:27,1216756635,43605,84,72,37,5,67
151013,2023-08-17 16:23:52,1216756933,0,22,66,16,0,66
139916,2023-08-17 16:24:22,1216757342,30527,167,82,57,4,78
119776,2023-08-17 16:41:20,1216771193,15885,98,55,8,5,50
161567,2023-08-17 17:05:21,1216790924,0,0,1,0,0,1
161577,2023-08-17 17:10:09,1216794668,9703,100,44,26,1,43
161583,2023-08-17 17:37:30,1216817594,5812,67,24,11,6,18
121117,2023-08-17 17:43:45,1216823075,1461,116,96,59,1,95
121480,2023-08-17 17:52:40,1216830906,3635,31,53,34,2,51
149082,2023-08-17 17:59:41,1216837311,1461,21,9,6,1,8
161588,2023-08-17 18:08:35,1216845367,369,2,3,1,1,2
161589,2023-08-17 18:08:48,1216845527,54593,344,51,25,16,35
161590,2023-08-17 18:10:16,1216846738,71020,50,20,13,3,17
161591,2023-08-17 18:19:29,1216855003,31820,44,33,25,3,30
161602,2023-08-17 18:37:01,1216870639,35581,62,31,16,3,28
161605,2023-08-17 18:49:12,1216881717,13141,25,11,6,2,9
161615,2023-08-17 18:49:56,1216882402,3190,52,34,2,1,33
161615,2023-08-17 18:50:01,1216882474,3190,52,34,2,1,33
161114,2023-08-17 18:58:48,1216890274,19458,63,7,6,3,4
161114,2023-08-17 18:58:49,1216890297,19458,63,7,6,3,4
161114,2023-08-17 18:58:52,1216890350,19458,63,7,6,3,4
161114,2023-08-17 18:58:54,1216890374,19458,63,7,6,3,4
161114,2023-08-17 18:58:55,1216890386,19458,63,7,6,3,4
161114,2023-08-17 18:58:57,1216890412,19458,63,7,6,3,4
161619,2023-08-17 19:03:56,1216894805,12330,42,18,15,2,16
151255,2023-08-17 19:20:52,1216909459,14960,13,3,2,1,2
161621,2023-08-17 19:30:37,1216918120,4184,71,15,5,2,13
161624,2023-08-17 19:48:30,1216933310,12653,70,87,20,3,84
161627,2023-08-17 19:57:12,1216940500,2683,30,4,0,1,3
161630,2023-08-17 20:10:02,1216951249,24141,47,25,5,7,18
161629,2023-08-17 20:26:07,1216964607,19362,57,23,23,2,21
161634,2023-08-17 20:42:43,1216978444,39352,44,38,20,8,30
161635,2023-08-17 21:02:21,1216995206,0,315,116,31,0,116
161641,2023-08-17 21:27:57,1217016582,122787,225,41,24,10,31
161651,2023-08-17 22:34:27,1217070647,0,8,11,1,0,11
161662,2023-08-17 23:16:42,1217104892,33289,295,96,47,8,88
161662,2023-08-17 23:16:46,1217104923,33289,295,96,47,8,88
161662,2023-08-17 23:16:49,1217104949,33289,295,96,47,8,88
161664,2023-08-17 23:26:34,1217111707,0,0,1,1,0,1
161666,2023-08-17 23:26:57,1217111943,0,0,4,0,0,4
161665,2023-08-17 23:32:38,1217115903,0,7,1,0,0,1
161665,2023-08-17 23:32:41,1217115930,0,7,1,0,0,1
161665,2023-08-17 23:32:43,1217115954,0,7,1,0,0,1
161668,2023-08-17 23:47:12,1217125784,20952,194,36,11,10,26
161670,2023-08-18 00:08:26,1217139392,8002,75,56,35,6,50
161670,2023-08-18 00:08:32,1217139468,8002,75,56,35,6,50
161669,2023-08-18 00:09:01,1217139768,18928,129,49,37,7,42
161671,2023-08-18 00:13:11,1217142172,8333,13,12,8,4,8
161675,2023-08-18 00:18:16,1217144902,62864,126,149,110,9,140
116271,2023-08-18 00:24:38,1217148374,28408,88,45,30,6,39
161680,2023-08-18 00:35:25,1217154272,33594,68,44,29,4,40
161697,2023-08-18 15:15:47,1217362675,47444,113,56,41,6,50
161699,2023-08-18 15:23:25,1217366955,34281,54,6,2,6,0
161701,2023-08-18 15:38:01,1217375826,0,0,16,15,0,16
161705,2023-08-18 15:47:15,1217381645,8158,5,20,14,1,19
140849,2023-08-18 15:53:27,1217386033,0,12,11,9,0,11
161706,2023-08-18 15:54:44,1217386874,80327,31,89,25,1,88
161706,2023-08-18 15:54:46,1217386898,80327,31,89,25,1,88
161700,2023-08-18 15:55:03,1217387067,24314,105,86,37,3,83
161711,2023-08-18 16:00:26,1217390830,37750,76,99,4,8,91
140843,2023-08-18 16:10:37,1217398276,0,7,30,20,0,30
161726,2023-08-18 16:55:04,1217432703,57755,129,24,18,6,18
130205,2023-08-18 17:06:23,1217441746,51372,86,36,15,6,30
161731,2023-08-18 17:31:00,1217462057,18201,91,48,28,3,45
161734,2023-08-18 18:01:22,1217488062,60331,137,16,6,5,11
161737,2023-08-18 18:07:22,1217493188,27935,72,42,21,4,38
161736,2023-08-18 18:07:42,1217493456,26245,58,10,3,2,8
161738,2023-08-18 18:10:21,1217495767,143393,84,46,30,7,39
161741,2023-08-18 18:16:25,1217501143,286867,432,32,17,15,17
109210,2023-08-18 18:19:35,1217503865,0,1,8,5,0,8
161743,2023-08-18 18:24:08,1217507891,19885,2,72,39,1,71
161744,2023-08-18 18:26:04,1217509542,66575,123,25,18,5,20
161744,2023-08-18 18:26:07,1217509592,66575,123,25,18,5,20
161747,2023-08-18 18:33:10,1217515613,0,1,5,4,0,5
161747,2023-08-18 18:33:12,1217515651,0,1,5,4,0,5
161714,2023-08-18 18:50:35,1217531325,0,35,59,32,0,59
161756,2023-08-18 19:03:14,1217542452,2173,17,23,14,2,21
161782,2023-08-18 20:30:51,1217649937,15545,72,1,1,1,0
161784,2023-08-18 20:57:58,1217669389,13982,121,33,24,3,30
161784,2023-08-18 20:58:04,1217669463,13982,121,33,24,3,30
161785,2023-08-18 21:05:13,1217674526,100888,306,51,16,10,41
161786,2023-08-18 21:08:53,1217676909,52862,46,71,32,1,70
161787,2023-08-18 21:11:33,1217678847,17216,39,16,11,3,13
161732,2023-08-18 21:33:40,1217693810,9378,19,11,5,2,9
161790,2023-08-18 21:40:36,1217698670,117419,364,41,18,9,32
161792,2023-08-18 21:48:10,1217703925,226544,194,55,14,15,40
161795,2023-08-18 21:54:58,1217708684,103386,71,60,24,6,54
161797,2023-08-18 21:57:08,1217710115,9850,44,22,14,1,21
161796,2023-08-18 21:57:17,1217710200,53719,32,10,6,3,7
161798,2023-08-18 22:01:24,1217712869,60348,143,52,27,6,46
161799,2023-08-18 22:06:07,1217715914,17826,146,80,61,5,75
161810,2023-08-18 22:18:21,1217723574,8151,43,8,6,2,6
161810,2023-08-18 22:18:23,1217723596,8151,43,8,6,2,6
161815,2023-08-18 22:39:07,1217736781,4572,22,44,25,3,41
161818,2023-08-18 22:45:41,1217741015,23479,53,46,3,1,45
161825,2023-08-18 22:55:17,1217746878,1821,11,2,1,1,1
161827,2023-08-18 23:05:10,1217752999,88769,228,36,18,6,30
131066,2023-08-18 23:10:34,1217756046,1086,93,31,19,2,29
131000,2023-08-18 23:35:56,1217770435,4276,3,2,0,1,1
161829,2023-08-18 23:51:36,1217779106,81881,188,51,24,6,45
161829,2023-08-18 23:51:42,1217779152,81881,188,51,24,6,45
161843,2023-08-19 00:27:17,1217797040,0,4,3,1,0,3
161844,2023-08-19 00:39:43,1217803104,75185,203,53,30,11,42
161842,2023-08-19 00:55:26,1217810607,116189,76,25,15,3,22
145702,2023-08-19 03:42:04,1217868443,22792,58,34,21,4,30
161846,2023-08-19 04:10:38,1217875454,13238,113,42,34,4,38
161847,2023-08-19 04:14:01,1217876269,2604,20,39,28,2,37
161848,2023-08-19 04:17:54,1217877211,17384,14,10,6,2,8
161849,2023-08-19 04:25:15,1217879056,30556,155,33,22,4,29
161850,2023-08-19 04:34:34,1217881299,43984,36,29,22,2,27
161856,2023-08-19 14:54:20,1217961124,26330,26,31,7,1,30
161841,2023-08-19 14:54:30,1217961151,24171,53,65,28,3,62
161841,2023-08-19 14:54:32,1217961165,24171,53,65,28,3,62
161860,2023-08-19 15:22:53,1217969181,10612,52,22,15,3,19
161861,2023-08-19 15:37:59,1217974075,19400,54,47,31,4,43
161862,2023-08-19 16:12:46,1217987194,7105,50,32,28,3,29
161866,2023-08-19 17:17:38,1218016803,9355,45,73,59,2,71
130159,2023-08-19 17:22:15,1218019111,0,5,37,21,0,37
161867,2023-08-19 17:31:16,1218023691,12341,79,31,9,4,27
161869,2023-08-19 17:46:39,1218031563,128899,64,19,7,4,15
161871,2023-08-19 19:16:16,1218079693,8484,16,17,10,2,15
104515,2023-08-19 20:02:59,1218104008,58240,57,48,18,2,46
114207,2023-08-19 20:09:44,1218107425,4786,23,20,13,2,18
161875,2023-08-19 20:16:57,1218111104,0,0,11,8,0,11
161876,2023-08-19 20:35:44,1218120219,13141,42,18,11,2,16
161877,2023-08-19 20:40:58,1218122774,0,0,8,4,0,8
161878,2023-08-20 03:15:37,1218269805,8669,22,13,5,1,12
161880,2023-08-21 14:10:26,1218732391,54002,42,50,29,6,44
161893,2023-08-21 15:13:32,1218753711,102302,176,42,17,7,35
136904,2023-08-21 15:26:01,1218759912,10320,20,15,5,2,13
161900,2023-08-21 16:09:48,1218785507,46575,173,19,6,7,12
161903,2023-08-21 16:32:59,1218801718,35903,12,11,7,1,10
161909,2023-08-21 16:57:56,1218820444,1024,13,14,1,2,12
161911,2023-08-21 17:21:53,1218839052,33471,81,59,39,7,52
161912,2023-08-21 17:22:06,1218839263,744,34,5,1,2,3
129484,2023-08-21 17:29:32,1218845170,21618,148,91,53,7,84
129482,2023-08-21 17:30:07,1218845730,23750,32,49,41,1,48
141222,2023-08-21 17:30:29,1218846026,17326,161,79,57,5,74
107681,2023-08-21 18:20:09,1218887733,10534,49,78,52,4,74
140992,2023-08-21 18:21:53,1218889246,10452,30,9,5,4,5
161920,2023-08-21 18:28:47,1218895422,16907,18,16,10,3,13
161951,2023-08-21 21:16:07,1219036684,51798,83,39,15,3,36
161969,2023-08-21 22:29:14,1219092348,172028,267,86,47,10,76
161987,2023-08-21 23:06:06,1219118288,0,3,4,2,0,4
126101,2023-08-21 23:15:48,1219125344,8197,207,50,22,5,45
161991,2023-08-21 23:20:15,1219128608,222301,264,75,20,3,72
161991,2023-08-21 23:20:16,1219128623,222301,264,75,20,3,72
161998,2023-08-22 14:31:03,1219391527,57619,12,11,8,2,9
161999,2023-08-22 15:01:15,1219404786,64675,119,32,16,7,25
162002,2023-08-22 15:01:43,1219405061,17957,42,55,20,3,52
130206,2023-08-22 15:03:59,1219406361,16621,50,36,8,3,33
130204,2023-08-22 15:28:54,1219419951,47792,142,33,16,7,26
86577,2023-08-22 16:01:27,1219441355,98293,141,93,63,6,87
162010,2023-08-22 16:12:55,1219449910,95240,113,42,35,4,38
162012,2023-08-22 16:20:37,1219455495,120342,98,81,53,5,76
162014,2023-08-22 16:25:28,1219459221,69124,145,44,30,6,38
162014,2023-08-22 16:25:35,1219459294,69124,145,44,30,6,38
150299,2023-08-22 16:36:57,1219468177,88832,136,60,40,3,57
162021,2023-08-22 17:01:26,1219488041,10800,42,5,4,1,4
162044,2023-08-22 18:48:45,1219580085,0,46,59,21,0,59
141071,2023-08-22 18:51:07,1219582264,31617,114,13,2,8,5
141068,2023-08-22 18:51:38,1219582635,7772,16,26,12,2,24
162048,2023-08-22 19:15:55,1219603989,113591,280,83,50,8,75
162051,2023-08-22 19:22:45,1219609788,44441,155,75,54,5,70
162052,2023-08-22 19:36:45,1219621958,35101,52,85,61,6,79
162053,2023-08-22 19:37:24,1219622569,20229,98,54,34,6,48
162071,2023-08-22 20:01:35,1219647225,9125,71,8,1,7,1
161709,2023-08-22 20:29:32,1219671580,76345,62,26,17,7,19
162089,2023-08-22 21:08:17,1219704656,17323,76,52,28,9,43
162092,2023-08-22 21:42:19,1219733566,16784,43,15,11,3,12
162101,2023-08-22 22:33:59,1219777520,80813,51,50,29,4,46
162102,2023-08-22 22:34:41,1219778099,25212,62,6,3,6,0
162103,2023-08-22 22:40:46,1219782787,27326,64,42,36,3,39
136379,2023-08-22 22:49:58,1219790276,74601,7,17,2,1,16
136379,2023-08-22 22:50:01,1219790317,74601,7,17,2,1,16
162112,2023-08-22 23:13:27,1219809649,4799,3,4,3,2,2
162113,2023-08-22 23:14:16,1219810236,11735,103,23,12,3,20
162116,2023-08-22 23:20:02,1219814813,15284,26,11,2,1,10
162104,2023-08-22 23:49:30,1219837788,0,5,43,5,0,43
162151,2023-08-23 14:46:13,1220128508,47768,67,23,10,7,16
162152,2023-08-23 14:52:53,1220131090,4066,43,61,19,3,58
162153,2023-08-23 15:10:37,1220138981,21112,135,8,7,5,3
162154,2023-08-23 15:17:09,1220142106,0,0,1,0,0,1
162155,2023-08-23 15:22:18,1220144788,148589,352,49,30,16,33
162156,2023-08-23 15:30:17,1220149232,5564,21,4,2,2,2
162156,2023-08-23 15:30:23,1220149287,5564,21,4,2,2,2
162157,2023-08-23 15:31:46,1220150006,44854,119,20,9,4,16
162158,2023-08-23 15:36:19,1220152566,179766,398,48,38,8,40
162159,2023-08-23 15:52:16,1220162194,20680,55,12,8,3,9
162159,2023-08-23 15:52:22,1220162249,20680,55,12,8,3,9
162171,2023-08-23 16:22:50,1220182534,9738,26,18,16,1,17
162172,2023-08-23 16:26:49,1220185411,68175,280,33,18,9,24
162166,2023-08-23 16:42:33,1220197088,4868,36,20,17,3,17
162166,2023-08-23 16:42:35,1220197129,4868,36,20,17,3,17
162166,2023-08-23 16:42:38,1220197159,4868,36,20,17,3,17
162182,2023-08-23 16:47:42,1220200923,57739,180,23,13,6,17
162184,2023-08-23 16:48:35,1220201624,7159,32,34,27,3,31
162185,2023-08-23 16:53:44,1220205475,55499,58,40,23,8,32
162186,2023-08-23 17:01:20,1220211458,50855,184,17,5,6,11
162189,2023-08-23 17:13:55,1220221609,2898,19,38,25,1,37
162190,2023-08-23 17:22:48,1220229179,12872,0,24,10,1,23
162208,2023-08-23 17:49:36,1220252113,87239,92,33,16,2,31
96484,2023-08-23 18:04:20,1220264785,125142,60,90,54,11,79
96484,2023-08-23 18:04:21,1220264802,125142,60,90,54,11,79
96574,2023-08-23 18:07:42,1220267833,16830,53,38,16,5,33
96574,2023-08-23 18:07:43,1220267850,16830,53,38,16,5,33
162211,2023-08-23 18:15:09,1220274254,74115,266,40,18,10,30
96501,2023-08-23 18:17:21,1220276203,18972,139,98,14,19,79
162216,2023-08-23 18:21:18,1220279615,4475,3,8,5,1,7
162215,2023-08-23 18:22:33,1220280606,157407,280,42,26,10,32
136448,2023-08-23 18:22:48,1220280823,19925,20,27,15,5,22
162214,2023-08-23 18:23:51,1220281822,0,6,23,11,0,23
162212,2023-08-23 18:24:13,1220282176,0,0,14,10,0,14
162217,2023-08-23 18:33:28,1220290281,0,1,17,14,0,17
162220,2023-08-23 18:34:48,1220291408,7007,34,68,46,7,61
162222,2023-08-23 18:51:45,1220305953,0,135,61,28,0,61
124388,2023-08-23 19:06:48,1220319146,124066,84,63,44,6,57
162231,2023-08-23 19:13:03,1220324685,32999,214,85,36,3,82
162232,2023-08-23 19:27:39,1220337522,23118,60,12,10,4,8
162232,2023-08-23 19:27:41,1220337546,23118,60,12,10,4,8
162233,2023-08-23 19:27:47,1220337607,34609,63,40,33,4,36
162234,2023-08-23 19:27:55,1220337695,14610,19,36,24,2,34
96488,2023-08-23 19:56:17,1220361489,94627,88,76,51,8,68
124474,2023-08-23 20:04:43,1220368682,1505,18,39,30,1,38
150389,2023-08-23 20:13:16,1220375895,34886,126,17,7,10,7
150390,2023-08-23 20:13:33,1220376137,96074,298,94,56,4,90
150392,2023-08-23 20:13:45,1220376308,35076,68,51,22,2,49
150393,2023-08-23 20:13:59,1220376494,0,31,80,41,0,80
152044,2023-08-23 20:14:15,1220376758,43117,86,38,32,4,34
162247,2023-08-23 20:20:04,1220381387,23964,103,44,26,4,40
162260,2023-08-23 21:12:17,1220423192,59984,196,34,21,13,21
150944,2023-08-23 21:17:32,1220427374,1956,42,33,23,1,32
150921,2023-08-23 21:17:56,1220427663,81,244,40,18,3,37
150918,2023-08-23 21:18:18,1220427999,35270,44,54,31,3,51
150912,2023-08-23 21:18:40,1220428277,2176,27,12,10,1,11
150905,2023-08-23 21:19:01,1220428548,47517,283,48,27,4,44
150901,2023-08-23 21:19:25,1220428882,2115,23,37,28,1,36
162262,2023-08-23 21:25:25,1220433720,72075,112,60,6,3,57
162261,2023-08-23 21:26:27,1220434565,7194,9,41,14,1,40
162264,2023-08-23 21:33:38,1220440415,9081,238,70,41,5,65
162263,2023-08-23 21:34:22,1220440987,172072,165,57,23,10,47
162265,2023-08-23 21:36:48,1220442911,20812,23,18,7,1,17
162266,2023-08-23 21:59:30,1220461420,35592,109,37,4,2,35
89396,2023-08-23 22:14:37,1220472892,81864,103,102,25,3,99
162268,2023-08-23 22:14:57,1220473175,27314,163,47,8,4,43
162269,2023-08-23 22:15:04,1220473268,9446,76,11,7,3,8
89399,2023-08-23 22:15:08,1220473319,0,80,47,17,0,47
89410,2023-08-23 22:15:35,1220473684,16926,9,32,12,1,31
151753,2023-08-23 22:15:54,1220473958,2464,10,4,0,1,3
162270,2023-08-23 22:20:52,1220477721,121904,241,43,27,12,31
162271,2023-08-23 22:27:24,1220482620,0,46,2,1,0,2
162274,2023-08-23 23:21:32,1220524081,112152,74,20,9,3,17
130783,2023-08-23 23:37:58,1220536306,83655,60,30,21,3,27
130784,2023-08-23 23:41:11,1220538636,118990,158,46,28,6,40
130787,2023-08-23 23:44:02,1220540556,124588,553,89,49,14,75
130767,2023-08-23 23:48:59,1220544000,127942,307,86,60,9,77
152798,2023-08-24 00:32:11,1220572632,3982,75,57,3,5,52
153051,2023-08-24 00:33:11,1220573211,26931,136,116,35,5,111
152802,2023-08-24 00:35:11,1220574434,73287,90,116,59,9,107
152801,2023-08-24 00:35:57,1220574939,0,55,27,15,0,27
152349,2023-08-24 00:37:32,1220576078,7,155,71,22,1,70
152680,2023-08-24 00:38:21,1220576682,281,2,4,0,1,3
152345,2023-08-24 00:38:53,1220577021,21053,259,46,23,4,42
152344,2023-08-24 00:39:28,1220577404,9790,73,85,48,5,80
152721,2023-08-24 00:40:02,1220577781,4421,5,46,22,2,44
152346,2023-08-24 00:40:33,1220578169,5760,33,104,45,3,101
152434,2023-08-24 00:41:11,1220578677,17194,24,41,27,5,36
152363,2023-08-24 00:41:42,1220579019,35860,180,94,29,12,82
19005,2023-08-24 14:34:49,1220835005,259132,239,166,47,11,155
19005,2023-08-24 14:34:51,1220835014,259132,239,166,47,11,155
19005,2023-08-24 14:34:54,1220835032,259132,239,166,47,11,155
152797,2023-08-24 14:45:10,1220839127,52526,57,41,8,3,38
151561,2023-08-24 15:23:18,1220857550,2622,69,15,7,2,13
151398,2023-08-24 15:24:03,1220857979,16452,115,77,48,5,72
151400,2023-08-24 15:24:49,1220858396,95703,103,57,44,5,52
151394,2023-08-24 15:25:28,1220858792,31220,119,59,47,6,53
151399,2023-08-24 15:26:09,1220859212,18680,0,55,5,1,54
151567,2023-08-24 15:26:53,1220859641,62154,151,87,66,6,81
151369,2023-08-24 15:28:01,1220860261,21968,49,87,21,5,82
151373,2023-08-24 15:28:38,1220860636,118955,90,46,20,7,39
151370,2023-08-24 15:29:28,1220861103,139182,39,37,17,8,29
151363,2023-08-24 15:30:02,1220861392,100195,40,17,12,4,13
151364,2023-08-24 15:30:47,1220861796,88894,48,14,9,4,10
151371,2023-08-24 15:31:41,1220862321,196516,151,69,25,12,57
162299,2023-08-24 15:32:08,1220862556,4546,24,5,3,1,4
151362,2023-08-24 15:32:21,1220862673,90947,255,114,43,11,103
162301,2023-08-24 15:34:08,1220863726,16832,197,19,9,5,14
162301,2023-08-24 15:34:11,1220863772,16832,197,19,9,5,14
112612,2023-08-24 15:42:28,1220868816,0,4,19,10,0,19
93241,2023-08-24 15:44:43,1220870322,72562,106,57,39,6,51
94646,2023-08-24 15:45:13,1220870613,65944,112,28,15,10,18
139400,2023-08-24 15:45:36,1220870875,8545,57,16,11,2,14
139398,2023-08-24 15:45:56,1220871080,13099,76,14,10,2,12
148601,2023-08-24 15:46:17,1220871316,7633,85,73,33,3,70
162303,2023-08-24 15:54:17,1220876621,70832,160,20,15,7,13
162311,2023-08-24 15:55:56,1220877725,3786,20,63,28,6,57
162315,2023-08-24 16:12:40,1220888959,1939,5,5,4,1,4
162317,2023-08-24 16:24:08,1220897415,3065,23,18,12,2,16
162317,2023-08-24 16:24:12,1220897490,3065,23,18,12,2,16
162229,2023-08-24 16:29:33,1220901535,1789,2,4,1,1,3
162319,2023-08-24 16:31:26,1220903043,4860,111,37,29,3,34
162323,2023-08-24 16:35:46,1220906460,102529,75,74,43,6,68
162323,2023-08-24 16:35:47,1220906470,102529,75,74,43,6,68
162323,2023-08-24 16:35:49,1220906497,102529,75,74,43,6,68
162323,2023-08-24 16:35:50,1220906500,102529,75,74,43,6,68
95170,2023-08-24 16:37:42,1220907912,35710,159,150,56,5,145
162124,2023-08-24 16:43:40,1220912627,43475,57,16,8,3,13
132218,2023-08-24 16:44:32,1220913334,43053,277,248,35,5,243
151972,2023-08-24 16:45:12,1220913894,2421,0,23,15,1,22
151973,2023-08-24 16:45:43,1220914261,36609,229,107,55,13,94
162330,2023-08-24 16:47:11,1220915464,72833,110,52,37,6,46
96812,2023-08-24 16:48:09,1220916287,7216,0,43,32,1,42
96812,2023-08-24 16:48:12,1220916341,7216,0,43,32,1,42
162339,2023-08-24 16:56:44,1220923361,218141,96,18,14,3,15
162351,2023-08-24 17:28:02,1220949220,85823,253,103,48,16,87
162352,2023-08-24 17:30:01,1220950890,8319,108,58,39,7,51
162352,2023-08-24 17:30:02,1220950907,8319,108,58,39,7,51
162353,2023-08-24 17:31:33,1220952214,4133,15,37,24,1,36
162354,2023-08-24 17:36:10,1220956092,12162,51,93,54,5,88
162354,2023-08-24 17:36:11,1220956100,12162,51,93,54,5,88
162354,2023-08-24 17:36:15,1220956171,12162,51,93,54,5,88
162355,2023-08-24 17:40:16,1220959338,26073,141,19,9,7,12
162355,2023-08-24 17:40:19,1220959393,26073,141,19,9,7,12
151658,2023-08-24 18:01:37,1220977819,23298,70,69,29,3,66
151654,2023-08-24 18:01:59,1220978169,6909,49,28,8,2,26
162361,2023-08-24 18:30:29,1221008825,16363,17,31,22,3,28
162361,2023-08-24 18:30:31,1221008882,16363,17,31,22,3,28
162361,2023-08-24 18:30:34,1221008928,16363,17,31,22,3,28
162363,2023-08-24 18:32:48,1221010886,0,4,11,1,0,11
162364,2023-08-24 18:36:36,1221014201,7826,83,9,8,2,7
162367,2023-08-24 18:41:45,1221018769,0,0,58,9,0,58
162369,2023-08-24 18:43:46,1221020551,19938,23,33,12,1,32
162310,2023-08-24 18:44:25,1221021167,7632,30,8,3,2,6
162371,2023-08-24 18:55:18,1221031072,0,18,53,33,0,53
162372,2023-08-24 19:11:40,1221045819,0,3,75,40,0,75
162385,2023-08-24 19:47:46,1221075964,108652,66,77,23,6,71
162385,2023-08-24 19:47:53,1221076071,108652,66,77,23,6,71
11429,2023-08-24 20:08:37,1221093519,3897,63,24,15,3,21
93577,2023-08-24 20:57:54,1221133230,30266,33,21,14,4,17
151776,2023-08-24 21:06:34,1221139849,0,0,3,2,0,3
151689,2023-08-24 21:07:15,1221140441,10177,79,34,20,8,26
151649,2023-08-24 21:07:43,1221140809,0,0,1,0,0,1
151650,2023-08-24 21:08:19,1221141286,10969,5,25,11,1,24
151650,2023-08-24 21:08:25,1221141380,10969,5,25,11,1,24
151722,2023-08-24 21:09:01,1221141836,7853,65,40,24,1,39
162399,2023-08-24 21:09:33,1221142259,1812,36,72,49,1,71
162401,2023-08-24 21:26:06,1221155179,86455,201,68,46,12,56
162402,2023-08-24 21:31:33,1221159573,20829,33,4,3,2,2
162404,2023-08-24 21:43:40,1221168965,11699,87,3,2,3,0
162405,2023-08-24 21:57:28,1221179890,0,2,4,0,0,4
162405,2023-08-24 21:57:30,1221179920,0,2,4,0,0,4
162406,2023-08-24 22:06:44,1221187085,12614,79,7,7,3,4
162406,2023-08-24 22:06:45,1221187095,12614,79,7,7,3,4
162415,2023-08-24 22:28:54,1221203308,170906,91,48,28,10,38
162415,2023-08-24 22:29:01,1221203383,170906,91,48,28,10,38
162427,2023-08-24 22:37:14,1221209221,99125,254,117,87,12,105
162428,2023-08-24 22:42:55,1221213122,110112,223,34,23,11,23
162429,2023-08-24 22:47:36,1221218654,1960,103,48,41,2,46
162432,2023-08-24 22:52:21,1221222162,18615,103,69,31,7,62
162430,2023-08-24 22:52:39,1221222362,14718,53,34,15,5,29
162431,2023-08-24 22:53:22,1221222844,156581,401,97,59,24,73
162433,2023-08-24 22:54:39,1221223726,0,1,41,22,0,41
111368,2023-08-25 01:49:13,1221433572,28673,65,83,61,6,77
152718,2023-08-25 01:49:18,1221433655,3380,26,68,54,2,66
152715,2023-08-25 01:49:27,1221433845,33274,185,61,36,5,56
162434,2023-08-25 14:06:18,1222528464,94387,370,39,30,8,31
162434,2023-08-25 14:06:21,1222528472,94387,370,39,30,8,31
162454,2023-08-25 14:19:11,1222531449,66624,214,40,31,9,31
162454,2023-08-25 14:19:16,1222531482,66624,214,40,31,9,31
162455,2023-08-25 14:25:35,1222533074,15123,106,63,56,4,59
162455,2023-08-25 14:25:38,1222533084,15123,106,63,56,4,59
162452,2023-08-25 14:34:21,1222547931,452,39,40,13,2,38
114567,2023-08-25 14:41:53,1222567737,6984,42,31,9,2,29
132716,2023-08-25 14:59:21,1222623406,9472,18,13,6,4,9
147558,2023-08-25 15:03:53,1222639127,638,2,2,0,1,1
162483,2023-08-25 15:36:24,1222750726,38219,159,123,11,18,105
162484,2023-08-25 15:51:35,1222790412,117611,97,41,21,7,34
162484,2023-08-25 15:51:38,1222790443,117611,97,41,21,7,34
162485,2023-08-25 15:59:21,1222807619,8384,27,12,11,3,9
162487,2023-08-25 16:22:13,1222857165,77209,134,33,27,6,27
162488,2023-08-25 16:25:14,1222864272,67344,166,24,10,14,10
162489,2023-08-25 16:28:53,1222868130,67465,116,26,8,5,21
162490,2023-08-25 16:34:34,1222871454,15181,19,71,26,1,70
126103,2023-08-25 16:55:44,1222884355,663,2,126,24,1,125
162499,2023-08-25 17:02:55,1222893735,121558,68,24,20,3,21
162365,2023-08-25 17:03:11,1222894094,0,0,8,3,0,8
162366,2023-08-25 17:04:42,1222895982,126335,98,73,19,4,69
162500,2023-08-25 17:10:55,1222904152,88927,64,49,21,3,46
162508,2023-08-25 17:21:55,1222919054,0,0,5,0,0,5
162507,2023-08-25 17:26:31,1222928239,56497,152,23,11,9,14
162512,2023-08-25 17:27:36,1222930216,51022,191,44,21,7,37
162511,2023-08-25 17:27:41,1222930406,0,0,3,2,0,3
162534,2023-08-25 18:38:04,1223001377,5055,7,5,3,1,4
162533,2023-08-25 18:49:21,1223010706,0,0,1,1,0,1
162536,2023-08-25 18:53:04,1223013850,164604,402,94,53,21,73
162539,2023-08-25 19:26:43,1223074718,66903,25,42,20,1,41
162540,2023-08-25 19:28:09,1223079201,8378,4,12,8,1,11
162543,2023-08-25 19:42:26,1223124929,9770,31,5,1,2,3
162527,2023-08-25 20:30:03,1223228255,46716,153,105,52,4,101
162562,2023-08-25 21:20:37,1223298854,24461,63,25,1,9,16
162573,2023-08-25 21:47:16,1223354792,332075,122,40,31,5,35
162573,2023-08-25 21:47:19,1223354938,332075,122,40,31,5,35
162575,2023-08-25 21:53:15,1223373810,218723,351,94,50,17,77
162575,2023-08-25 21:53:21,1223374108,218723,351,94,50,17,77
162576,2023-08-25 22:07:38,1223412490,53988,39,28,26,4,24
162577,2023-08-25 22:07:55,1223413120,0,0,8,6,0,8
162580,2023-08-25 22:38:26,1223481434,1750,2,6,5,1,5
162583,2023-08-25 22:53:59,1223517892,23655,73,34,17,4,30
162586,2023-08-25 23:05:09,1223546434,2384,15,6,4,1,5
162590,2023-08-25 23:11:35,1223558702,8783,32,21,15,2,19
162591,2023-08-25 23:15:31,1223565923,2247,6,3,1,1,2
162592,2023-08-25 23:19:22,1223573066,0,2,60,43,0,60
130768,2023-08-25 23:24:12,1223581800,104236,119,156,63,8,148
162593,2023-08-25 23:28:15,1223587554,52632,41,8,4,3,5
162594,2023-08-25 23:37:58,1223602090,777,18,5,1,1,4
162595,2023-08-25 23:42:18,1223608247,3128,46,35,18,1,34
132928,2023-08-26 00:05:56,1223662185,65880,259,82,52,4,78
162596,2023-08-26 00:14:16,1223677250,116239,99,48,36,6,42
162597,2023-08-26 00:29:29,1223698798,0,16,17,13,0,17
162600,2023-08-26 14:23:57,1223912037,29926,49,7,4,2,5
162601,2023-08-26 14:35:02,1223915236,41827,63,16,11,7,9
162608,2023-08-26 14:56:54,1223921406,24173,190,85,43,5,80
162609,2023-08-26 15:01:02,1223922725,0,0,11,6,0,11
92944,2023-08-26 15:01:23,1223922840,10624,74,6,3,4,2
93077,2023-08-26 15:02:53,1223923319,19259,61,50,30,2,48
162610,2023-08-26 15:04:01,1223923697,129376,253,49,34,11,38
162611,2023-08-26 15:04:21,1223923844,6229,72,3,2,2,1
92133,2023-08-26 15:04:30,1223923893,20725,182,73,27,6,67
150496,2023-08-26 15:06:30,1223924566,12388,44,6,4,3,3
162612,2023-08-26 15:09:20,1223925646,184,8,6,4,1,5
162613,2023-08-26 15:13:38,1223927252,36089,75,5,3,2,3
162614,2023-08-26 15:19:38,1223929573,25030,69,39,10,5,34
130055,2023-08-26 15:41:54,1223939113,34305,185,29,15,8,21
129714,2023-08-26 15:42:17,1223939288,8935,15,8,3,2,6
129711,2023-08-26 15:42:37,1223939405,34306,50,56,31,6,50
132203,2023-08-26 15:43:02,1223939619,0,0,7,3,0,7
141707,2023-08-26 15:43:27,1223939785,2516,2,3,1,1,2
162615,2023-08-26 15:46:19,1223941058,1873,5,37,16,1,36
150585,2023-08-26 15:49:58,1223942542,28761,77,42,22,2,40
162618,2023-08-26 15:58:53,1223946313,0,0,20,16,0,20
162620,2023-08-26 16:03:47,1223948403,0,2,12,2,0,12
162621,2023-08-26 16:06:54,1223949892,2908,26,22,11,2,20
162622,2023-08-26 16:17:41,1223955357,86758,325,34,15,8,26
162624,2023-08-26 16:26:28,1223959974,5927,20,14,14,1,13
162636,2023-08-26 17:13:03,1223985883,2510,30,30,2,3,27
162638,2023-08-26 17:18:54,1223989595,38601,92,184,48,4,180
147730,2023-08-26 17:23:47,1223992877,79935,160,69,35,5,64
162641,2023-08-26 17:41:33,1224004230,14227,26,8,4,2,6
162642,2023-08-26 17:50:08,1224009878,0,3,83,60,0,83
162645,2023-08-26 18:04:50,1224019873,7449,15,6,3,2,4
162647,2023-08-26 18:40:49,1224044349,0,3,58,49,0,58
162646,2023-08-26 18:41:05,1224044511,0,64,33,29,0,33
162648,2023-08-26 18:58:14,1224055390,0,3,37,34,0,37
162640,2023-08-26 19:18:17,1224067581,0,5,19,14,0,19
162634,2023-08-26 19:18:23,1224067638,16834,105,14,11,4,10
162627,2023-08-26 19:18:30,1224067729,0,3,12,7,0,12
162626,2023-08-26 19:18:37,1224067793,17492,28,37,32,3,34
162625,2023-08-26 19:18:51,1224067898,80484,220,85,64,9,76
162623,2023-08-26 19:18:57,1224067967,0,0,8,6,0,8
162619,2023-08-26 19:19:05,1224068074,120586,77,100,29,2,98
162589,2023-08-26 19:19:20,1224068216,8380,8,8,7,1,7
162554,2023-08-26 19:19:30,1224068300,10291,57,36,26,2,34
142227,2023-08-28 14:33:39,1224756932,127159,116,229,21,8,221
142227,2023-08-28 14:33:47,1224756967,127159,116,229,21,8,221
142230,2023-08-28 14:34:46,1224757321,33630,212,60,26,12,48
142220,2023-08-28 14:35:13,1224757494,13102,58,6,3,2,4
142333,2023-08-28 14:35:35,1224757630,44058,204,41,15,11,30
142224,2023-08-28 14:35:52,1224757726,5090,8,51,22,1,50
142232,2023-08-28 14:36:20,1224757904,8093,17,12,8,2,10
162666,2023-08-28 14:59:32,1224765933,110120,227,112,87,13,99
162667,2023-08-28 15:02:37,1224767074,622,6,25,14,2,23
162668,2023-08-28 15:06:58,1224768800,293095,174,113,67,13,100
152020,2023-08-28 15:10:10,1224770142,17392,268,51,34,2,49
153140,2023-08-28 15:19:43,1224774555,3469,26,46,32,1,45
152905,2023-08-28 15:20:10,1224774798,35381,35,37,10,6,31
152599,2023-08-28 15:20:34,1224775025,0,1,46,27,0,46
152164,2023-08-28 15:20:55,1224775210,0,0,34,29,0,34
152162,2023-08-28 15:21:20,1224775435,12702,58,9,1,4,5
162669,2023-08-28 15:24:47,1224777188,130577,82,40,10,5,35
142235,2023-08-28 15:31:20,1224780810,44410,17,17,14,2,15
127405,2023-08-28 15:41:34,1224786525,28426,238,44,23,5,39
162672,2023-08-28 15:42:01,1224786759,4240,30,25,12,1,24
162679,2023-08-28 15:57:21,1224795663,0,0,2,0,0,2
160459,2023-08-28 16:36:31,1224823266,440,1,1,1,1,0
162616,2023-08-28 16:39:06,1224825163,57814,181,63,18,6,57
162617,2023-08-28 16:39:15,1224825267,1999,143,29,16,1,28
162693,2023-08-28 16:39:29,1224825440,285,1,69,18,1,68
162693,2023-08-28 16:39:32,1224825477,285,1,69,18,1,68
141609,2023-08-28 16:39:46,1224825634,1789,13,55,35,1,54
132446,2023-08-28 16:39:55,1224825737,71154,91,83,50,4,79
162696,2023-08-28 16:39:55,1224825749,57962,107,27,19,5,22
132447,2023-08-28 16:40:03,1224825851,17513,110,27,12,6,21
132452,2023-08-28 16:40:15,1224826016,43160,263,111,44,12,99
162697,2023-08-28 16:51:57,1224835012,0,0,16,15,0,16
162697,2023-08-28 16:52:01,1224835076,0,0,16,15,0,16
162699,2023-08-28 16:59:54,1224841419,55003,6,41,8,4,37
162703,2023-08-28 17:00:00,1224841519,26874,178,64,16,8,56
162704,2023-08-28 17:02:39,1224843563,268706,236,95,23,9,86
162715,2023-08-28 17:47:05,1224879119,67833,96,65,54,7,58
162717,2023-08-28 17:54:15,1224885095,54256,214,36,31,10,26
162708,2023-08-28 17:57:05,1224887331,0,0,11,5,0,11
162723,2023-08-28 17:57:26,1224887601,0,0,9,7,0,9
150418,2023-08-28 18:07:54,1224896497,0,0,3,1,0,3
150415,2023-08-28 18:09:14,1224897711,16814,8,48,34,1,47
162728,2023-08-28 18:14:58,1224902322,2854,35,4,3,2,2
162725,2023-08-28 18:20:53,1224907552,53896,69,19,14,4,15
162731,2023-08-28 18:29:16,1224914605,6251,57,4,0,3,1
151258,2023-08-28 18:48:47,1224930623,85541,103,32,18,6,26
151258,2023-08-28 18:48:52,1224930704,85541,103,32,18,6,26
151290,2023-08-28 18:49:23,1224931136,57991,189,35,21,9,26
151290,2023-08-28 18:49:26,1224931174,57991,189,35,21,9,26
151390,2023-08-28 18:49:57,1224931604,32436,148,75,51,6,69
140684,2023-08-28 18:50:48,1224932314,17155,35,53,33,4,49
140684,2023-08-28 18:50:51,1224932355,17155,35,53,33,4,49
140555,2023-08-28 18:51:24,1224932809,93736,150,53,24,8,45
151288,2023-08-28 18:51:58,1224933231,45636,154,48,32,4,44
162745,2023-08-28 18:59:00,1224938885,0,1,14,6,0,14
127413,2023-08-28 19:20:49,1224957305,6615,90,60,32,5,55
150546,2023-08-28 19:24:46,1224960620,0,0,2,1,0,2
151738,2023-08-28 19:59:41,1224989726,131932,123,47,25,7,40
151739,2023-08-28 20:00:39,1224990412,1057,10,12,9,1,11
145542,2023-08-28 20:01:03,1224990737,25345,116,121,95,4,117
162773,2023-08-28 20:55:24,1225036966,537,43,12,5,2,10
142508,2023-08-28 20:56:13,1225037819,51859,85,55,19,10,45
142509,2023-08-28 20:57:37,1225039369,19185,5,41,23,2,39
162784,2023-08-28 21:32:59,1225074443,123164,261,81,45,14,67
152112,2023-08-28 21:35:47,1225077082,75850,40,118,68,2,116
152165,2023-08-28 21:36:15,1225077542,2673,58,31,18,2,29
152183,2023-08-28 21:36:45,1225077961,0,0,9,5,0,9
152399,2023-08-28 21:37:05,1225078281,0,26,32,9,0,32
162730,2023-08-28 22:30:10,1225128176,70,92,32,17,2,30
162730,2023-08-28 22:30:11,1225128192,70,92,32,17,2,30
162730,2023-08-28 22:30:12,1225128208,70,92,32,17,2,30
162797,2023-08-28 22:47:59,1225145346,13305,114,35,6,8,27
141782,2023-08-28 22:49:41,1225146893,60090,216,64,29,18,46
132020,2023-08-28 22:49:59,1225147161,24728,131,58,27,9,49
132024,2023-08-28 22:51:59,1225149175,42681,232,41,10,3,38
132106,2023-08-28 22:52:24,1225149575,15769,31,49,39,1,48
132022,2023-08-28 22:52:41,1225149832,53615,67,83,32,3,80
132025,2023-08-28 22:53:15,1225150364,0,51,56,42,0,56
162798,2023-08-28 22:55:21,1225152359,5026,36,44,6,2,42
162844,2023-08-29 14:09:08,1225401854,1487,171,4,1,1,3
162845,2023-08-29 14:18:56,1225404456,59745,35,12,5,2,10
162845,2023-08-29 14:19:02,1225404493,59745,35,12,5,2,10
162846,2023-08-29 14:32:14,1225408864,0,0,6,3,0,6
162847,2023-08-29 14:40:23,1225412005,179547,266,88,53,17,71
162847,2023-08-29 14:40:27,1225412039,179547,266,88,53,17,71
162847,2023-08-29 14:40:28,1225412044,179547,266,88,53,17,71
162847,2023-08-29 14:40:29,1225412054,179547,266,88,53,17,71
162847,2023-08-29 14:40:30,1225412057,179547,266,88,53,17,71
162849,2023-08-29 14:50:32,1225416170,28961,52,54,24,4,50
162850,2023-08-29 15:02:43,1225421657,0,0,5,2,0,5
109663,2023-08-29 15:05:56,1225423096,255,2,29,10,1,28
107683,2023-08-29 15:06:27,1225423333,16925,73,70,44,5,65
162843,2023-08-29 15:06:50,1225423509,71035,104,24,21,4,20
162843,2023-08-29 15:06:51,1225423522,71035,104,24,21,4,20
162851,2023-08-29 15:07:27,1225423816,0,45,41,10,0,41
153430,2023-08-29 15:09:04,1225424559,236635,240,78,58,9,69
162852,2023-08-29 15:15:40,1225428090,8504,36,41,28,4,37
162853,2023-08-29 15:19:20,1225430090,75671,164,11,8,6,5
162853,2023-08-29 15:19:25,1225430142,75671,164,11,8,6,5
153018,2023-08-29 15:20:18,1225430575,552,1,3,0,1,2
153001,2023-08-29 15:20:47,1225430847,10385,172,43,14,4,39
162854,2023-08-29 15:21:20,1225431156,36514,138,53,37,6,47
153000,2023-08-29 15:22:09,1225431584,0,0,1,0,0,1
152960,2023-08-29 15:22:47,1225431929,9180,118,28,2,2,26
152069,2023-08-29 15:23:13,1225432138,6201,18,48,23,2,46
162856,2023-08-29 15:30:47,1225436412,135089,299,57,15,17,40
162858,2023-08-29 15:33:23,1225438060,115677,127,74,47,10,64
162858,2023-08-29 15:33:25,1225438102,115677,127,74,47,10,64
162858,2023-08-29 15:33:26,1225438106,115677,127,74,47,10,64
162858,2023-08-29 15:33:28,1225438134,115677,127,74,47,10,64
162858,2023-08-29 15:33:29,1225438142,115677,127,74,47,10,64
162858,2023-08-29 15:33:31,1225438157,115677,127,74,47,10,64
153544,2023-08-29 15:35:50,1225439582,69338,77,119,48,6,113
153516,2023-08-29 15:36:24,1225439942,28848,84,129,70,4,125
153584,2023-08-29 15:37:02,1225440297,19359,21,117,54,3,114
162859,2023-08-29 15:37:14,1225440464,44097,42,18,15,4,14
153545,2023-08-29 15:37:31,1225440597,1431,57,423,96,2,421
153518,2023-08-29 15:38:48,1225441460,63897,76,80,46,5,75
130126,2023-08-29 15:47:42,1225447268,35160,256,56,32,3,53
130126,2023-08-29 15:47:45,1225447293,36935,271,63,37,4,59
162855,2023-08-29 15:50:31,1225449051,58072,344,48,27,14,34
162855,2023-08-29 15:50:33,1225449077,58072,344,48,27,14,34
162855,2023-08-29 15:50:35,1225449091,58072,344,48,27,14,34
162887,2023-08-29 15:50:57,1225449313,632,27,34,5,1,33
162886,2023-08-29 16:07:54,1225460912,5151,160,4,2,3,1
162863,2023-08-29 16:08:04,1225461038,6075,12,2,1,1,1
162860,2023-08-29 16:08:12,1225461130,140522,150,67,29,8,59
162857,2023-08-29 16:08:19,1225461199,51215,121,45,23,4,41
162774,2023-08-29 16:08:26,1225461276,13730,47,62,52,1,61
162890,2023-08-29 16:08:50,1225461519,644,24,17,3,1,16
162772,2023-08-29 16:09:01,1225461637,0,0,1,0,0,1
162895,2023-08-29 16:38:30,1225484690,42849,51,33,5,7,26
162903,2023-08-29 16:47:34,1225492056,68716,61,63,44,6,57
162903,2023-08-29 16:47:39,1225492154,68716,61,63,44,6,57
127503,2023-08-29 16:52:56,1225496737,34783,46,45,19,5,40
162904,2023-08-29 16:56:50,1225499825,13337,26,15,5,3,12
162906,2023-08-29 16:59:42,1225502086,17045,24,35,22,1,34
162907,2023-08-29 17:02:30,1225504376,1409,26,30,10,1,29
162908,2023-08-29 17:03:55,1225505600,21093,40,17,8,5,12
162911,2023-08-29 17:15:29,1225514973,231174,195,64,34,13,51
162911,2023-08-29 17:15:30,1225514987,231174,195,64,34,13,51
162911,2023-08-29 17:15:31,1225514992,231174,195,64,34,13,51
162911,2023-08-29 17:15:32,1225515004,231174,195,64,34,13,51
162911,2023-08-29 17:15:33,1225515024,231174,195,64,34,13,51
162911,2023-08-29 17:15:36,1225515065,231174,195,64,34,13,51
118319,2023-08-29 17:24:36,1225522828,20799,15,22,17,2,20
118335,2023-08-29 17:24:50,1225523027,31201,18,28,24,2,26
118338,2023-08-29 17:25:17,1225523422,63447,87,48,27,6,42
115667,2023-08-29 17:25:34,1225523684,39598,39,40,28,2,38
129517,2023-08-29 17:25:49,1225523907,0,0,27,22,0,27
129517,2023-08-29 17:25:50,1225523928,0,0,27,22,0,27
151137,2023-08-29 17:26:04,1225524134,0,0,1,0,0,1
151137,2023-08-29 17:26:06,1225524153,0,0,1,0,0,1
162913,2023-08-29 17:27:09,1225525129,6045,25,46,38,3,43
151532,2023-08-29 17:27:39,1225525505,4444,4,46,27,1,45
151557,2023-08-29 17:27:55,1225525724,6769,35,34,3,2,32
151530,2023-08-29 17:28:10,1225525924,5647,6,6,1,1,5
151575,2023-08-29 17:28:27,1225526137,149129,46,23,16,2,21
162921,2023-08-29 18:54:47,1225600511,27328,147,57,42,3,54
162921,2023-08-29 18:54:52,1225600577,27328,147,57,42,3,54
142820,2023-08-29 19:16:17,1225618766,14404,55,76,47,6,70
142820,2023-08-29 19:16:21,1225618831,14404,55,76,47,6,70
65981,2023-08-29 19:43:02,1225640832,111073,183,109,65,9,100
162939,2023-08-29 19:47:24,1225644531,51598,85,46,25,11,35
162939,2023-08-29 19:47:25,1225644544,51598,85,46,25,11,35
162939,2023-08-29 19:47:26,1225644549,51598,85,46,25,11,35
162939,2023-08-29 19:47:27,1225644575,51598,85,46,25,11,35
162939,2023-08-29 19:47:28,1225644579,51598,85,46,25,11,35
162939,2023-08-29 19:47:29,1225644598,51598,85,46,25,11,35
162939,2023-08-29 19:47:31,1225644625,51598,85,46,25,11,35
162939,2023-08-29 19:47:32,1225644631,51598,85,46,25,11,35
162939,2023-08-29 19:47:34,1225644650,51598,85,46,25,11,35
162939,2023-08-29 19:47:35,1225644678,51598,85,46,25,11,35
162940,2023-08-29 19:51:22,1225647959,10865,46,23,9,4,19
162940,2023-08-29 19:51:23,1225647965,10865,46,23,9,4,19
162940,2023-08-29 19:51:25,1225648003,10865,46,23,9,4,19
162940,2023-08-29 19:51:26,1225648017,10865,46,23,9,4,19
135735,2023-08-29 20:01:38,1225656582,57057,57,50,35,8,42
162962,2023-08-29 21:02:45,1225703540,9651,92,26,18,4,22
162962,2023-08-29 21:02:47,1225703568,9651,92,26,18,4,22
162963,2023-08-29 21:06:38,1225706337,0,6,34,23,0,34
162963,2023-08-29 21:06:40,1225706354,0,6,34,23,0,34
162968,2023-08-29 21:21:00,1225717273,44425,10,91,54,3,88
162966,2023-08-29 21:21:02,1225717297,39004,8,55,13,3,52
162985,2023-08-29 21:23:51,1225719438,52329,221,121,26,17,104
162986,2023-08-29 21:26:14,1225721323,48698,31,57,15,3,54
136403,2023-08-29 22:11:47,1225756229,13205,24,46,30,2,44
130993,2023-08-29 22:12:50,1225756962,22114,135,71,44,4,67
151186,2023-08-29 22:13:15,1225757326,6770,35,28,9,1,27
162967,2023-08-29 22:19:43,1225762130,121802,63,12,1,4,8
163006,2023-08-29 22:29:41,1225769096,95977,154,52,44,3,49
163013,2023-08-29 22:38:52,1225775784,44532,59,22,16,4,18
163013,2023-08-29 22:38:54,1225775801,44532,59,22,16,4,18
163013,2023-08-29 22:38:57,1225775842,44532,59,22,16,4,18
163018,2023-08-29 22:53:10,1225786210,163519,140,20,15,5,15
163018,2023-08-29 22:53:11,1225786216,163519,140,20,15,5,15
163018,2023-08-29 22:53:13,1225786260,163519,140,20,15,5,15
163022,2023-08-29 23:23:05,1225807819,1771,32,11,8,1,10
163019,2023-08-30 14:18:00,1226040736,3155,74,32,8,4,28
163019,2023-08-30 14:18:02,1226040749,3155,74,32,8,4,28
163027,2023-08-30 14:19:47,1226041312,0,0,23,15,0,23
163030,2023-08-30 14:42:37,1226048907,18591,58,17,15,2,15
163031,2023-08-30 14:49:40,1226051886,280884,67,23,22,3,20
163038,2023-08-30 14:53:06,1226053454,1380,24,4,2,1,3
163040,2023-08-30 15:07:41,1226060378,49902,106,31,17,3,28
163040,2023-08-30 15:07:47,1226060423,49902,106,31,17,3,28
123634,2023-08-30 15:15:35,1226064391,24049,139,23,16,4,19
123916,2023-08-30 15:16:20,1226064802,9136,48,38,31,3,35
123639,2023-08-30 15:16:47,1226065048,11932,68,43,22,4,39
124208,2023-08-30 15:17:09,1226065264,11875,83,34,14,5,29
123917,2023-08-30 15:17:30,1226065476,30401,80,21,12,2,19
151750,2023-08-30 15:18:02,1226065783,1154,22,33,26,1,32
163066,2023-08-30 16:43:00,1226141479,25345,48,6,3,3,3
143674,2023-08-30 17:06:54,1226168810,13506,31,72,64,3,69
141242,2023-08-30 17:08:03,1226170107,25553,141,76,21,7,69
143162,2023-08-30 17:08:38,1226170767,21147,41,21,17,2,19
143164,2023-08-30 17:09:18,1226171527,18238,86,35,29,4,31
143164,2023-08-30 17:09:20,1226171566,18238,86,35,29,4,31
141983,2023-08-30 17:09:54,1226172194,189907,140,108,78,7,101
141983,2023-08-30 17:09:57,1226172246,189907,140,108,78,7,101
141223,2023-08-30 17:10:37,1226173110,118337,89,63,53,4,59
141223,2023-08-30 17:10:38,1226173145,118337,89,63,53,4,59
141223,2023-08-30 17:10:40,1226173169,118337,89,63,53,4,59
141986,2023-08-30 17:11:22,1226174012,529,2,20,12,1,19
141986,2023-08-30 17:11:23,1226174017,529,2,20,12,1,19
141986,2023-08-30 17:11:24,1226174048,529,2,20,12,1,19
163073,2023-08-30 17:24:26,1226189342,12067,63,6,3,2,4
163071,2023-08-30 17:24:58,1226189941,18762,79,21,13,6,15
163075,2023-08-30 17:38:21,1226205749,0,156,49,13,0,49
151439,2023-08-30 17:39:40,1226207307,4009,18,15,2,2,13
151437,2023-08-30 17:39:55,1226207598,52548,54,71,27,2,69
151431,2023-08-30 17:40:08,1226207871,42425,24,20,17,1,19
151435,2023-08-30 17:40:32,1226208318,56429,61,48,26,3,45
151441,2023-08-30 17:40:48,1226208630,17608,18,11,7,4,7
151433,2023-08-30 17:41:05,1226208993,0,0,3,0,0,3
163077,2023-08-30 17:48:55,1226218595,11642,65,10,4,4,6
163083,2023-08-30 17:55:44,1226226048,696,94,12,0,3,9
163094,2023-08-30 18:03:16,1226235005,0,37,13,0,0,13
163099,2023-08-30 18:24:24,1226259968,31386,91,163,60,3,160
163109,2023-08-30 18:45:32,1226285361,0,7,10,3,0,10
163133,2023-08-30 20:00:12,1226370374,27678,167,10,2,4,6
162643,2023-08-30 20:04:44,1226373555,1467,7,10,3,1,9
163135,2023-08-30 20:26:13,1226401542,16364,68,21,11,3,18
163135,2023-08-30 20:26:17,1226401624,16364,68,21,11,3,18
163136,2023-08-30 20:31:26,1226407787,51749,44,78,28,4,74
163146,2023-08-30 20:49:24,1226430062,194,5,8,6,1,7
163156,2023-08-30 21:02:19,1226446311,151928,260,51,12,8,43
163157,2023-08-30 21:05:33,1226450092,10512,34,14,8,2,12
163158,2023-08-30 21:11:37,1226457338,24542,47,17,7,3,14
163163,2023-08-30 21:20:05,1226467373,2024,19,15,12,1,14
163168,2023-08-30 21:20:36,1226467965,36046,36,83,47,3,80
163170,2023-08-30 21:41:18,1226492303,9121,3,28,14,1,27
163171,2023-08-30 21:41:26,1226492443,0,2,16,11,0,16
163171,2023-08-30 21:41:30,1226492518,0,2,16,11,0,16
163172,2023-08-30 21:41:38,1226492649,122864,44,82,57,2,80
163173,2023-08-30 21:41:45,1226492796,439,9,1,0,1,0
163175,2023-08-30 21:50:12,1226502961,9353,70,21,6,3,18
163145,2023-08-30 21:52:07,1226505256,98951,122,97,52,7,90
163185,2023-08-30 22:38:29,1226558144,0,0,1,0,0,1
163176,2023-08-30 22:46:57,1226567700,507,156,8,2,1,7
163197,2023-08-30 23:04:26,1226586989,7415,114,48,11,2,46
163196,2023-08-30 23:06:27,1226589120,109950,201,57,31,10,47
163198,2023-08-30 23:06:26,1226589121,98522,195,48,28,8,40
163198,2023-08-30 23:06:29,1226589140,98522,195,48,28,8,40
163199,2023-08-30 23:07:42,1226590541,29169,157,8,6,7,1
152624,2023-08-30 23:11:19,1226594474,0,0,2,0,0,2
152794,2023-08-30 23:11:41,1226594836,4190,52,69,40,3,66
153392,2023-08-30 23:12:02,1226595251,12041,21,54,1,4,50
152567,2023-08-30 23:12:20,1226595585,10762,44,23,13,2,21
152908,2023-08-30 23:12:34,1226595830,6960,8,2,1,1,1
152941,2023-08-30 23:12:47,1226596048,0,6,12,1,0,12
163223,2023-08-31 00:06:54,1226651868,47625,116,40,23,10,30
163223,2023-08-31 00:06:55,1226651882,47625,116,40,23,10,30
163223,2023-08-31 00:06:56,1226651887,47625,116,40,23,10,30
163223,2023-08-31 00:06:58,1226651894,47625,116,40,23,10,30
163223,2023-08-31 00:07:00,1226651968,47625,116,40,23,10,30
163223,2023-08-31 00:07:01,1226651975,47625,116,40,23,10,30
163223,2023-08-31 00:07:02,1226651984,47625,116,40,23,10,30
163148,2023-08-31 15:18:54,1227022304,69421,106,12,6,6,6
163250,2023-08-31 15:20:02,1227023491,65624,174,87,64,5,82
163250,2023-08-31 15:20:03,1227023516,65624,174,87,64,5,82
163250,2023-08-31 15:20:05,1227023539,65624,174,87,64,5,82
163250,2023-08-31 15:20:06,1227023546,65624,174,87,64,5,82
163250,2023-08-31 15:20:08,1227023561,65624,174,87,64,5,82
132927,2023-08-31 15:35:04,1227059895,5578,8,8,3,1,7
163252,2023-08-31 15:40:19,1227073172,1811,71,26,3,7,19
163254,2023-08-31 15:44:17,1227085010,23303,32,15,11,4,11
163254,2023-08-31 15:44:18,1227085021,23303,32,15,11,4,11
163254,2023-08-31 15:44:19,1227085099,23303,32,15,11,4,11
163254,2023-08-31 15:44:20,1227085132,23303,32,15,11,4,11
163255,2023-08-31 15:57:42,1227106717,18383,41,80,38,2,78
163256,2023-08-31 16:00:17,1227109280,2515,32,9,5,2,7
163261,2023-08-31 16:06:06,1227115002,55327,99,121,37,18,103
163269,2023-08-31 16:51:42,1227159403,6491,33,61,33,3,58
163273,2023-08-31 17:03:06,1227168099,37209,110,7,6,4,3
96699,2023-08-31 17:35:13,1227193525,9307,234,44,13,6,38
163002,2023-08-31 18:40:15,1227365549,10133,18,19,13,2,17
132929,2023-08-31 19:35:55,1227537642,22513,101,33,9,13,20
132925,2023-08-31 19:45:43,1227564360,9564,106,48,12,2,46
127161,2023-08-31 19:53:34,1227573539,39877,35,23,14,3,20
126969,2023-08-31 19:53:58,1227573921,16792,68,18,14,5,13
126967,2023-08-31 19:54:17,1227574289,0,10,14,11,0,14
137424,2023-08-31 19:54:32,1227574547,53453,67,31,14,8,23
126970,2023-08-31 19:54:50,1227574792,13687,17,21,16,2,19
163319,2023-08-31 19:55:06,1227575048,110407,328,28,11,9,19
163320,2023-08-31 19:58:50,1227578684,42258,60,54,25,2,52
142152,2023-08-31 20:03:16,1227582825,8044,1,34,11,1,33
132971,2023-08-31 20:10:29,1227588930,12688,37,20,17,3,17
134637,2023-08-31 20:13:12,1227591029,12282,37,46,37,2,44
162912,2023-08-31 21:48:07,1227662799,7654,19,109,12,2,107
163342,2023-08-31 21:57:32,1227669524,3816,27,61,15,2,59
163345,2023-08-31 22:23:22,1227687542,10183,98,51,27,2,49
163381,2023-09-01 00:41:54,1227772678,25377,216,50,30,6,44
163381,2023-09-01 00:42:00,1227772719,25377,216,50,30,6,44
163311,2023-09-01 14:56:12,1227987545,24823,58,24,5,2,22
163419,2023-09-01 15:02:34,1227990307,34966,63,53,35,4,49
163420,2023-09-01 15:18:13,1227997874,89678,152,42,25,7,35
163422,2023-09-01 15:18:50,1227998182,17239,31,7,2,3,4
163444,2023-09-01 16:53:49,1228058127,0,8,83,30,0,83
163438,2023-09-01 16:56:57,1228062011,0,0,26,11,0,26
163446,2023-09-01 17:38:17,1228093087,12666,24,53,23,1,52
163449,2023-09-01 18:14:45,1228121526,0,0,22,19,0,22
163450,2023-09-01 18:19:44,1228126122,5333,3,3,2,1,2
163451,2023-09-01 18:20:58,1228126954,10369,18,71,18,1,70
163452,2023-09-01 18:30:49,1228134544,16632,72,29,17,3,26
163453,2023-09-01 18:32:14,1228135555,24025,138,38,18,5,33
163463,2023-09-01 19:13:43,1228168896,1567,3,18,5,2,16
163467,2023-09-01 21:35:57,1228292460,63461,220,95,51,5,90
163468,2023-09-01 21:48:11,1228305376,7680,12,12,11,1,11
163447,2023-09-01 21:55:50,1228312593,0,2,43,13,0,43
163483,2023-09-02 14:32:56,1228788122,12528,206,58,37,1,57
112831,2023-09-02 14:42:26,1228791782,23503,50,59,14,2,57
112832,2023-09-02 14:44:09,1228792498,59114,85,92,16,4,88
112823,2023-09-02 14:45:25,1228792987,45301,93,29,10,9,20
112834,2023-09-02 14:46:18,1228793302,26018,162,45,10,16,29
143702,2023-09-02 14:47:51,1228793947,16381,14,30,2,2,28
143702,2023-09-02 14:47:53,1228793960,16381,14,30,2,2,28
163485,2023-09-02 15:05:20,1228800615,103107,26,7,6,2,5
163487,2023-09-02 15:13:09,1228803972,16943,70,9,7,1,8
163491,2023-09-02 15:20:38,1228807629,11136,56,8,4,3,5
163490,2023-09-02 15:20:55,1228807788,8523,25,9,3,3,6
163489,2023-09-02 15:21:22,1228808025,18123,13,31,11,4,27
163488,2023-09-02 15:21:38,1228808147,2990,9,31,10,1,30
163486,2023-09-02 15:21:54,1228808271,0,0,5,2,0,5
163492,2023-09-02 15:23:32,1228809079,235,1,3,2,1,2
112833,2023-09-02 16:42:48,1228852561,118332,251,134,40,15,119
112833,2023-09-02 16:42:50,1228852583,118332,251,134,40,15,119
112833,2023-09-02 16:42:55,1228852626,118332,251,134,40,15,119
163466,2023-09-02 18:27:13,1228923531,21854,52,60,6,1,59
163459,2023-09-04 15:01:42,1230044666,52974,149,56,40,5,51
163454,2023-09-04 15:01:52,1230044753,34737,46,3,1,3,0
163534,2023-09-04 15:20:56,1230053667,9307,234,44,13,6,38
163538,2023-09-04 16:20:06,1230091925,362424,264,68,51,14,54
163538,2023-09-04 16:20:15,1230092015,362424,264,68,51,14,54
163539,2023-09-04 16:24:02,1230095111,456717,360,73,50,18,55
163543,2023-09-04 16:42:19,1230109368,26154,41,15,9,3,12
163544,2023-09-04 16:42:28,1230109496,10625,24,8,4,1,7
163540,2023-09-04 16:45:02,1230111497,9456,62,18,6,1,17
152268,2023-09-04 16:51:20,1230116511,5334,26,12,8,2,10
152268,2023-09-04 16:51:22,1230116538,5334,26,12,8,2,10
127136,2023-09-04 17:07:54,1230130255,64300,36,58,20,4,54
127136,2023-09-04 17:07:59,1230130363,64300,36,58,20,4,54
163545,2023-09-04 17:22:28,1230142852,26387,296,80,38,4,76
151755,2023-09-04 17:26:53,1230146597,4579,8,15,5,2,13
151755,2023-09-04 17:26:58,1230146765,4579,8,15,6,2,13
151757,2023-09-04 17:27:09,1230146976,1482,5,5,2,1,4
151756,2023-09-04 17:27:25,1230147227,42679,34,44,31,2,42
151756,2023-09-04 17:27:28,1230147273,42679,34,44,31,2,42
152636,2023-09-04 17:27:44,1230147455,173,16,32,6,2,30
152636,2023-09-04 17:27:47,1230147523,173,16,32,6,2,30
152210,2023-09-04 17:28:09,1230147832,0,1,59,39,0,59
152210,2023-09-04 17:28:12,1230147841,0,1,59,39,0,59
152212,2023-09-04 17:28:33,1230148158,0,0,16,7,0,16
152212,2023-09-04 17:28:32,1230148180,0,0,16,7,0,16
152258,2023-09-04 17:33:18,1230152474,7280,77,20,12,2,18
163560,2023-09-04 19:04:21,1230226751,1397,20,7,1,1,6
163560,2023-09-04 19:04:19,1230226760,1397,20,7,1,1,6
152267,2023-09-04 19:21:38,1230242110,0,0,10,4,0,10
152267,2023-09-04 19:21:40,1230242140,0,0,10,4,0,10
163573,2023-09-04 20:48:58,1230330519,8800,43,25,15,1,24
163577,2023-09-04 21:04:44,1230346305,0,14,36,23,0,36
163579,2023-09-04 21:10:01,1230352472,1879,6,6,3,1,5
163572,2023-09-04 21:11:43,1230354677,36967,82,49,22,3,46
163588,2023-09-04 21:17:43,1230361453,62267,111,156,32,7,149
163589,2023-09-04 21:21:14,1230363690,7708,184,59,25,6,53
163590,2023-09-04 21:21:27,1230363859,10081,37,20,10,2,18
163592,2023-09-04 21:42:23,1230392947,0,167,57,28,0,57
163592,2023-09-04 21:42:25,1230392989,0,167,57,28,0,57
163593,2023-09-04 21:44:35,1230397002,1710,4,4,2,1,3
163594,2023-09-04 21:47:01,1230401037,1345,53,66,32,4,62
163594,2023-09-04 21:47:04,1230401068,1345,53,66,32,4,62
163596,2023-09-04 21:54:26,1230414316,12006,187,57,32,2,55
163591,2023-09-04 21:57:48,1230419617,29783,43,65,20,5,60
145083,2023-09-04 22:25:57,1230452102,65614,55,73,66,4,69
163600,2023-09-04 22:26:17,1230452434,30221,50,17,9,7,10
163601,2023-09-04 22:31:00,1230456316,83874,155,28,13,17,11
163604,2023-09-04 22:36:34,1230460758,102874,134,37,14,7,30
163609,2023-09-04 23:03:47,1230482376,9590,42,2,0,2,0
163606,2023-09-04 23:09:47,1230486965,79452,179,47,20,7,40
163611,2023-09-04 23:21:48,1230496059,209724,239,81,41,11,70
163615,2023-09-04 23:35:51,1230509781,177912,24,76,29,2,74
163617,2023-09-04 23:44:51,1230521256,20365,73,52,21,1,51
163619,2023-09-04 23:53:18,1230532373,164754,44,345,82,4,341
163620,2023-09-05 00:00:25,1230539878,91168,221,83,29,12,71
163605,2023-09-05 15:05:16,1230806742,27953,58,13,4,3,10
163605,2023-09-05 15:05:20,1230806777,27953,58,13,4,3,10
163632,2023-09-05 15:31:02,1230820908,12229,203,18,3,9,9
163635,2023-09-05 15:41:59,1230828079,35283,155,33,21,4,29
163638,2023-09-05 15:54:22,1230836434,2096,5,10,7,2,8
163637,2023-09-05 15:54:46,1230836724,2469,12,1,0,1,0
163634,2023-09-05 15:55:10,1230837011,19174,13,17,9,4,13
163633,2023-09-05 15:55:33,1230837287,58884,83,13,6,6,7
163629,2023-09-05 15:56:00,1230837626,55415,111,19,10,10,9
163645,2023-09-05 15:57:53,1230838860,5754,35,29,15,2,27
131815,2023-09-05 16:10:53,1230847619,2559,13,25,11,3,22
131638,2023-09-05 16:20:38,1230854692,17814,34,26,24,4,22
131629,2023-09-05 16:24:03,1230857180,12624,96,8,7,3,5
163648,2023-09-05 16:35:56,1230866611,6634,41,4,0,4,0
131599,2023-09-05 16:35:57,1230866618,5552,8,4,3,1,3
163648,2023-09-05 16:35:59,1230866643,6634,41,4,0,4,0
163648,2023-09-05 16:36:02,1230866671,6634,41,4,0,4,0
163649,2023-09-05 16:39:36,1230869447,32536,127,37,25,8,29
163651,2023-09-05 16:51:39,1230879738,14295,37,37,17,3,34
163652,2023-09-05 16:55:03,1230882646,15657,81,111,66,3,108
163653,2023-09-05 16:57:02,1230884399,0,17,49,38,0,49
163654,2023-09-05 17:00:52,1230887726,12390,119,104,41,4,100
163655,2023-09-05 17:16:24,1230901229,0,6,1,0,0,1
128686,2023-09-05 17:19:01,1230903580,8679,70,37,22,4,33
128686,2023-09-05 17:19:07,1230903680,8679,70,37,22,4,33
163670,2023-09-05 17:38:12,1230921060,1378,11,8,8,1,7
163668,2023-09-05 17:38:37,1230921397,40489,65,27,5,5,22
163665,2023-09-05 17:38:59,1230921683,267987,178,40,23,11,29
132076,2023-09-05 17:55:42,1230937202,1697,46,40,16,1,39
132075,2023-09-05 17:56:10,1230937637,37077,46,51,27,2,49
143333,2023-09-05 17:56:43,1230938089,14220,150,34,14,1,33
163667,2023-09-05 18:01:14,1230942326,38068,97,30,6,5,25
163630,2023-09-05 18:35:14,1230973695,127346,178,64,45,7,57
163630,2023-09-05 18:35:16,1230973729,127346,178,64,45,7,57
163630,2023-09-05 18:35:17,1230973731,127346,178,64,45,7,57
142825,2023-09-05 18:48:41,1230986059,392,4,9,1,3,6
142107,2023-09-05 18:49:11,1230986721,0,0,15,3,0,15
142085,2023-09-05 18:49:30,1230987159,54775,63,74,44,2,72
142164,2023-09-05 18:49:48,1230987629,11747,18,35,27,2,33
142212,2023-09-05 18:50:12,1230988083,79024,130,60,47,6,54
142213,2023-09-05 18:50:32,1230988581,71100,123,67,36,3,64
142186,2023-09-05 18:50:58,1230989179,14081,75,26,13,2,24
142184,2023-09-05 18:51:13,1230989637,2076,160,28,16,2,26
163681,2023-09-05 18:58:38,1230999727,88610,176,39,19,10,29
129903,2023-09-05 19:46:02,1231052568,4906,3,11,3,1,10
163689,2023-09-05 19:50:57,1231056791,0,0,1,0,0,1
153857,2023-09-05 20:21:56,1231085438,31113,108,58,42,3,55
100282,2023-09-05 20:22:12,1231085683,29815,163,71,48,6,65
121856,2023-09-05 20:22:37,1231086055,17686,48,86,63,5,81
153795,2023-09-05 20:23:01,1231086355,5765,8,16,8,1,15
163692,2023-09-05 20:32:25,1231095066,101572,98,80,50,7,73
163691,2023-09-05 20:33:30,1231096017,476247,155,26,19,10,16
163690,2023-09-05 20:33:33,1231096076,2229,11,15,1,4,11
163695,2023-09-05 20:42:45,1231104135,4489,38,7,1,3,4
163696,2023-09-05 20:43:03,1231104355,115907,110,35,23,7,28
163697,2023-09-05 20:45:57,1231106672,2990,8,12,11,1,11
163706,2023-09-05 21:07:34,1231125519,6376,61,14,7,2,12
163706,2023-09-05 21:07:35,1231125520,6376,61,14,7,2,12
163706,2023-09-05 21:07:37,1231125542,6376,61,14,7,2,12
163706,2023-09-05 21:07:36,1231125546,6376,61,14,7,2,12
163706,2023-09-05 21:07:38,1231125567,6376,61,14,7,2,12
163706,2023-09-05 21:07:40,1231125604,6376,61,14,7,2,12
163709,2023-09-05 21:11:44,1231129628,0,55,15,3,0,15
163710,2023-09-05 21:13:39,1231131292,5871,63,9,4,2,7
163710,2023-09-05 21:13:41,1231131303,5871,63,9,4,2,7
163710,2023-09-05 21:13:40,1231131304,5871,63,9,4,2,7
163720,2023-09-05 21:15:15,1231132728,43367,197,19,10,3,16
163722,2023-09-05 21:23:45,1231140558,78691,75,71,37,6,65
163723,2023-09-05 21:23:53,1231140702,4582,131,15,3,4,11
163724,2023-09-05 21:38:41,1231154805,64883,334,70,41,11,59
163724,2023-09-05 21:38:44,1231154825,64883,334,70,41,11,59
163725,2023-09-05 21:43:10,1231158668,57834,223,42,26,4,38
163726,2023-09-05 21:43:54,1231159368,87664,107,50,29,8,42
163727,2023-09-05 21:44:39,1231160030,32355,81,25,11,4,21
163729,2023-09-05 21:48:02,1231162998,97722,162,67,53,9,58
163729,2023-09-05 21:48:07,1231163062,97722,162,67,53,9,58
163742,2023-09-05 22:44:55,1231203892,20328,65,28,3,4,24
163752,2023-09-06 14:48:18,1231486118,15947,57,19,5,4,15
163754,2023-09-06 15:16:01,1231499925,180858,242,31,24,5,26
132931,2023-09-06 15:24:04,1231504606,5799,57,20,9,5,15
163756,2023-09-06 15:36:38,1231512559,15637,25,25,11,5,20
163757,2023-09-06 15:36:54,1231512720,19840,25,363,2,1,362
163759,2023-09-06 15:47:49,1231520103,0,0,18,1,0,18
163758,2023-09-06 15:48:14,1231520441,3423,65,24,6,1,23
163760,2023-09-06 15:54:10,1231524537,107152,52,25,17,6,19
163761,2023-09-06 16:07:19,1231533845,16264,62,2,1,1,1
131633,2023-09-06 16:10:35,1231536292,7342,39,19,16,2,17
163762,2023-09-06 16:12:30,1231537733,34720,119,50,28,2,48
163763,2023-09-06 16:15:16,1231539834,29816,95,60,23,4,56
132482,2023-09-06 16:28:14,1231550428,43032,50,91,64,5,86
163764,2023-09-06 16:32:45,1231554105,8784,12,13,3,1,12
163767,2023-09-06 16:40:11,1231560388,4256,3,29,6,2,27
152138,2023-09-06 16:45:25,1231564722,815,86,11,0,2,9
152134,2023-09-06 16:45:53,1231565135,3426,70,11,0,3,8
152065,2023-09-06 16:46:17,1231565472,0,0,1,0,0,1
151961,2023-09-06 16:46:46,1231565859,10064,342,29,17,1,28
151939,2023-09-06 16:47:11,1231566211,10902,45,6,1,1,5
151937,2023-09-06 16:47:34,1231566520,381,47,23,13,3,20
135732,2023-09-06 16:48:34,1231567392,6323,100,34,24,4,30
163777,2023-09-06 17:01:12,1231578062,0,9,30,18,0,30
163788,2023-09-06 17:16:53,1231593343,43929,58,50,34,3,47
145545,2023-09-06 17:26:08,1231602386,11386,0,12,7,1,11
145086,2023-09-06 17:26:29,1231602713,23349,56,31,21,2,29
145419,2023-09-06 17:26:54,1231603092,32124,241,38,7,5,33
145417,2023-09-06 17:27:15,1231603414,109703,95,54,21,13,41
145421,2023-09-06 17:27:40,1231603810,4483,12,13,5,3,10
145080,2023-09-06 17:28:10,1231604330,84470,141,41,29,7,34
145618,2023-09-06 17:28:48,1231604964,14833,39,68,57,2,66
145088,2023-09-06 17:29:12,1231605367,8181,39,37,9,3,34
163765,2023-09-06 17:38:31,1231614824,43706,19,71,18,3,68
163778,2023-09-06 17:41:01,1231617353,108955,380,127,57,6,121
163797,2023-09-06 17:50:09,1231626653,121469,270,21,14,10,11
163799,2023-09-06 18:06:43,1231642926,40544,20,20,5,3,17
163798,2023-09-06 18:17:34,1231653832,12906,77,38,32,2,36
163801,2023-09-06 18:24:06,1231660563,250526,172,62,34,6,56
163803,2023-09-06 18:35:20,1231671807,61057,223,46,34,9,37
163804,2023-09-06 18:39:02,1231675457,18380,158,61,40,5,56
163804,2023-09-06 18:39:06,1231675544,18380,158,61,40,5,56
163806,2023-09-06 18:40:30,1231676964,34264,78,66,24,4,62
163807,2023-09-06 18:44:50,1231681035,14272,117,33,25,3,30
163808,2023-09-06 18:48:35,1231684785,108139,251,73,41,15,58
163809,2023-09-06 19:01:02,1231697381,25913,181,25,13,7,18
163811,2023-09-06 19:05:05,1231701434,15092,181,25,8,9,16
163811,2023-09-06 19:05:10,1231701540,15092,181,25,8,9,16
142223,2023-09-06 19:19:07,1231714655,2659,36,13,4,2,11
163812,2023-09-06 19:19:47,1231715291,683,1,16,11,1,15
142221,2023-09-06 19:20:44,1231716182,150,60,86,31,1,85
142313,2023-09-06 19:21:19,1231716704,3636,31,13,6,3,10
141647,2023-09-06 19:21:47,1231717191,46436,274,39,24,7,32
141638,2023-09-06 19:22:19,1231717736,10373,48,42,32,3,39
163813,2023-09-06 19:26:13,1231721392,111693,490,70,46,26,44
163813,2023-09-06 19:26:14,1231721393,111693,490,70,46,26,44
163813,2023-09-06 19:26:15,1231721416,111693,490,70,46,26,44
163813,2023-09-06 19:26:17,1231721447,111693,490,70,46,26,44
131872,2023-09-06 19:39:00,1231733308,22380,64,52,35,6,46
163816,2023-09-06 20:08:02,1231760428,60418,104,103,14,8,95
163817,2023-09-06 20:15:26,1231767089,0,20,22,18,0,22
163818,2023-09-06 20:20:59,1231771909,22852,70,23,15,3,20
163820,2023-09-06 20:26:00,1231776355,111797,187,210,34,30,180
132189,2023-09-06 20:31:58,1231781735,0,1,16,10,0,16
131874,2023-09-06 20:33:15,1231783035,14607,17,38,17,1,37
131870,2023-09-06 20:33:46,1231783440,40209,304,69,32,6,63
131873,2023-09-06 20:34:09,1231783797,10134,27,110,72,3,107
142458,2023-09-06 20:34:29,1231784093,0,6,34,8,0,34
152778,2023-09-06 20:34:50,1231784376,8027,138,25,10,4,21
163822,2023-09-06 20:35:39,1231785079,2320,18,36,31,1,35
163823,2023-09-06 20:39:24,1231788340,15377,64,28,22,4,24
163824,2023-09-06 20:41:18,1231790200,501,22,9,5,1,8
163825,2023-09-06 20:41:21,1231790241,0,19,4,2,0,4
163826,2023-09-06 20:46:21,1231794588,4998,42,9,3,4,5
163828,2023-09-06 20:53:19,1231800664,986,1,13,3,1,12
163829,2023-09-06 20:58:08,1231804779,47424,72,27,25,2,25
163831,2023-09-06 21:03:13,1231809006,0,25,21,4,0,21
163832,2023-09-06 21:07:39,1231812582,24901,11,6,2,1,5
163836,2023-09-06 21:46:02,1231838956,17736,48,15,9,2,13
163827,2023-09-06 21:59:03,1231851274,5950,84,14,7,2,12
163821,2023-09-06 22:00:21,1231852431,47384,103,21,11,3,18
163835,2023-09-06 22:40:27,1231889718,0,0,4,2,0,4
163834,2023-09-06 22:40:31,1231889768,35217,39,23,8,3,20
163850,2023-09-06 23:11:21,1231919059,36389,34,51,37,5,46
163853,2023-09-06 23:30:59,1231940620,205405,420,76,45,16,60
131614,2023-09-07 15:28:05,1232246267,3571,7,12,5,1,11
134085,2023-09-07 16:10:44,1232275493,36698,64,23,17,4,19
134083,2023-09-07 16:11:44,1232276125,11269,38,55,42,3,52
134086,2023-09-07 16:12:32,1232276761,0,169,89,43,0,89
134089,2023-09-07 16:14:04,1232277919,0,20,28,22,0,28
163866,2023-09-07 16:16:11,1232279502,3918,6,16,10,1,15
163868,2023-09-07 16:19:13,1232281782,21562,65,29,9,3,26
163867,2023-09-07 16:27:56,1232288135,82741,166,159,87,7,152
163869,2023-09-07 16:27:59,1232288164,15380,226,29,18,3,26
134172,2023-09-07 16:29:58,1232289619,4364,20,74,35,1,73
134080,2023-09-07 16:30:46,1232290217,21386,387,48,17,6,42
163870,2023-09-07 16:33:06,1232292820,0,5,15,12,0,15
153431,2023-09-07 16:47:11,1232304372,0,0,5,2,0,5
153343,2023-09-07 16:47:33,1232304650,13378,11,15,9,2,13
153323,2023-09-07 16:47:48,1232304868,14246,14,9,8,2,7
153565,2023-09-07 16:48:01,1232305062,0,0,14,3,0,14
153320,2023-09-07 16:48:18,1232305249,34674,145,107,75,5,102
163871,2023-09-07 16:56:12,1232311421,31430,11,24,14,2,22
163874,2023-09-07 16:59:34,1232314094,20673,84,71,22,13,58
163872,2023-09-07 17:03:08,1232317018,0,2,4,4,0,4
163875,2023-09-07 17:03:24,1232317261,9233,162,5,3,3,2
163877,2023-09-07 17:03:32,1232317342,11006,72,25,14,5,20
153564,2023-09-07 17:14:02,1232326015,11138,10,9,7,2,7
163876,2023-09-07 17:19:54,1232330785,0,1,47,0,0,47
163876,2023-09-07 17:19:59,1232330846,0,1,47,0,0,47
163882,2023-09-07 17:57:47,1232363026,25868,107,5,2,3,2
163881,2023-09-07 18:48:08,1232406172,19157,31,12,7,3,9
163884,2023-09-07 18:48:16,1232406272,44966,55,25,16,6,19
163886,2023-09-07 18:48:27,1232406422,124963,416,130,31,12,118
163887,2023-09-07 18:48:32,1232406509,104479,172,102,64,6,96
163890,2023-09-07 18:48:39,1232406607,58910,57,7,3,3,4
163892,2023-09-07 18:48:53,1232406753,2424,14,106,60,1,105
163899,2023-09-07 18:49:10,1232407026,7103,9,42,22,4,38
163903,2023-09-07 18:57:15,1232414194,9939,156,71,4,2,69
163880,2023-09-07 19:28:07,1232440727,11958,25,34,23,6,28
163906,2023-09-07 19:43:51,1232453524,2164,5,1,0,1,0
163906,2023-09-07 19:43:52,1232453590,2164,5,1,0,1,0
163907,2023-09-07 19:48:37,1232457970,17901,99,44,18,3,41
163908,2023-09-07 20:09:03,1232474568,52224,174,43,27,7,36
163923,2023-09-07 20:29:30,1232491578,8771,31,10,5,3,7
163925,2023-09-07 20:45:37,1232503962,4950,32,2,1,1,1
163925,2023-09-07 20:45:40,1232504012,4950,32,2,1,1,1
163941,2023-09-07 22:23:46,1232578128,13866,38,23,15,3,20
163926,2023-09-07 22:45:20,1232593200,10372,22,20,8,2,18
163942,2023-09-07 22:55:46,1232600252,499,2,39,9,1,38
119486,2023-09-07 23:09:21,1232610020,142104,45,17,8,4,13
163967,2023-09-08 15:53:53,1232945786,3759,41,28,7,2,26
163968,2023-09-08 16:03:44,1232951452,7145,18,10,6,3,7
163969,2023-09-08 16:11:38,1232956349,0,31,5,2,0,5
163970,2023-09-08 16:13:55,1232957717,5536,26,3,3,2,1
163971,2023-09-08 16:21:50,1232962403,1545,10,7,5,1,6
163973,2023-09-08 16:30:17,1232967954,74655,237,20,12,9,11
163983,2023-09-08 16:40:22,1232974694,8263,23,22,15,3,19
163983,2023-09-08 16:40:27,1232974766,8263,23,22,15,3,19
122326,2023-09-08 16:41:21,1232975343,0,45,55,36,0,55
122326,2023-09-08 16:41:23,1232975376,0,45,55,36,0,55
122319,2023-09-08 16:41:43,1232975597,70719,60,40,22,5,35
153704,2023-09-08 16:42:29,1232976092,27838,246,39,29,2,37
122321,2023-09-08 16:43:15,1232976643,26168,257,18,5,5,13
143048,2023-09-08 16:44:20,1232977448,23087,216,53,28,5,48
153705,2023-09-08 16:45:00,1232977886,0,5,9,4,0,9
122320,2023-09-08 16:45:35,1232978270,0,3,30,27,0,30
163964,2023-09-08 16:49:18,1232980890,0,0,15,13,0,15
163972,2023-09-08 16:49:25,1232980978,373678,88,30,8,8,22
163986,2023-09-08 16:49:31,1232981061,587776,484,70,19,21,49
163995,2023-09-08 17:15:48,1233002910,0,0,14,4,0,14
163998,2023-09-08 17:16:36,1233003733,18800,57,14,8,6,8
164000,2023-09-08 17:23:53,1233010958,45377,26,2,2,1,1
164000,2023-09-08 17:23:55,1233011033,45377,26,2,2,1,1
164001,2023-09-08 17:23:55,1233011034,8505,4,3,1,1,2
164002,2023-09-08 17:27:56,1233015266,107830,121,25,8,7,18
122174,2023-09-08 17:52:20,1233041067,63579,184,36,23,5,31
164003,2023-09-08 18:08:49,1233055545,53319,165,43,27,5,38
164003,2023-09-08 18:08:50,1233055555,53319,165,43,27,5,38
164007,2023-09-08 18:24:29,1233068608,199854,383,43,15,22,21
162149,2023-09-08 18:32:05,1233075044,52974,186,46,37,7,39
164008,2023-09-08 18:38:47,1233080878,42322,109,32,23,8,24
133690,2023-09-08 19:11:55,1233109826,600,14,25,16,1,24
133711,2023-09-08 19:25:05,1233121027,0,3,50,32,0,50
133712,2023-09-08 19:31:05,1233126154,5272,10,37,17,1,36
164017,2023-09-08 19:39:39,1233133471,4332,15,15,11,2,13
164024,2023-09-08 20:19:35,1233174349,25747,156,26,17,8,18
163721,2023-09-08 21:08:47,1233216326,4294,35,17,10,4,13
153328,2023-09-08 21:14:27,1233220469,44112,59,38,22,1,37
153014,2023-09-08 21:14:56,1233220829,14328,69,45,26,1,44
153433,2023-09-08 21:15:22,1233221178,0,0,2,0,0,2
153034,2023-09-08 21:15:45,1233221449,0,0,44,30,0,44
153019,2023-09-08 21:16:15,1233221867,3571,30,4,1,2,2
153016,2023-09-08 21:16:39,1233222141,15204,48,29,16,2,27
153449,2023-09-08 21:17:15,1233222594,44783,69,11,5,5,6
143582,2023-09-08 21:17:38,1233222859,473,3,16,8,1,15
153023,2023-09-08 21:17:42,1233222903,16897,3,45,35,2,43
143575,2023-09-08 21:18:56,1233223773,302585,13,79,9,2,77
143495,2023-09-08 21:19:43,1233224368,16283,102,82,31,8,74
143591,2023-09-08 21:20:29,1233224957,123453,285,72,21,19,53
143597,2023-09-08 21:21:05,1233225418,26142,112,51,24,8,43
143576,2023-09-08 21:21:42,1233225874,0,28,31,1,0,31
143657,2023-09-08 21:22:24,1233226478,13929,63,52,11,4,48
142478,2023-09-08 21:24:10,1233227817,0,48,17,7,0,17
142480,2023-09-08 21:24:46,1233228267,1750,1,6,3,1,5
142481,2023-09-08 21:25:22,1233228849,130346,293,56,37,12,44
142471,2023-09-08 21:25:54,1233229274,0,3,37,11,0,37
142751,2023-09-08 21:26:39,1233229824,39739,49,38,29,4,34
133723,2023-09-08 21:37:57,1233237729,0,0,27,19,0,27
164040,2023-09-08 21:47:29,1233244907,4106,5,27,24,1,26
111285,2023-09-08 22:48:50,1233288475,0,7,6,5,0,6
111165,2023-09-08 22:49:19,1233288810,0,11,7,6,0,7
111159,2023-09-08 22:49:39,1233289102,14804,217,16,8,4,12
121000,2023-09-08 22:50:05,1233289431,28176,142,17,9,6,11
134556,2023-09-08 22:50:25,1233289660,19412,108,37,13,4,33
143666,2023-09-08 22:50:47,1233289909,5203,37,11,7,2,9
153855,2023-09-08 22:51:08,1233290144,13254,24,3,2,1,2
164050,2023-09-08 22:51:54,1233290663,175224,124,129,68,11,118
164058,2023-09-09 15:04:57,1233837779,30328,51,56,27,3,53
164059,2023-09-09 15:14:42,1233843681,20786,42,71,42,2,69
164025,2023-09-09 15:29:52,1233850658,3721,25,5,2,1,4
153097,2023-09-09 15:32:40,1233851734,20801,24,45,14,1,44
154383,2023-09-09 16:31:20,1233877083,0,0,1,0,0,1
132077,2023-09-09 16:42:19,1233882591,74898,76,49,39,6,43
164071,2023-09-09 17:24:31,1233904301,0,31,17,6,0,17
164072,2023-09-09 17:29:43,1233907075,19367,44,16,2,4,12
164078,2023-09-11 14:42:42,1234710558,395185,474,128,72,23,105
164053,2023-09-11 15:15:26,1234725828,8155,4,61,23,1,60
164053,2023-09-11 15:15:30,1234725866,8155,4,61,23,1,60
154104,2023-09-11 15:21:23,1234729230,97600,217,29,14,10,19
154101,2023-09-11 15:21:38,1234729390,25556,76,70,38,4,66
154110,2023-09-11 15:22:22,1234729827,31673,36,63,49,4,59
154098,2023-09-11 15:22:24,1234729841,10282,48,45,15,2,43
154102,2023-09-11 15:22:26,1234729869,167289,320,49,33,5,44
154107,2023-09-11 15:22:29,1234729890,47792,72,74,57,4,70
164101,2023-09-12 16:47:33,1235503887,0,3,3,2,0,3
101448,2023-09-12 17:21:27,1235532198,7899,219,100,35,2,98
164178,2023-09-12 17:25:14,1235535467,183572,285,75,57,17,58
164160,2023-09-12 17:25:45,1235535873,5544,109,177,9,1,176
90682,2023-09-12 17:25:48,1235535942,94141,135,40,13,8,32
164175,2023-09-12 17:26:01,1235536109,9289,32,34,26,1,33
91038,2023-09-12 17:28:32,1235538283,79500,196,80,44,8,72
90880,2023-09-12 17:30:09,1235539671,19087,314,167,64,6,161
153307,2023-09-12 17:46:04,1235553713,0,0,1,0,0,1
153279,2023-09-12 17:46:33,1235554191,22055,54,16,8,5,11
153147,2023-09-12 17:46:55,1235554533,9173,8,13,4,3,10
152850,2023-09-12 17:47:25,1235554977,33792,68,93,66,5,88
152849,2023-09-12 17:47:56,1235555459,47879,241,336,41,8,328
152770,2023-09-12 17:48:23,1235555911,14656,145,11,7,2,9
164180,2023-09-12 17:59:09,1235566145,71738,44,39,25,3,36
164181,2023-09-12 18:05:18,1235571795,235,5,15,13,1,14
164182,2023-09-12 18:06:24,1235572804,20420,154,32,18,3,29
164183,2023-09-12 18:07:07,1235573476,13000,89,66,51,4,62
164184,2023-09-12 18:08:03,1235574332,81911,98,44,31,6,38
164187,2023-09-12 18:11:41,1235577835,13639,41,7,4,4,3
164187,2023-09-12 18:11:42,1235577854,13639,41,7,4,4,3
164185,2023-09-12 18:12:25,1235578466,23987,88,30,24,4,26
154074,2023-09-12 18:15:30,1235581574,0,2,21,14,0,21
164118,2023-09-12 18:20:27,1235586141,56272,153,62,8,7,55
164188,2023-09-12 18:23:22,1235588953,128621,232,75,43,16,59
164188,2023-09-12 18:23:28,1235589037,128621,232,75,43,16,59
90746,2023-09-12 18:23:48,1235589380,15357,161,23,2,7,16
91034,2023-09-12 18:25:19,1235590784,43795,45,38,21,3,35
164189,2023-09-12 18:35:11,1235600052,33644,217,31,24,6,25
164189,2023-09-12 18:35:16,1235600134,33644,217,31,24,6,25
164189,2023-09-12 18:35:17,1235600160,33644,217,31,24,6,25
164197,2023-09-12 18:45:45,1235610137,5775,62,13,6,4,9
91342,2023-09-12 18:52:25,1235616538,938,15,23,11,1,22
91342,2023-09-12 18:52:31,1235616617,938,15,23,11,1,22
164213,2023-09-12 19:17:24,1235639821,2426,32,25,14,1,24
164212,2023-09-12 19:17:42,1235640089,6970,38,8,2,3,5
164210,2023-09-12 19:17:59,1235640323,15464,10,28,24,1,27
164202,2023-09-12 19:18:17,1235640590,771,7,23,15,3,20
164225,2023-09-12 20:08:07,1235688179,24684,24,15,6,1,14
164226,2023-09-12 20:42:47,1235718391,56756,222,32,19,7,25
164227,2023-09-12 20:43:33,1235719035,0,0,11,9,0,11
164228,2023-09-12 20:44:31,1235719838,40313,186,25,17,6,19
164230,2023-09-12 20:45:35,1235720820,39043,27,22,15,2,20
164231,2023-09-12 20:52:15,1235726687,30905,23,18,12,1,17
164234,2023-09-12 21:07:04,1235739242,76199,185,49,38,8,41
164238,2023-09-12 21:32:22,1235760122,0,0,2,2,0,2
164119,2023-09-12 21:33:27,1235761008,17427,35,12,6,4,8
164239,2023-09-12 21:40:13,1235766696,44,247,18,9,1,17
164241,2023-09-12 22:20:46,1235798900,19446,113,35,6,4,31
164242,2023-09-12 22:27:36,1235804233,167559,145,57,19,15,42
164244,2023-09-12 22:39:10,1235813196,33644,217,31,24,6,25
164244,2023-09-12 22:39:15,1235813256,33644,217,31,24,6,25
164257,2023-09-12 23:16:14,1235840949,19126,68,8,8,1,7
164268,2023-09-13 00:02:41,1235875438,8985,47,21,9,3,18
133719,2023-09-13 15:04:26,1236104129,16858,158,37,32,4,33
100279,2023-09-13 15:04:54,1236104350,23800,78,33,26,5,28
110560,2023-09-13 15:10:39,1236106923,19172,73,115,88,2,113
110560,2023-09-13 15:10:47,1236106982,19172,73,115,88,2,113
133691,2023-09-13 15:14:20,1236108837,17300,19,30,25,2,28
164288,2023-09-13 15:16:44,1236109995,22214,70,42,27,3,39
133717,2023-09-13 15:18:48,1236111121,3583,45,56,37,3,53
164295,2023-09-13 15:21:20,1236112534,35287,47,17,11,2,15
133885,2023-09-13 15:49:23,1236130266,47989,93,30,18,3,27
143334,2023-09-13 16:01:29,1236138093,57838,62,8,6,2,6
133888,2023-09-13 16:02:00,1236138385,4083,102,52,40,2,50
164299,2023-09-13 16:05:39,1236140744,0,0,1,0,0,1
120977,2023-09-13 16:10:40,1236144325,77416,130,18,13,5,13
120985,2023-09-13 16:11:11,1236144729,85436,174,40,25,4,36
120984,2023-09-13 16:11:45,1236145093,54252,169,94,73,12,82
143697,2023-09-13 16:11:56,1236145230,52825,134,72,24,7,65
120982,2023-09-13 16:12:18,1236145493,1468,8,48,15,1,47
142844,2023-09-13 16:13:00,1236145930,24369,147,28,20,4,24
153904,2023-09-13 16:13:35,1236146324,9046,9,8,4,1,7
133887,2023-09-13 16:16:29,1236148468,0,1,10,4,0,10
142761,2023-09-13 16:55:52,1236179273,0,1,44,20,0,44
142759,2023-09-13 16:56:13,1236179695,31729,131,51,31,3,48
142763,2023-09-13 16:58:49,1236181861,10515,8,37,30,1,36
142762,2023-09-13 16:59:10,1236182131,90424,188,35,23,9,26
142764,2023-09-13 16:59:36,1236182535,45929,50,56,43,2,54
142766,2023-09-13 17:00:00,1236182846,0,0,4,1,0,4
154333,2023-09-13 17:00:26,1236183245,0,5,58,13,0,58
134434,2023-09-13 17:03:23,1236185675,32530,19,83,75,3,80
134693,2023-09-13 17:03:49,1236185960,1769,14,53,26,1,52
134673,2023-09-13 17:04:15,1236186356,11948,102,59,13,2,57
145195,2023-09-13 17:05:53,1236187617,33970,21,38,30,1,37
134675,2023-09-13 17:06:17,1236187952,17084,10,35,28,1,34
164305,2023-09-13 17:15:42,1236195859,55580,147,16,6,8,8
83378,2023-09-13 17:24:51,1236203465,17960,20,27,10,3,24
83378,2023-09-13 17:24:53,1236203499,17960,20,27,10,3,24
106074,2023-09-13 17:26:44,1236205094,15998,142,23,14,2,21
154439,2023-09-13 17:28:18,1236206454,16292,119,53,35,7,46
154438,2023-09-13 17:28:33,1236206682,27693,118,24,14,6,18
154436,2023-09-13 17:29:04,1236207117,4529,50,80,42,2,78
154435,2023-09-13 17:29:31,1236207510,6818,12,7,2,2,5
154437,2023-09-13 18:24:04,1236254208,3230,234,113,47,5,108
142277,2023-09-13 18:44:04,1236271879,7204,33,36,10,2,34
142461,2023-09-13 18:44:59,1236272647,3243,19,27,21,1,26
142278,2023-09-13 18:45:49,1236273349,13939,52,18,14,2,16
142251,2023-09-13 18:47:39,1236274906,1501,28,12,3,2,10
142578,2023-09-13 18:49:36,1236276643,19632,170,104,63,8,96
142587,2023-09-13 18:50:21,1236277292,33734,102,150,63,11,139
142550,2023-09-13 18:51:07,1236277962,6225,43,14,8,1,13
143200,2023-09-13 18:52:03,1236278842,0,0,22,12,0,22
143205,2023-09-13 18:52:45,1236279478,0,0,9,7,0,9
142546,2023-09-13 18:53:33,1236280252,17019,43,62,44,2,60
142864,2023-09-13 18:54:20,1236280930,0,10,66,34,0,66
154669,2023-09-13 18:57:18,1236283439,0,22,14,5,0,14
155116,2023-09-13 18:58:01,1236284042,351,31,78,53,1,77
154794,2023-09-13 18:58:54,1236284840,27456,124,17,7,8,9
154795,2023-09-13 19:03:17,1236288555,9228,175,32,7,4,28
164317,2023-09-13 19:14:28,1236298005,9196,58,10,5,6,4
164358,2023-09-13 21:53:00,1236420642,19198,88,10,4,5,5
164358,2023-09-13 21:53:03,1236420681,19198,88,10,4,5,5
164380,2023-09-13 23:25:00,1236497029,20944,51,26,2,3,23
164379,2023-09-13 23:25:37,1236497573,7748,25,24,12,1,23
164378,2023-09-13 23:26:08,1236498001,900,20,21,16,1,20
164377,2023-09-13 23:26:38,1236498429,0,6,13,0,0,13
164376,2023-09-13 23:27:04,1236498824,1038,12,14,6,1,13
164375,2023-09-13 23:27:29,1236499178,5131,25,63,42,2,61
164373,2023-09-13 23:27:53,1236499546,46462,128,50,27,3,47
164367,2023-09-13 23:28:19,1236499921,877831,648,106,45,30,76
164406,2023-09-14 14:55:25,1236776443,10649,53,63,38,2,61
164404,2023-09-14 14:58:26,1236777794,51037,141,27,15,8,19
164404,2023-09-14 14:58:27,1236777800,51037,141,27,15,8,19
164408,2023-09-14 15:07:11,1236781696,71670,88,13,9,4,9
164409,2023-09-14 15:14:57,1236785345,92407,103,8,3,6,2
164409,2023-09-14 15:15:03,1236785392,92407,103,8,3,6,2
164410,2023-09-14 15:20:08,1236787905,2423,6,6,3,1,5
164411,2023-09-14 15:50:11,1236806133,0,0,1,0,0,1
164414,2023-09-14 15:50:27,1236806298,3109,48,45,14,2,43
164415,2023-09-14 15:50:36,1236806402,50230,163,15,8,5,10
153722,2023-09-14 15:55:34,1236809513,146868,142,25,15,6,19
153722,2023-09-14 15:55:41,1236809617,146868,142,25,15,6,19
153727,2023-09-14 15:56:08,1236809879,24772,71,53,21,5,48
153727,2023-09-14 15:56:12,1236809953,24772,71,53,21,5,48
153731,2023-09-14 15:56:28,1236810170,4429,141,37,5,17,20
153774,2023-09-14 15:56:46,1236810389,60372,209,60,26,5,55
153777,2023-09-14 15:57:15,1236810730,2042,32,26,14,2,24
141700,2023-09-14 16:26:42,1236831758,16353,31,92,18,3,89
152110,2023-09-14 16:27:15,1236832202,1704,6,14,5,1,13
133683,2023-09-14 17:36:24,1236887626,41879,93,57,45,2,55
164445,2023-09-14 17:50:41,1236898820,11359,56,14,8,4,10
142329,2023-09-14 17:56:29,1236903616,25835,41,25,21,5,20
142330,2023-09-14 17:56:53,1236903974,16551,70,8,5,5,3
142894,2023-09-14 17:57:11,1236904187,39506,110,22,14,6,16
142896,2023-09-14 17:57:29,1236904394,22801,44,31,21,5,26
142898,2023-09-14 17:57:46,1236904642,1194,6,10,3,1,9
142945,2023-09-14 17:58:05,1236904947,1194,5,2,0,1,1
164447,2023-09-14 17:59:41,1236906330,1084,3,11,6,1,10
142484,2023-09-14 18:14:55,1236918693,85929,175,196,72,6,190
164450,2023-09-14 18:18:49,1236921807,24064,117,16,8,3,13
164464,2023-09-14 19:42:20,1236989657,38449,313,65,30,6,59
86322,2023-09-14 20:20:37,1237020495,23799,31,98,31,3,95
100394,2023-09-14 20:21:18,1237021033,20163,209,60,37,10,50
87006,2023-09-14 20:22:11,1237021746,30724,71,64,52,5,59
86345,2023-09-14 20:22:53,1237022303,9782,49,34,27,3,31
87007,2023-09-14 20:23:35,1237022823,5739,24,32,23,1,31
164487,2023-09-14 22:13:47,1237104332,36123,98,34,24,6,28
164485,2023-09-14 22:26:00,1237112731,60184,50,34,26,2,32
164489,2023-09-14 22:55:09,1237132425,16682,55,29,13,2,27
164490,2023-09-14 22:55:24,1237132590,46303,64,22,18,5,17
164492,2023-09-14 23:05:50,1237139335,4644,2,17,5,1,16
164473,2023-09-15 14:32:54,1237777353,10769,34,16,7,4,12
164473,2023-09-15 14:32:56,1237777364,10769,34,16,7,4,12
164499,2023-09-15 14:54:35,1237786247,111379,170,37,27,6,31
164499,2023-09-15 14:54:38,1237786271,111379,170,37,27,6,31
164500,2023-09-15 14:58:59,1237788334,19058,41,27,13,4,23
164503,2023-09-15 15:19:08,1237798130,10725,12,1,0,1,0
164504,2023-09-15 15:22:29,1237799892,28078,160,25,8,10,15
164506,2023-09-15 15:40:18,1237810438,45540,196,16,7,6,10
164502,2023-09-15 15:51:37,1237816956,49068,178,55,17,8,47
164505,2023-09-15 15:51:59,1237817244,35672,145,100,68,4,96
164518,2023-09-15 15:52:12,1237817377,23036,6,71,44,2,69
164507,2023-09-15 15:52:29,1237817577,14442,172,42,20,4,38
164507,2023-09-15 15:52:34,1237817654,14442,172,42,20,4,38
164508,2023-09-15 15:52:52,1237817830,4464,61,101,72,4,97
164508,2023-09-15 15:52:57,1237817857,4464,61,101,72,4,97
164517,2023-09-15 15:53:13,1237818067,0,0,8,6,0,8
164517,2023-09-15 15:53:17,1237818143,0,0,8,6,0,8
164519,2023-09-15 15:53:54,1237818500,31658,55,10,5,3,7
164520,2023-09-15 16:01:07,1237822768,51180,141,27,15,8,19
164520,2023-09-15 16:01:08,1237822781,51180,141,27,15,8,19
164521,2023-09-15 16:07:11,1237826383,10769,34,16,7,4,12
164521,2023-09-15 16:07:13,1237826419,10769,34,16,7,4,12
164524,2023-09-15 16:22:28,1237836933,12804,27,9,2,2,7
164524,2023-09-15 16:22:30,1237836936,12804,27,9,2,2,7
164522,2023-09-15 16:22:55,1237837208,39950,242,12,8,3,9
164523,2023-09-15 16:23:44,1237837758,343045,220,28,16,10,18
164523,2023-09-15 16:23:48,1237837806,343045,220,28,16,10,18
164535,2023-09-15 16:36:26,1237846247,1366,4,42,29,1,41
117220,2023-09-15 16:43:41,1237851256,176,14,52,25,2,50
117216,2023-09-15 16:44:01,1237851488,88732,152,102,51,7,95
117214,2023-09-15 16:44:21,1237851730,8679,3,50,44,1,49
117222,2023-09-15 16:44:41,1237852015,36579,89,62,41,4,58
117206,2023-09-15 16:44:59,1237852218,8436,98,29,14,5,24
117223,2023-09-15 16:45:54,1237852881,97569,88,88,52,5,83
164540,2023-09-15 17:05:19,1237866596,0,9,122,72,0,122
151802,2023-09-15 17:08:32,1237868898,8103,39,28,12,2,26
117217,2023-09-15 17:18:34,1237876199,98531,114,81,33,12,69
164543,2023-09-15 17:34:23,1237887600,0,53,32,12,0,32
164564,2023-09-15 19:24:18,1237969904,77026,88,25,7,4,21
164566,2023-09-15 19:44:00,1237984210,1017,18,2,0,1,1
164569,2023-09-15 20:16:10,1238007192,22086,144,21,12,3,18
164596,2023-09-18 14:32:38,1239241480,21530,50,22,9,3,19
164619,2023-09-18 15:33:57,1239272602,58294,50,10,7,3,7
164622,2023-09-18 15:41:51,1239281280,62714,62,31,8,3,28
164625,2023-09-18 15:56:32,1239299256,11343,64,25,15,4,21
164625,2023-09-18 15:56:35,1239299322,11343,64,25,15,4,21
164625,2023-09-18 15:56:38,1239299393,11343,64,25,15,4,21
164567,2023-09-18 16:08:56,1239315972,267,147,43,23,2,41
164568,2023-09-18 16:09:13,1239316286,0,68,35,12,0,35
164570,2023-09-18 16:09:29,1239316618,315626,148,25,11,5,20
164571,2023-09-18 16:09:48,1239316960,47322,144,27,15,7,20
164572,2023-09-18 16:10:14,1239317534,47095,204,49,30,5,44
164573,2023-09-18 16:11:04,1239318653,0,0,4,3,0,4
164604,2023-09-18 16:11:21,1239319041,1660,26,52,34,1,51
164614,2023-09-18 16:12:31,1239320468,36469,586,101,37,6,95
164616,2023-09-18 16:13:28,1239321682,23521,86,9,6,4,5
164620,2023-09-18 16:13:53,1239322111,449400,112,38,22,4,34
164632,2023-09-18 16:28:15,1239337681,33662,121,25,18,7,18
164635,2023-09-18 16:28:32,1239337926,168613,146,33,25,6,27
164565,2023-09-18 16:30:28,1239340196,81908,157,128,88,9,119
164565,2023-09-18 16:30:30,1239340239,81908,157,128,88,9,119
164565,2023-09-18 16:30:33,1239340290,81908,157,128,88,9,119
164637,2023-09-18 16:49:45,1239362596,70583,53,17,3,3,14
164636,2023-09-18 16:51:26,1239364740,2304,76,115,53,1,114
142865,2023-09-18 17:35:07,1239415795,0,4,48,29,0,48
164643,2023-09-18 17:37:21,1239417975,10195,15,10,0,2,8
164644,2023-09-18 17:38:47,1239419353,101004,80,7,6,4,3
128681,2023-09-18 17:51:56,1239431775,72710,105,32,25,3,29
128681,2023-09-18 17:52:03,1239431875,72710,105,32,25,3,29
164645,2023-09-18 17:58:49,1239438025,4947,71,26,26,1,25
164645,2023-09-18 17:58:53,1239438102,4947,71,26,26,1,25
164647,2023-09-18 18:06:05,1239444497,48435,77,23,1,7,16
164648,2023-09-18 18:17:29,1239454577,0,0,3,2,0,3
164649,2023-09-18 18:18:36,1239455587,44288,190,91,40,8,83
164650,2023-09-18 18:21:19,1239458001,4071,13,174,2,1,173
164651,2023-09-18 18:34:27,1239469941,19343,55,35,4,2,33
164654,2023-09-18 18:41:49,1239476431,329563,213,145,23,29,116
153761,2023-09-18 19:05:27,1239497761,8592,62,8,1,1,7
153763,2023-09-18 19:05:48,1239498038,0,12,23,21,0,23
153765,2023-09-18 19:07:51,1239499695,21763,29,15,5,5,10
153830,2023-09-18 19:08:37,1239500374,0,0,9,8,0,9
153961,2023-09-18 19:09:01,1239500721,133429,83,20,12,5,15
164666,2023-09-18 19:34:04,1239521959,0,0,10,6,0,10
164671,2023-09-18 21:16:11,1239614700,44939,106,72,32,8,64
164675,2023-09-18 21:16:26,1239614901,17654,38,12,5,5,7
164676,2023-09-18 21:16:41,1239615099,53108,152,25,15,6,19
164677,2023-09-18 21:16:53,1239615318,122453,246,59,28,10,49
164679,2023-09-18 21:46:52,1239641368,0,0,11,0,0,11
164701,2023-09-18 22:59:39,1239702611,16400,33,10,5,3,7
164722,2023-09-19 14:06:09,1239962932,4947,71,26,26,1,25
142542,2023-09-19 14:23:46,1239968368,0,0,3,2,0,3
142817,2023-09-19 14:24:34,1239968670,24380,189,104,63,3,101
142891,2023-09-19 14:25:15,1239968919,0,8,16,14,0,16
142539,2023-09-19 14:25:55,1239969126,52120,87,55,42,4,51
154485,2023-09-19 14:26:47,1239969432,18596,216,90,44,6,84
143554,2023-09-19 14:59:22,1239983580,47709,204,97,57,11,86
164726,2023-09-19 15:02:40,1239985150,1857,19,3,0,2,1
164709,2023-09-19 15:06:47,1239987145,0,188,21,3,0,21
164730,2023-09-19 15:42:34,1240009676,54587,192,29,22,6,23
133685,2023-09-19 15:45:17,1240011480,0,3,31,26,0,31
134186,2023-09-19 15:49:38,1240014521,44,37,76,34,1,75
164736,2023-09-19 16:49:16,1240062394,10919,120,89,56,3,86
164736,2023-09-19 16:49:21,1240062447,10919,120,89,56,3,86
164749,2023-09-19 17:07:50,1240078119,4030,324,55,33,2,53
164751,2023-09-19 17:14:19,1240083681,28863,111,29,22,3,26
164752,2023-09-19 17:20:16,1240088941,13994,77,21,13,4,17
164753,2023-09-19 17:25:12,1240093423,1349,6,9,1,1,8
164754,2023-09-19 17:26:01,1240094245,37963,100,42,24,5,37
164755,2023-09-19 17:31:58,1240099605,7700,11,26,19,1,25
164757,2023-09-19 17:37:54,1240104780,6664,108,32,26,3,29
164760,2023-09-19 17:51:56,1240118500,51953,210,39,5,5,34
164759,2023-09-19 17:52:16,1240118817,0,0,6,4,0,6
164762,2023-09-19 18:14:06,1240139552,67168,175,51,38,8,43
155073,2023-09-19 18:18:08,1240143370,907,3,50,31,1,49
143524,2023-09-19 18:18:35,1240143818,1529,10,72,66,2,70
143003,2023-09-19 18:18:59,1240144210,76247,18,26,16,3,23
143567,2023-09-19 18:19:15,1240144493,32519,93,49,41,4,45
143510,2023-09-19 18:19:37,1240144841,7802,48,7,3,5,2
143004,2023-09-19 18:19:55,1240145039,73750,16,24,12,2,22
119243,2023-09-19 18:25:53,1240150509,38329,54,26,9,6,20
119216,2023-09-19 18:26:15,1240150883,0,0,3,0,0,3
164784,2023-09-19 19:21:23,1240209174,28549,63,61,46,5,56
164784,2023-09-19 19:21:28,1240209247,28549,63,61,46,5,56
164786,2023-09-19 19:35:53,1240225810,18794,15,25,14,3,22
164790,2023-09-19 19:51:49,1240244340,65538,349,48,40,10,38
164790,2023-09-19 19:51:53,1240244418,65538,349,48,40,10,38
164791,2023-09-19 20:00:03,1240253735,47580,265,32,14,12,20
164791,2023-09-19 20:00:06,1240253823,47580,265,32,14,12,20
164791,2023-09-19 20:00:09,1240253877,47580,265,32,14,12,20
164795,2023-09-19 21:05:56,1240325800,46859,241,39,17,9,30
164800,2023-09-19 21:22:27,1240343627,35421,42,26,17,5,21
164816,2023-09-19 22:18:15,1240402678,53867,208,43,16,10,33
164816,2023-09-19 22:18:20,1240402776,53867,208,43,16,10,33
164817,2023-09-19 22:42:44,1240428327,6640,50,4,1,3,1
164817,2023-09-19 22:42:50,1240428412,6640,50,4,1,3,1
164818,2023-09-19 22:49:31,1240435508,0,0,2,2,0,2
164819,2023-09-19 22:53:57,1240439956,41805,124,74,46,5,69
164828,2023-09-20 14:47:40,1240855648,34123,36,48,38,2,46
164828,2023-09-20 14:47:46,1240855686,34123,36,48,38,2,46
164829,2023-09-20 15:04:02,1240863631,54939,63,42,35,4,38
164830,2023-09-20 15:11:45,1240867759,30997,51,57,28,2,55
164830,2023-09-20 15:11:49,1240867790,30997,51,57,28,2,55
164831,2023-09-20 15:31:43,1240880118,20477,91,21,17,4,17
164831,2023-09-20 15:31:44,1240880132,20477,91,21,17,4,17
164833,2023-09-20 15:42:14,1240887100,595794,57,7,1,2,5
164832,2023-09-20 15:42:43,1240887419,0,0,1,0,0,1
164836,2023-09-20 15:52:36,1240894495,52525,297,36,15,5,31
164835,2023-09-20 15:52:57,1240894760,0,46,44,6,0,44
164834,2023-09-20 15:54:38,1240895963,50589,25,12,6,1,11
164848,2023-09-20 16:04:33,1240903397,47373,221,18,13,5,13
164850,2023-09-20 16:12:20,1240909355,1478,30,49,5,1,48
164851,2023-09-20 16:17:38,1240913498,60805,83,29,8,4,25
146741,2023-09-20 16:33:24,1240926333,49911,67,33,28,2,31
146745,2023-09-20 16:33:45,1240926623,6862,103,32,20,6,26
147003,2023-09-20 16:34:24,1240927172,1603,55,30,24,1,29
147050,2023-09-20 16:34:45,1240927487,5185,14,11,8,1,10
164853,2023-09-20 16:38:33,1240930776,9611,10,5,2,2,3
146749,2023-09-20 17:14:24,1240960799,25241,34,55,44,2,53
164867,2023-09-20 17:20:01,1240965586,373465,343,42,32,11,31
164273,2023-09-20 17:43:20,1240986310,11351,402,141,21,33,108
164897,2023-09-20 18:35:31,1241036232,7178,108,45,25,5,40
164899,2023-09-20 18:58:15,1241057146,67387,126,14,7,7,7
164900,2023-09-20 19:07:17,1241065107,20829,35,4,2,3,1
164902,2023-09-20 19:15:37,1241072448,26829,71,20,4,4,16
164903,2023-09-20 19:16:31,1241073202,551848,119,19,4,8,11
164901,2023-09-20 19:16:45,1241073386,0,24,1,1,0,1
164911,2023-09-20 19:23:53,1241079530,101254,300,99,28,13,86
88539,2023-09-20 19:35:55,1241089852,133963,15,6,3,1,5
88583,2023-09-20 19:36:16,1241090140,133963,16,7,5,1,6
88547,2023-09-20 19:37:23,1241091446,134221,23,39,17,3,36
88541,2023-09-20 19:37:42,1241091719,142198,208,19,7,2,17
145183,2023-09-20 19:38:00,1241091931,0,0,21,15,0,21
144876,2023-09-20 19:39:47,1241093387,0,0,2,0,0,2
164913,2023-09-20 20:06:37,1241116835,29381,63,12,4,3,9
164914,2023-09-20 20:19:57,1241128534,9537,21,2,2,1,1
164916,2023-09-20 20:25:58,1241133660,88955,437,58,10,12,46
164919,2023-09-20 20:37:20,1241143404,10548,26,43,13,3,40
164921,2023-09-20 20:50:32,1241154393,27129,43,10,5,5,5
164923,2023-09-20 21:05:22,1241166344,10375,29,11,5,3,8
164927,2023-09-20 21:14:16,1241174414,0,0,3,2,0,3
164930,2023-09-20 21:55:32,1241208613,9574,29,42,27,2,40
164931,2023-09-20 22:19:07,1241226974,22119,54,8,5,4,4
164943,2023-09-21 00:00:22,1241301357,62430,105,21,12,11,10
164944,2023-09-21 00:06:25,1241305516,53274,326,114,31,12,102
164945,2023-09-21 00:17:20,1241312757,37854,24,6,3,1,5
164957,2023-09-21 14:59:00,1241506970,76337,158,90,54,10,80
164957,2023-09-21 14:59:04,1241507020,76337,158,90,54,10,80
144088,2023-09-21 15:08:52,1241511295,0,12,10,7,0,10
164958,2023-09-21 15:09:45,1241511663,51696,104,17,5,3,14
164969,2023-09-21 15:42:57,1241534679,8772,0,13,13,1,12
164969,2023-09-21 15:43:00,1241534716,8772,0,13,13,1,12
164969,2023-09-21 15:43:03,1241534757,8772,0,13,13,1,12
164970,2023-09-21 15:50:00,1241539732,41805,124,74,46,5,69
164971,2023-09-21 15:50:13,1241539906,7280,26,69,49,1,68
146001,2023-09-21 15:54:02,1241542686,162408,219,105,30,5,100
164972,2023-09-21 15:56:00,1241544143,20477,91,21,17,4,17
164980,2023-09-21 16:07:12,1241552095,5531,50,5,2,4,1
164993,2023-09-21 17:22:16,1241611780,12698,93,15,8,4,11
164997,2023-09-21 18:21:54,1241660320,241690,167,25,13,12,13
165005,2023-09-21 18:38:05,1241674215,684,4,21,13,2,19
165005,2023-09-21 18:38:06,1241674234,684,4,21,13,2,19
165006,2023-09-21 18:40:24,1241676210,1031,91,7,0,1,6
165007,2023-09-21 18:49:04,1241683974,62776,83,24,7,6,18
165008,2023-09-21 18:49:40,1241684551,0,0,6,5,0,6
165009,2023-09-21 18:54:22,1241688765,64425,173,11,4,9,2
165010,2023-09-21 18:58:04,1241691965,101873,160,17,7,5,12
134432,2023-09-21 19:39:50,1241727943,0,0,94,40,0,94
165026,2023-09-21 20:02:33,1241747679,1165,29,69,44,1,68
165027,2023-09-21 20:35:04,1241776825,197570,154,44,29,10,34
165029,2023-09-21 20:35:48,1241777566,34869,39,12,9,4,8
165039,2023-09-21 21:06:18,1241809271,11898,35,68,28,4,64
165039,2023-09-21 21:06:19,1241809295,11898,35,68,28,4,64
165039,2023-09-21 21:06:22,1241809338,11898,35,68,28,4,64
165039,2023-09-21 21:06:23,1241809380,11898,35,68,28,4,64
165040,2023-09-21 21:18:13,1241821183,1888,18,43,14,2,41
165041,2023-09-21 21:30:34,1241833102,68531,118,21,20,4,17
165046,2023-09-21 21:44:57,1241847136,0,15,28,6,0,28
165047,2023-09-21 21:50:22,1241852697,12912,29,13,5,2,11
141475,2023-09-21 22:16:34,1241878971,28899,19,33,27,1,32
98940,2023-09-21 22:17:05,1241879537,36952,412,59,24,5,54
165048,2023-09-21 22:17:09,1241879617,44784,81,30,23,4,26
165051,2023-09-21 22:41:08,1241903943,0,1,1,0,0,1
165052,2023-09-21 22:46:27,1241909063,632,3,7,5,1,6
165056,2023-09-21 23:06:58,1241928508,41907,100,7,1,3,4
165057,2023-09-21 23:10:41,1241931923,37394,46,25,13,6,19
164946,2023-09-21 23:15:15,1241935972,143937,80,20,6,5,15
165053,2023-09-21 23:15:39,1241936330,34040,105,16,10,3,13
165055,2023-09-21 23:15:46,1241936410,240675,101,37,16,9,28
165058,2023-09-21 23:15:55,1241936543,78329,134,82,69,3,79
165054,2023-09-21 23:17:40,1241937937,7890,9,7,4,1,6
165059,2023-09-21 23:17:52,1241938099,32223,12,7,2,3,4
165075,2023-09-22 14:55:32,1242230032,46105,86,25,15,6,19
165074,2023-09-22 14:55:57,1242230242,131679,134,39,17,8,31
165082,2023-09-22 15:09:41,1242236661,0,0,35,26,0,35
165090,2023-09-22 15:18:21,1242241259,7968,48,13,3,1,12
165091,2023-09-22 15:31:27,1242249332,684,4,21,13,2,19
164876,2023-09-22 15:31:28,1242249359,0,0,2,2,0,2
165093,2023-09-22 15:31:58,1242249616,11898,35,68,28,4,64
164877,2023-09-22 16:22:31,1242288514,62510,127,42,32,7,35
164886,2023-09-22 16:25:11,1242291091,0,0,4,2,0,4
164994,2023-09-22 16:55:06,1242322031,90398,149,77,23,11,66
165098,2023-09-22 16:56:58,1242323984,11658,18,24,3,1,23
165106,2023-09-22 17:42:36,1242372981,29540,148,11,7,3,8
165103,2023-09-22 17:43:08,1242373508,74886,94,22,9,4,18
165102,2023-09-22 17:43:43,1242374148,46156,61,20,5,4,16
165101,2023-09-22 17:44:21,1242374842,70729,70,38,25,3,35
165099,2023-09-22 17:45:33,1242376067,32689,112,69,42,8,61
165097,2023-09-22 17:46:00,1242376540,44141,142,38,18,6,32
165109,2023-09-22 18:06:39,1242398665,1031,91,7,0,1,6
165111,2023-09-22 18:27:33,1242420604,77647,279,101,31,9,92
165112,2023-09-22 18:46:24,1242440522,147678,171,28,13,7,21
165112,2023-09-22 18:46:26,1242440543,147678,171,28,13,7,21
142353,2023-09-22 19:29:58,1242484337,24953,21,60,40,4,56
142353,2023-09-22 19:30:01,1242484387,24953,21,60,40,4,56
144006,2023-09-22 19:30:26,1242484814,0,6,5,1,0,5
144378,2023-09-22 19:31:10,1242485551,30176,190,55,40,3,52
154717,2023-09-22 19:31:31,1242485948,24921,27,29,10,2,27
165122,2023-09-22 20:26:25,1242544081,5132,40,26,7,2,24
165050,2023-09-22 21:09:26,1242591740,53683,335,51,25,13,38
165050,2023-09-22 21:09:31,1242591825,53683,335,51,25,13,38
165125,2023-09-22 22:19:03,1242665058,5850,92,14,5,1,13
154837,2023-09-22 22:55:38,1242700423,105,187,88,57,1,87
154824,2023-09-22 22:56:13,1242700974,0,1,6,0,0,6
154822,2023-09-22 22:56:39,1242701413,24641,165,100,58,5,95
154821,2023-09-22 22:57:06,1242701839,13846,207,90,53,2,88
154812,2023-09-22 22:57:31,1242702237,12028,27,6,4,3,3
165134,2023-09-22 23:34:21,1242736827,60940,82,16,5,3,13
165135,2023-09-22 23:40:47,1242742775,0,0,8,4,0,8
165136,2023-09-22 23:45:32,1242747168,2723,31,33,23,1,32
165137,2023-09-22 23:52:07,1242753376,100917,421,135,65,14,121
165138,2023-09-23 00:07:19,1242767142,31184,62,63,43,6,57
165139,2023-09-23 00:12:41,1242771778,15721,70,35,21,7,28
165140,2023-09-23 00:18:19,1242776503,13336,124,135,44,7,128
165141,2023-09-23 14:59:30,1243991043,15882,81,77,59,4,73
165149,2023-09-23 15:29:01,1244057039,8888,58,18,13,4,14
165151,2023-09-23 15:35:39,1244065273,22806,16,18,9,2,16
165150,2023-09-23 15:40:06,1244070815,42502,74,27,16,6,21
165152,2023-09-23 15:40:12,1244070942,3150,6,20,1,1,19
165153,2023-09-23 15:41:51,1244073237,6192,67,1,1,1,0
165154,2023-09-23 15:48:56,1244082603,30881,48,38,23,5,33
164996,2023-09-23 15:50:15,1244084169,90168,187,43,22,8,35
165155,2023-09-23 15:58:37,1244107503,13174,89,31,3,9,22
165156,2023-09-23 16:06:13,1244123648,85603,131,26,6,7,19
165157,2023-09-23 16:11:08,1244133731,4450,32,31,18,2,29
164866,2023-09-23 16:17:47,1244147396,0,0,3,0,0,3
165158,2023-09-23 16:21:58,1244155973,26738,47,16,3,6,10
165159,2023-09-23 16:31:30,1244172087,4007,46,105,44,4,101
165161,2023-09-23 16:40:53,1244189936,98023,80,21,15,4,17
165162,2023-09-23 16:50:27,1244197526,143909,159,52,28,7,45
165162,2023-09-23 16:50:29,1244197555,143909,159,52,28,7,45
165164,2023-09-23 16:58:30,1244201756,0,2,7,1,0,7
165163,2023-09-23 16:58:52,1244201962,325367,328,49,33,12,37
165160,2023-09-23 16:59:12,1244202143,58724,333,33,10,8,25
165167,2023-09-23 17:26:09,1244241123,24701,55,34,22,8,26
165167,2023-09-23 17:26:15,1244241256,24701,55,34,22,8,26
165166,2023-09-23 17:26:35,1244241854,17741,115,15,5,5,10
165165,2023-09-23 17:26:52,1244242429,17761,314,24,16,6,18
165168,2023-09-23 17:48:58,1244283397,30066,300,63,20,5,58
165169,2023-09-23 17:49:42,1244284697,1912,38,34,21,5,29
165170,2023-09-23 17:55:04,1244294985,0,0,4,3,0,4
165171,2023-09-23 17:56:38,1244298050,1285,150,38,23,3,35
165185,2023-09-25 14:31:41,1245329494,25932,30,8,4,6,2
165186,2023-09-25 14:37:28,1245332053,1441461,306,82,18,19,63
143507,2023-09-25 14:58:30,1245346002,18301,151,36,23,4,32
143530,2023-09-25 14:58:57,1245346476,142,121,58,29,1,57
143620,2023-09-25 14:59:20,1245346901,6573,41,46,18,3,43
143550,2023-09-25 14:59:45,1245347377,3199,22,37,18,2,35
143508,2023-09-25 15:00:12,1245347873,7700,45,35,15,1,34
165200,2023-09-25 16:30:38,1245466209,35800,93,78,12,7,71
165225,2023-09-25 16:57:53,1245507612,35882,23,40,23,2,38
165220,2023-09-25 17:05:22,1245519020,23873,65,56,50,4,52
165221,2023-09-25 17:05:45,1245519634,80738,26,24,20,3,21
165226,2023-09-25 17:05:49,1245519738,172414,215,51,49,7,44
165227,2023-09-25 17:05:52,1245519816,77530,65,30,27,4,26
145823,2023-09-25 17:55:44,1245591145,25441,58,69,39,4,65
145823,2023-09-25 17:55:46,1245591205,25441,58,69,39,4,65
145824,2023-09-25 17:56:12,1245591667,0,0,3,0,0,3
145824,2023-09-25 17:56:14,1245591712,0,0,3,0,0,3
146289,2023-09-25 17:56:39,1245592070,174563,87,313,96,7,306
146289,2023-09-25 17:56:42,1245592126,174563,87,313,96,7,306
146289,2023-09-25 17:56:45,1245592156,174563,87,313,96,7,306
146290,2023-09-25 17:57:04,1245592496,30061,228,29,19,4,25
145822,2023-09-25 17:57:27,1245592807,825,20,169,92,1,168
145822,2023-09-25 17:57:29,1245592845,825,20,169,92,1,168
145812,2023-09-25 17:57:55,1245593224,9951,59,62,41,3,59
165236,2023-09-25 17:57:54,1245593253,12090,5,12,2,2,10
145812,2023-09-25 17:57:56,1245593255,9951,59,62,41,3,59
145812,2023-09-25 17:57:59,1245593296,9951,59,62,41,3,59
165237,2023-09-25 18:00:17,1245595476,83214,109,29,19,5,24
165234,2023-09-25 19:05:49,1245676353,57973,92,81,65,3,78
165234,2023-09-25 19:05:51,1245676396,57973,92,81,65,3,78
165234,2023-09-25 19:05:55,1245676506,57973,92,81,65,3,78
165247,2023-09-25 19:41:29,1245721645,0,1,8,6,0,8
165240,2023-09-25 19:41:50,1245721917,14613,19,50,30,2,48
165248,2023-09-25 19:46:06,1245725549,8375,29,45,11,2,43
165249,2023-09-25 21:08:50,1245793258,0,0,2,1,0,2
84751,2023-09-25 21:16:36,1245799171,54907,341,41,21,7,34
165257,2023-09-25 21:27:48,1245807447,10651,8,11,6,1,10
165266,2023-09-25 21:34:33,1245812740,0,2,67,28,0,67
165267,2023-09-25 21:39:23,1245816604,750,26,16,12,1,15
165268,2023-09-25 21:46:20,1245822074,0,0,17,0,0,17
165269,2023-09-25 21:54:50,1245828643,0,0,7,1,0,7
165271,2023-09-25 22:00:18,1245832708,171846,107,40,16,6,34
165274,2023-09-25 22:09:00,1245839194,85944,25,16,8,3,13
165275,2023-09-25 22:12:38,1245841789,0,122,4,1,0,4
165290,2023-09-25 23:19:17,1245890511,7359,45,17,6,5,12
165292,2023-09-25 23:21:39,1245892133,17617,28,42,20,1,41
165288,2023-09-25 23:22:00,1245892344,85243,280,264,13,14,250
165293,2023-09-25 23:33:12,1245900675,0,4,32,16,0,32
165295,2023-09-25 23:39:24,1245904991,0,169,12,4,0,12
165296,2023-09-25 23:46:15,1245910064,0,4,27,12,0,27
165308,2023-09-26 15:16:33,1246312981,22675,121,14,10,5,9
165309,2023-09-26 15:17:14,1246313369,0,7,9,7,0,9
165310,2023-09-26 15:25:16,1246317931,68648,218,29,13,4,25
165311,2023-09-26 15:28:33,1246319773,9282,350,30,9,6,24
165298,2023-09-26 15:29:33,1246320287,141596,108,91,50,6,85
165316,2023-09-26 16:03:52,1246342016,26206,37,49,19,6,43
154879,2023-09-26 16:12:28,1246347985,0,1,36,25,0,36
165318,2023-09-26 16:14:41,1246349598,9742,0,32,10,2,30
132765,2023-09-26 16:18:35,1246352401,0,0,11,0,0,11
165197,2023-09-26 16:29:10,1246360329,161024,276,96,70,15,81
165321,2023-09-26 16:48:56,1246375495,2894,11,1,1,1,0
165325,2023-09-26 17:57:06,1246431613,57625,111,12,10,4,8
165328,2023-09-26 17:57:36,1246432023,163217,180,71,54,6,65
165328,2023-09-26 17:57:40,1246432071,163217,180,71,54,6,65
165330,2023-09-26 17:58:11,1246432483,186203,261,57,34,14,43
165332,2023-09-26 18:10:44,1246442654,6444,17,25,10,2,23
165333,2023-09-26 18:24:56,1246454454,32860,46,24,16,4,20
165337,2023-09-26 18:48:27,1246474397,9685,31,22,8,3,19
165339,2023-09-26 19:01:39,1246485109,1888,18,44,14,2,42
165334,2023-09-26 19:01:55,1246485341,0,0,12,6,0,12
165336,2023-09-26 19:02:08,1246485459,3056,8,16,5,1,15
165338,2023-09-26 19:02:19,1246485645,3368,3,2,0,1,1
165340,2023-09-26 19:02:29,1246485735,17033,6,40,23,1,39
165341,2023-09-26 19:10:29,1246491942,0,0,5,2,0,5
132779,2023-09-26 19:22:52,1246502166,316,25,32,29,1,31
165342,2023-09-26 19:25:09,1246504011,101806,219,69,49,15,54
165343,2023-09-26 19:25:56,1246504633,219022,214,53,34,7,46
165344,2023-09-26 19:26:23,1246505045,41809,344,35,23,9,26
165345,2023-09-26 19:26:59,1246505574,5262,118,19,14,4,15
106179,2023-09-26 19:27:27,1246505918,49914,76,44,19,3,41
106179,2023-09-26 19:27:30,1246506004,49914,76,46,20,3,43
165346,2023-09-26 19:36:43,1246513245,50853,103,54,31,5,49
154880,2023-09-26 19:37:29,1246513834,0,0,14,4,0,14
165356,2023-09-26 19:42:44,1246517967,13441,26,11,2,3,8
165354,2023-09-26 19:43:05,1246518265,26884,26,25,3,2,23
155145,2023-09-26 19:49:17,1246523418,55163,53,41,24,5,36
155145,2023-09-26 19:49:21,1246523469,55163,53,41,24,5,36
155145,2023-09-26 19:49:23,1246523478,55163,53,41,24,5,36
155146,2023-09-26 19:58:30,1246532175,6426,22,19,14,2,17
114566,2023-09-26 20:29:34,1246557201,10504,175,63,17,8,55
114564,2023-09-26 20:30:10,1246557707,3586,7,52,8,1,51
114568,2023-09-26 20:30:37,1246558030,873,258,29,8,3,26
115084,2023-09-26 20:31:09,1246558460,975,65,23,10,5,18
136857,2023-09-26 20:31:35,1246558797,5809,18,21,15,3,18
146052,2023-09-26 20:32:00,1246559101,13622,29,17,9,3,14
146323,2023-09-26 20:32:31,1246559528,21839,25,15,2,1,14
100078,2023-09-26 20:47:26,1246571095,639,6,13,10,1,12
165359,2023-09-26 20:51:09,1246573808,19525,28,34,20,6,28
165359,2023-09-26 20:51:14,1246573870,19525,28,34,20,6,28
165360,2023-09-26 20:59:12,1246580089,22141,35,28,16,4,24
165360,2023-09-26 20:59:14,1246580118,22141,35,28,16,4,24
165360,2023-09-26 20:59:15,1246580123,22141,35,28,16,4,24
132766,2023-09-26 21:04:31,1246584237,77635,50,33,30,3,30
165361,2023-09-26 21:11:53,1246589797,0,39,40,27,0,40
165362,2023-09-26 21:12:21,1246590227,27797,118,50,35,6,44
165362,2023-09-26 21:12:23,1246590246,27797,118,50,35,6,44
132767,2023-09-26 21:13:05,1246590754,2436,169,33,23,1,32
165365,2023-09-26 21:35:08,1246607764,0,1,10,6,0,10
165367,2023-09-26 21:43:23,1246614305,7554,139,39,26,2,37
165369,2023-09-26 21:47:58,1246617817,8080,2,36,11,1,35
165370,2023-09-26 21:48:03,1246617882,1497,8,13,8,1,12
165373,2023-09-26 22:12:45,1246636705,76214,198,67,40,7,60
165372,2023-09-26 22:13:17,1246637061,186423,118,53,32,3,50
165371,2023-09-26 22:13:54,1246637479,3981,57,23,17,2,21
165368,2023-09-26 22:14:38,1246638029,56835,72,21,9,2,19
165366,2023-09-26 22:15:18,1246638482,224640,255,98,29,21,77
132777,2023-09-26 22:15:17,1246638487,197,127,32,20,1,31
165389,2023-09-26 22:38:21,1246655898,0,0,4,2,0,4
134433,2023-09-26 22:42:26,1246659126,1411,17,6,0,3,3
123158,2023-09-26 22:47:35,1246662982,126247,99,51,34,6,45
123173,2023-09-26 23:01:22,1246673195,46013,40,9,5,3,6
123173,2023-09-26 23:01:26,1246673239,46013,40,9,5,3,6
165392,2023-09-26 23:03:29,1246674816,50886,116,122,31,5,117
165423,2023-09-27 13:25:39,1246908101,48965,57,17,2,4,13
165422,2023-09-27 13:26:02,1246908167,0,0,1,0,0,1
165425,2023-09-27 14:41:15,1246929304,51904,56,9,3,3,6
165427,2023-09-27 15:03:53,1246939351,5180,8,24,21,1,23
165427,2023-09-27 15:03:55,1246939371,5180,8,24,21,1,23
144366,2023-09-27 15:45:16,1246963836,25624,378,96,47,8,88
144366,2023-09-27 15:45:22,1246963921,25624,378,96,47,8,88
144368,2023-09-27 15:45:34,1246964057,4233,67,89,41,2,87
144369,2023-09-27 15:45:48,1246964218,4099,60,53,18,2,51
144370,2023-09-27 15:46:05,1246964390,84604,167,81,44,7,74
165429,2023-09-27 16:00:13,1246974196,68139,48,25,15,4,21
165429,2023-09-27 16:00:16,1246974233,68139,48,25,15,4,21
165432,2023-09-27 16:02:04,1246975527,0,6,1,1,0,1
165433,2023-09-27 16:05:36,1246977968,69705,138,104,32,9,95
106189,2023-09-27 16:06:20,1246978433,46306,62,36,20,2,34
143948,2023-09-27 16:15:21,1246985026,22024,195,47,8,4,43
165435,2023-09-27 16:17:38,1246986674,30022,149,109,43,6,103
165434,2023-09-27 16:19:38,1246988094,97097,215,54,25,15,39
165431,2023-09-27 16:24:57,1246992024,52444,206,93,62,9,84
165431,2023-09-27 16:24:58,1246992055,52444,206,93,62,9,84
165431,2023-09-27 16:25:00,1246992098,52444,206,93,62,9,84
155484,2023-09-27 16:32:51,1246997971,6552,35,40,17,2,38
165436,2023-09-27 16:33:34,1246998534,0,156,37,10,0,37
155495,2023-09-27 16:33:48,1246998727,25497,113,89,34,7,82
155504,2023-09-27 16:34:14,1246999083,140100,242,123,44,11,112
165430,2023-09-27 16:34:43,1246999437,77392,129,69,30,6,63
155513,2023-09-27 16:34:48,1246999489,13815,49,76,30,5,71
155519,2023-09-27 16:35:13,1246999855,73556,75,60,21,5,55
155805,2023-09-27 16:36:09,1247000551,117326,176,65,22,13,52
165437,2023-09-27 16:38:02,1247001933,55423,178,44,15,6,38
165438,2023-09-27 16:39:51,1247003313,2074,152,45,19,1,44
165440,2023-09-27 16:41:45,1247004781,11076,107,63,36,2,61
165443,2023-09-27 16:57:15,1247016740,19852,30,21,6,2,19
165442,2023-09-27 16:57:35,1247016966,19217,24,9,2,1,8
165449,2023-09-27 17:08:42,1247026078,0,25,12,5,0,12
165450,2023-09-27 17:09:43,1247026931,180068,309,86,57,15,71
165447,2023-09-27 17:15:52,1247032311,9043,57,6,1,2,4
165452,2023-09-27 17:18:57,1247035006,91640,168,43,25,7,36
165463,2023-09-27 17:37:56,1247053771,6691,15,22,11,2,20
165453,2023-09-27 17:38:29,1247054260,111892,291,29,11,6,23
165464,2023-09-27 17:52:46,1247068033,26323,239,33,24,5,28
165465,2023-09-27 17:57:56,1247073049,0,121,14,11,0,14
165466,2023-09-27 18:04:08,1247079033,22789,216,35,15,2,33
165454,2023-09-27 18:15:14,1247089962,7963,53,54,17,4,50
165467,2023-09-27 18:15:47,1247090576,38676,218,19,16,6,13
154036,2023-09-27 18:25:46,1247100219,6150,17,11,4,3,8
154274,2023-09-27 18:26:32,1247100943,10090,42,34,22,2,32
154197,2023-09-27 18:26:59,1247101355,11840,24,3,2,1,2
154045,2023-09-27 18:27:32,1247101934,649,22,38,6,1,37
154042,2023-09-27 18:28:10,1247102579,14505,34,57,19,3,54
154040,2023-09-27 18:28:33,1247102886,8313,33,15,9,2,13
105401,2023-09-27 18:31:11,1247105373,2027,21,112,74,1,111
120973,2023-09-27 18:32:08,1247106222,17764,297,33,12,3,30
120893,2023-09-27 18:32:38,1247106667,40507,22,48,21,1,47
132704,2023-09-27 18:33:03,1247107066,17292,69,19,10,3,16
145067,2023-09-27 18:33:26,1247107415,0,110,7,4,0,7
145099,2023-09-27 18:33:48,1247107801,0,0,12,10,0,12
165469,2023-09-27 18:58:04,1247131620,3878,230,33,20,1,32
165470,2023-09-27 19:01:56,1247135494,39965,134,15,2,10,5
95297,2023-09-27 19:17:16,1247150223,7108,77,38,22,4,34
95301,2023-09-27 19:17:43,1247150606,715,18,17,7,1,16
95307,2023-09-27 19:18:13,1247151148,0,11,15,11,0,15
95312,2023-09-27 19:18:52,1247151844,7345,26,41,15,2,39
145331,2023-09-27 19:19:22,1247152303,37018,179,26,10,7,19
95311,2023-09-27 19:19:51,1247152768,23660,175,149,13,7,142
95304,2023-09-27 19:20:14,1247153104,9026,137,50,9,4,46
135631,2023-09-27 19:25:29,1247157792,33,439,47,33,2,45
135626,2023-09-27 19:29:25,1247161386,7986,47,45,28,3,42
95313,2023-09-27 19:29:24,1247161392,131850,112,16,4,7,9
95295,2023-09-27 19:30:04,1247161949,715,20,27,11,1,26
106443,2023-09-27 19:30:33,1247162388,5313,54,14,7,4,10
135632,2023-09-27 19:31:56,1247163476,5935,64,74,51,2,72
135628,2023-09-27 19:35:34,1247166600,29663,187,199,87,5,194
143696,2023-09-27 19:43:56,1247174229,0,91,63,34,0,63
165428,2023-09-27 20:05:01,1247193200,4719,94,8,7,1,7
147480,2023-09-27 21:30:39,1247259983,42976,23,6,2,1,5
165510,2023-09-27 22:19:45,1247295523,4060,36,10,2,2,8
165511,2023-09-27 22:26:23,1247300014,54227,71,37,27,7,30
165513,2023-09-27 22:26:36,1247300175,30445,155,49,32,6,43
165514,2023-09-27 22:58:20,1247321887,19135,184,27,17,5,22
153202,2023-09-27 22:58:45,1247322120,35302,116,48,29,8,40
153878,2023-09-27 22:59:15,1247322473,14150,60,10,3,6,4
153678,2023-09-27 22:59:43,1247322781,6207,8,19,4,2,17
153251,2023-09-27 23:00:24,1247323203,4326,35,30,22,3,27
153889,2023-09-27 23:00:57,1247323572,14857,98,31,13,7,24
153248,2023-09-27 23:01:21,1247323829,20876,74,21,8,7,14
165517,2023-09-27 23:06:56,1247327534,49940,82,33,23,6,27
165525,2023-09-27 23:15:52,1247333360,157279,43,35,13,2,33
144375,2023-09-27 23:42:42,1247351580,3236,18,17,12,1,16
165540,2023-09-28 00:15:46,1247372741,3572,12,19,11,2,17
165541,2023-09-28 00:15:55,1247372813,46662,56,26,17,4,22
165554,2023-09-28 15:09:10,1247582487,5686,5,16,6,1,15
165555,2023-09-28 15:14:28,1247585200,0,0,3,1,0,3
165546,2023-09-28 15:14:52,1247585414,7889,94,5,3,2,3
165557,2023-09-28 15:36:47,1247597876,93511,253,50,41,8,42
165557,2023-09-28 15:36:49,1247597901,93511,253,50,41,8,42
165565,2023-09-28 15:37:01,1247598028,250469,223,65,39,9,56
165565,2023-09-28 15:37:02,1247598033,250469,223,65,39,9,56
165568,2023-09-28 15:37:15,1247598211,36027,212,57,45,11,46
165327,2023-09-28 15:47:17,1247604516,117583,255,63,36,17,46
165327,2023-09-28 15:47:19,1247604549,117583,255,63,36,17,46
165569,2023-09-28 15:55:17,1247610008,146634,145,32,21,5,27
165569,2023-09-28 15:55:21,1247610024,146634,145,32,21,5,27
165569,2023-09-28 15:55:22,1247610035,146634,145,32,21,5,27
165569,2023-09-28 15:55:24,1247610050,146634,145,32,21,5,27
165468,2023-09-28 16:47:34,1247660145,49308,12,21,7,1,20
165574,2023-09-28 16:59:23,1247682881,48040,208,227,125,8,219
165574,2023-09-28 16:59:27,1247682997,48040,208,227,125,8,219
165576,2023-09-28 16:59:44,1247683661,22097,46,14,10,4,10
165576,2023-09-28 16:59:46,1247683740,22097,46,14,10,4,10
165577,2023-09-28 16:59:57,1247684008,24313,20,72,58,4,68
165577,2023-09-28 16:59:58,1247684079,24313,20,72,58,4,68
165577,2023-09-28 17:00:00,1247684151,24313,20,72,58,4,68
165578,2023-09-28 17:00:11,1247684483,71917,228,140,106,7,133
165578,2023-09-28 17:00:14,1247684584,71917,228,140,106,7,133
165578,2023-09-28 17:00:16,1247684659,71917,228,140,106,7,133
165579,2023-09-28 17:00:42,1247685451,49863,139,80,56,6,74
165579,2023-09-28 17:00:45,1247685568,49863,139,80,56,6,74
165580,2023-09-28 17:10:28,1247699592,0,1,10,7,0,10
165590,2023-09-28 17:48:55,1247730552,0,0,15,0,0,15
165614,2023-09-28 19:31:36,1247828048,12298,19,7,2,3,4
165623,2023-09-28 20:14:50,1247871475,4704,22,32,5,2,30
165542,2023-09-28 21:12:22,1247928794,33592,129,106,71,7,99
165641,2023-09-28 21:45:52,1247961583,49274,391,63,42,20,43
165642,2023-09-28 21:57:32,1247973227,18399,50,15,8,3,12
154932,2023-09-28 22:02:50,1247978193,0,2,10,6,0,10
155488,2023-09-28 22:03:26,1247978763,993,24,7,5,1,6
165655,2023-09-28 23:39:32,1248066397,20120,193,25,18,8,17
165659,2023-09-29 14:55:29,1248308778,10100,10,5,3,1,4
165665,2023-09-29 15:00:09,1248310525,0,0,3,2,0,3
165667,2023-09-29 15:40:10,1248329505,255274,28,8,3,2,6
109540,2023-09-29 16:28:37,1248358098,36548,59,120,72,3,117
109632,2023-09-29 16:30:25,1248359039,23773,49,69,37,3,66
130209,2023-09-29 16:30:39,1248359185,3986,17,136,61,3,133
109532,2023-09-29 16:30:48,1248359271,90122,177,107,95,4,103
109634,2023-09-29 16:31:31,1248359609,2831,39,11,4,2,9
145969,2023-09-29 16:32:12,1248359982,45929,142,116,62,7,109
143638,2023-09-29 16:35:18,1248361667,3649,9,51,14,2,49
144007,2023-09-29 16:35:38,1248361816,20579,166,58,39,6,52
144003,2023-09-29 16:35:54,1248361947,15730,23,42,31,1,41
143838,2023-09-29 16:36:21,1248362160,33476,16,25,8,2,23
143639,2023-09-29 16:36:38,1248362285,1863,157,38,10,1,37
144001,2023-09-29 16:36:54,1248362401,0,28,3,0,0,3
155337,2023-09-29 16:37:11,1248362567,9847,30,44,6,1,43
165671,2023-09-29 16:49:44,1248368916,12812,70,30,19,2,28
162894,2023-09-29 16:50:06,1248369115,137997,77,142,35,5,137
165673,2023-09-29 17:29:59,1248392017,94457,62,28,17,3,25
165674,2023-09-29 17:30:53,1248392565,150677,1040,119,47,29,90
135629,2023-09-29 18:15:15,1248429364,0,2,87,27,0,87
111617,2023-09-29 18:46:26,1248457577,18048,21,55,49,2,53
111622,2023-09-29 18:46:27,1248457595,122105,75,84,60,5,79
143347,2023-09-29 18:46:33,1248457688,337,15,45,28,1,44
142683,2023-09-29 18:46:44,1248457866,12866,121,17,8,2,15
89317,2023-09-29 21:07:50,1248577388,17122,21,26,12,3,23
89317,2023-09-29 21:07:51,1248577401,17122,21,26,12,3,23
89317,2023-09-29 21:07:55,1248577451,17122,21,26,12,3,23
113897,2023-09-29 21:08:49,1248578111,2477,48,10,6,2,8
113897,2023-09-29 21:08:47,1248578115,2477,48,10,6,2,8
113897,2023-09-29 21:08:50,1248578146,2477,48,10,6,2,8
113897,2023-09-29 21:08:52,1248578158,2477,48,10,6,2,8
113897,2023-09-29 21:08:53,1248578170,2477,48,10,6,2,8
144427,2023-09-29 21:09:37,1248578692,16559,218,96,45,7,89
153568,2023-09-29 21:10:19,1248579157,1627,16,14,5,1,13
155398,2023-09-29 21:11:05,1248579635,47308,107,16,4,8,8
153706,2023-09-29 21:11:50,1248580228,41567,53,40,7,2,38
154892,2023-09-29 22:38:08,1248641312,0,0,34,0,0,34
165753,2023-09-30 00:09:51,1248697586,40480,83,23,14,4,19
165761,2023-09-30 00:54:14,1248721060,109512,56,107,38,8,99
165777,2023-09-30 14:29:50,1248878870,0,0,5,3,0,5
165789,2023-09-30 17:04:07,1248966590,0,0,9,5,0,9
165832,2023-10-02 16:39:48,1249957843,0,0,11,2,0,11
165833,2023-10-02 16:46:39,1249963707,18139,28,26,17,2,24
165834,2023-10-02 16:53:28,1249969311,87357,88,65,43,6,59
165849,2023-10-02 17:02:04,1249976431,0,15,3,0,0,3
165855,2023-10-02 17:15:18,1249985306,48713,33,31,18,2,29
165866,2023-10-02 19:01:43,1250064289,35571,236,66,44,16,50
165866,2023-10-02 19:01:48,1250064335,35571,236,66,44,16,50
165868,2023-10-02 19:38:33,1250094920,22566,79,21,17,3,18
165874,2023-10-02 20:47:56,1250163703,169016,50,45,15,2,43
165875,2023-10-02 21:04:08,1250180460,42868,86,32,23,1,31
165880,2023-10-02 21:48:16,1250224690,2081,7,3,0,1,2
165912,2023-10-03 15:56:09,1250662568,29013,110,89,37,5,84
165922,2023-10-03 16:19:42,1250679074,26675,60,49,8,3,46
165928,2023-10-03 16:38:59,1250694831,2774693,498,146,46,28,118
165926,2023-10-03 16:39:19,1250695181,93568,319,96,66,16,80
165925,2023-10-03 16:39:41,1250695504,46309,57,7,6,3,4
165924,2023-10-03 16:39:58,1250695750,0,2,20,9,0,20
165923,2023-10-03 16:40:21,1250696044,3531,79,60,36,2,58
165921,2023-10-03 16:40:42,1250696356,0,48,36,20,0,36
145180,2023-10-03 16:47:58,1250702514,159910,110,154,29,8,146
165931,2023-10-03 16:56:39,1250710379,73273,239,83,41,6,77
165931,2023-10-03 16:56:42,1250710434,73273,239,83,41,6,77
154960,2023-10-03 17:03:19,1250716478,112357,69,61,27,4,57
165939,2023-10-03 17:07:46,1250720413,317380,150,12,4,11,1
165939,2023-10-03 17:07:48,1250720452,317380,150,12,4,11,1
165914,2023-10-03 17:08:11,1250720793,28070,115,58,36,5,53
165913,2023-10-03 17:08:29,1250721055,31501,73,67,24,2,65
165911,2023-10-03 17:08:56,1250721446,70250,195,57,24,7,50
165909,2023-10-03 17:09:18,1250721846,1230,101,21,17,1,20
165943,2023-10-03 17:22:44,1250733992,2712,9,36,32,1,35
165953,2023-10-03 17:45:34,1250755118,8062,30,38,23,3,35
165951,2023-10-03 17:45:56,1250755435,16752,88,43,10,7,36
165947,2023-10-03 17:46:18,1250755800,89202,20,101,47,2,99
155555,2023-10-03 17:46:39,1250756096,46820,243,62,22,12,50
165954,2023-10-03 18:02:07,1250770726,146611,68,12,5,2,10
165955,2023-10-03 18:05:30,1250774034,104791,105,59,47,6,53
165956,2023-10-03 18:10:45,1250778782,165984,71,27,18,6,21
165958,2023-10-03 18:20:28,1250787878,37770,265,46,25,9,37
165958,2023-10-03 18:20:32,1250787926,37770,265,46,25,9,37
165960,2023-10-03 18:31:41,1250798565,30785,177,61,33,6,55
165960,2023-10-03 18:31:43,1250798630,30785,177,61,33,6,55
165962,2023-10-03 18:39:59,1250806493,144629,27,32,27,3,29
165963,2023-10-03 18:49:32,1250815472,177938,176,36,6,17,19
165964,2023-10-03 18:56:58,1250822459,153108,36,49,5,5,44
165966,2023-10-03 19:35:28,1250858384,68542,73,402,17,13,389
165968,2023-10-03 21:03:15,1250937215,109259,192,33,11,10,23
165969,2023-10-03 21:12:31,1250945747,66574,196,175,14,13,162
165974,2023-10-03 22:22:44,1251006602,23610,33,15,4,3,12
165977,2023-10-03 23:41:59,1251070616,21081,46,31,5,2,29
165978,2023-10-03 23:42:51,1251071291,35688,42,30,22,4,26
165979,2023-10-03 23:44:33,1251072714,6571,29,12,7,2,10
165980,2023-10-03 23:45:04,1251073132,272556,92,20,13,6,14
165981,2023-10-03 23:46:04,1251073944,0,2,7,6,0,7
165982,2023-10-03 23:46:31,1251074302,75918,142,113,8,6,107
165983,2023-10-03 23:47:02,1251074720,16992,6,7,3,2,5
165984,2023-10-03 23:47:30,1251075071,78944,35,181,19,2,179
165973,2023-10-04 15:22:43,1251414275,175201,81,41,29,5,36
165940,2023-10-04 15:33:50,1251421286,59709,44,46,14,4,42
165992,2023-10-04 15:34:29,1251421711,48685,88,45,21,9,36
165919,2023-10-04 15:34:30,1251421731,25674,89,10,2,6,4
122647,2023-10-04 15:55:11,1251435553,185198,76,91,59,4,87
122646,2023-10-04 15:57:00,1251436746,786,211,92,50,1,91
122645,2023-10-04 15:57:34,1251437138,6593,252,99,63,5,94
122643,2023-10-04 15:58:00,1251437409,17489,31,104,69,1,103
142428,2023-10-04 15:58:46,1251437975,0,0,30,16,0,30
165995,2023-10-04 16:05:50,1251442517,70823,307,29,22,13,16
135039,2023-10-04 16:19:59,1251452922,17912,83,118,61,3,115
166002,2023-10-04 16:42:50,1251470679,111737,115,145,95,9,136
166002,2023-10-04 16:42:52,1251470702,111737,115,145,95,9,136
166006,2023-10-04 17:23:30,1251505530,31095,104,86,12,5,81
166012,2023-10-04 18:31:29,1251564978,73470,39,18,6,5,13
166015,2023-10-04 19:14:54,1251604417,48495,248,27,4,13,14
166021,2023-10-04 19:57:40,1251642034,8180,177,8,2,2,6
166030,2023-10-04 21:02:31,1251695430,3154,3,9,6,1,8
166028,2023-10-04 21:02:57,1251695737,170247,83,15,11,4,11
166027,2023-10-04 21:03:20,1251696024,80589,46,46,33,5,41
166026,2023-10-04 21:03:37,1251696257,116591,131,47,39,5,42
166025,2023-10-04 21:04:00,1251696533,8787,1,14,5,1,13
166024,2023-10-04 21:04:22,1251696860,68936,103,32,27,3,29
166023,2023-10-04 21:04:50,1251697235,24487,120,12,8,4,8
166020,2023-10-04 21:05:15,1251697646,12046,56,5,3,2,3
166032,2023-10-04 21:38:39,1251724432,130353,387,250,127,34,216
166032,2023-10-04 21:38:48,1251724518,130353,387,250,127,34,216
166031,2023-10-04 21:39:16,1251724884,21291,45,82,15,3,79
166033,2023-10-04 21:47:55,1251730745,91329,92,28,13,3,25
166036,2023-10-04 22:06:14,1251743340,3755,26,21,17,2,19
166037,2023-10-04 22:12:20,1251747402,23340,77,54,31,6,48
166038,2023-10-04 22:22:02,1251753647,1179331,335,85,33,11,74
166039,2023-10-04 22:22:22,1251753894,82354,81,53,37,3,50
166041,2023-10-04 22:27:20,1251757782,15302,86,20,9,4,16
166056,2023-10-05 14:51:49,1252059844,39796,103,67,38,6,61
166057,2023-10-05 14:58:36,1252062938,76571,167,51,26,14,37
166059,2023-10-05 15:03:56,1252065349,6557,26,10,3,3,7
120188,2023-10-05 15:08:26,1252067386,134470,238,36,17,8,28
120190,2023-10-05 15:08:57,1252067625,0,0,4,2,0,4
120187,2023-10-05 15:09:21,1252067857,3570,12,13,8,2,11
120186,2023-10-05 15:09:43,1252068025,0,0,2,1,0,2
120189,2023-10-05 15:10:10,1252068255,0,0,12,10,0,12
166060,2023-10-05 15:11:24,1252068859,2722,6,32,25,1,31
166061,2023-10-05 15:18:36,1252072366,154370,55,21,7,7,14
135020,2023-10-05 15:23:26,1252074909,0,1,21,14,0,21
154363,2023-10-05 16:12:58,1252105612,5655,72,6,3,1,5
166074,2023-10-05 16:24:36,1252113649,12046,56,5,3,2,3
166075,2023-10-05 16:35:56,1252121435,24487,120,12,8,4,8
166076,2023-10-05 16:45:05,1252127457,142115,175,49,38,7,42
166077,2023-10-05 16:52:00,1252132575,8787,1,14,5,1,13
166078,2023-10-05 16:59:39,1252138341,117594,135,47,39,6,41
166080,2023-10-05 17:12:11,1252147924,171304,84,15,11,5,10
166081,2023-10-05 17:17:46,1252152628,3187,9,33,9,1,32
166094,2023-10-05 18:33:50,1252216241,73154,44,35,26,4,31
166092,2023-10-05 18:38:57,1252220708,8498,63,8,4,2,6
166079,2023-10-05 18:58:18,1252237266,81099,47,47,33,6,41
166079,2023-10-05 18:58:22,1252237340,81099,47,47,33,6,41
166103,2023-10-05 19:11:05,1252247618,135326,196,118,77,12,106
166108,2023-10-05 20:03:43,1252287016,47741,168,58,38,17,41
166109,2023-10-05 20:09:53,1252291541,63530,89,19,16,5,14
143348,2023-10-05 20:12:31,1252293433,559,1,10,5,1,9
166110,2023-10-05 20:15:57,1252295840,21072,134,40,27,8,32
166113,2023-10-05 20:34:50,1252311508,45866,98,40,12,8,32
166115,2023-10-05 20:53:39,1252327229,1613,11,7,6,1,6
166116,2023-10-05 21:08:38,1252338476,30442,63,37,29,4,33
166119,2023-10-05 22:14:21,1252386006,4592,2,26,18,1,25
166123,2023-10-05 22:42:32,1252405869,23712,53,23,12,3,20
166123,2023-10-05 22:42:35,1252405891,23712,53,23,12,3,20
166123,2023-10-05 22:42:36,1252405906,23712,53,23,12,3,20
166123,2023-10-05 22:42:37,1252405922,23712,53,23,12,3,20
166124,2023-10-05 22:59:36,1252417585,55795,60,5,4,4,1
166120,2023-10-05 23:00:40,1252418226,73087,120,12,8,5,7
166121,2023-10-05 23:01:06,1252418495,1951,13,1,0,1,0
166126,2023-10-05 23:01:46,1252418878,12555,46,34,29,3,31
166127,2023-10-05 23:39:50,1252443951,183770,316,103,55,19,84
166130,2023-10-06 00:29:32,1252475803,1090,4,7,2,1,6
166133,2023-10-06 13:42:58,1252716501,25104,143,11,2,6,5
166133,2023-10-06 13:43:03,1252716531,25104,143,11,2,6,5
166132,2023-10-06 13:43:21,1252716608,1845,21,4,0,4,0
166134,2023-10-06 14:12:10,1252723488,677,1,1,1,1,0
166135,2023-10-06 14:20:36,1252725842,12864,74,10,4,4,6
156837,2023-10-06 14:31:57,1252729270,21532,224,64,42,8,56
156850,2023-10-06 14:34:22,1252730041,83348,36,70,43,9,61
166136,2023-10-06 14:34:49,1252730175,11483,31,4,1,1,3
156871,2023-10-06 14:35:15,1252730343,20504,99,31,17,7,24
156863,2023-10-06 14:35:56,1252730546,6026,39,42,7,5,37
156833,2023-10-06 14:36:35,1252730762,27712,75,36,23,5,31
166141,2023-10-06 15:54:01,1252768866,4854,34,79,70,1,78
166142,2023-10-06 15:54:31,1252769169,48421,44,36,11,3,33
145479,2023-10-06 16:19:42,1252785469,20666,29,36,22,4,32
156108,2023-10-06 16:20:12,1252785786,15083,54,28,8,2,26
156884,2023-10-06 16:21:26,1252786571,9876,56,12,6,4,8
155755,2023-10-06 16:22:01,1252786946,58204,7,10,6,1,9
155763,2023-10-06 16:22:37,1252787374,61461,53,32,14,4,28
155762,2023-10-06 16:23:14,1252787801,89808,23,17,13,2,15
156111,2023-10-06 16:23:38,1252788058,117977,248,47,32,7,40
156736,2023-10-06 16:24:02,1252788299,399,122,38,19,1,37
166146,2023-10-06 16:56:54,1252812179,0,8,10,10,0,10
166159,2023-10-06 17:13:36,1252825077,5709,253,137,8,5,132
166160,2023-10-06 17:14:02,1252825445,42078,30,83,34,1,82
166157,2023-10-06 17:14:23,1252825733,18967,228,82,17,3,79
166156,2023-10-06 17:14:44,1252826028,2378,28,71,29,1,70
166155,2023-10-06 17:15:05,1252826295,22581,75,49,16,1,48
166154,2023-10-06 17:15:27,1252826601,221225,195,41,3,7,34
151817,2023-10-06 17:56:16,1252860617,6014,237,16,5,3,13
156151,2023-10-06 17:56:44,1252861008,3960,16,4,2,2,2
156159,2023-10-06 17:57:09,1252861359,235849,141,40,22,13,27
156159,2023-10-06 17:57:15,1252861453,235849,141,40,22,13,27
156247,2023-10-06 17:57:30,1252861681,204384,261,153,40,18,135
156247,2023-10-06 17:57:35,1252861731,204384,261,153,40,18,135
156330,2023-10-06 17:57:49,1252861953,36932,237,80,26,6,74
156365,2023-10-06 17:58:18,1252862392,3455,23,33,16,2,31
156458,2023-10-06 17:58:37,1252862644,11263,16,11,8,2,9
156460,2023-10-06 17:59:20,1252863288,5221,30,37,23,4,33
156834,2023-10-06 17:59:40,1252863576,63493,75,70,52,7,63
156882,2023-10-06 18:00:01,1252863839,62712,103,25,18,3,22
156931,2023-10-06 18:00:24,1252864113,60793,238,17,13,6,11
157057,2023-10-06 18:01:18,1252864865,26561,129,33,28,5,28
157058,2023-10-06 18:01:36,1252865143,24085,122,31,24,9,22
166162,2023-10-06 18:33:48,1252892435,5900,11,14,7,2,12
166165,2023-10-06 19:01:34,1252915828,12142,18,20,9,5,15
166163,2023-10-06 19:01:43,1252916007,82073,216,17,1,7,10
166166,2023-10-06 19:12:10,1252925123,11867,81,8,4,4,4
166166,2023-10-06 19:12:11,1252925126,11867,81,8,4,4,4
166167,2023-10-06 19:25:52,1252936748,86432,110,33,26,6,27
166168,2023-10-06 19:36:37,1252945862,206831,136,36,28,4,32
166174,2023-10-06 21:08:01,1253021638,4112,87,42,16,2,40
166175,2023-10-06 21:10:54,1253023972,0,2,21,15,0,21
166176,2023-10-06 21:26:01,1253034541,66758,86,56,40,6,50
166177,2023-10-06 21:48:06,1253051883,10105,59,26,16,5,21
166178,2023-10-06 22:02:15,1253062880,20064,29,18,7,4,14
166179,2023-10-06 22:07:21,1253066964,0,2,11,7,0,11
166198,2023-10-07 01:03:06,1253182205,40773,170,21,8,6,15
166200,2023-10-07 14:47:20,1253375508,33789,50,45,21,7,38
166201,2023-10-07 14:52:42,1253377080,24234,55,21,5,4,17
166202,2023-10-07 14:58:09,1253378807,18191,57,31,14,5,26
166203,2023-10-07 15:04:56,1253381001,8979,13,23,14,2,21
166205,2023-10-07 15:12:19,1253383539,179533,194,87,37,10,77
166207,2023-10-07 15:21:27,1253387173,1762,5,26,6,1,25
166208,2023-10-07 15:39:46,1253394800,113973,195,55,34,7,48
166209,2023-10-07 16:02:04,1253405141,0,0,23,14,0,23
166180,2023-10-07 16:11:17,1253409461,27155,67,8,6,6,2
166211,2023-10-07 16:55:23,1253432066,109404,67,72,35,6,66
166212,2023-10-07 17:00:51,1253435029,0,35,7,1,0,7
166214,2023-10-07 17:52:33,1253462326,2179,23,44,31,5,39
166223,2023-10-09 14:45:19,1254262680,18945,100,9,2,4,5
166233,2023-10-09 16:09:48,1254306952,70118,173,53,39,11,42
166233,2023-10-09 16:09:54,1254307020,70118,173,53,39,11,42
157587,2023-10-09 16:14:08,1254309875,0,0,4,1,0,4
157509,2023-10-09 16:14:40,1254310210,290931,172,83,33,7,76
157261,2023-10-09 16:14:57,1254310436,2700,2,19,13,1,18
157586,2023-10-09 16:15:18,1254310672,98930,66,47,32,6,41
157527,2023-10-09 16:15:47,1254310989,12403,65,80,56,4,76
145827,2023-10-09 16:34:38,1254324145,14694,108,42,32,2,40
145827,2023-10-09 16:34:41,1254324190,14694,108,42,32,2,40
145828,2023-10-09 16:35:22,1254324683,11585,126,23,9,1,22
146004,2023-10-09 16:35:58,1254325104,26551,246,66,44,4,62
145831,2023-10-09 16:36:25,1254325490,0,0,4,2,0,4
145829,2023-10-09 16:37:06,1254325950,23476,7,7,2,1,6
154897,2023-10-09 16:37:37,1254326274,5469,352,41,16,2,39
166158,2023-10-09 19:20:01,1254456903,19961,45,63,18,4,59
166259,2023-10-09 19:58:57,1254493080,10022,18,58,39,1,57
166260,2023-10-09 20:01:41,1254495315,0,0,5,5,0,5
166261,2023-10-09 20:09:11,1254502603,1412,79,75,8,2,73
166262,2023-10-09 20:14:11,1254508076,785,56,26,13,2,24
166263,2023-10-09 20:21:07,1254515933,42802,101,39,21,3,36
144024,2023-10-09 20:21:26,1254516197,62517,44,31,17,4,27
144098,2023-10-09 20:21:43,1254516420,35574,61,14,6,3,11
144100,2023-10-09 20:22:05,1254516717,6467,15,43,30,2,41
144665,2023-10-09 20:22:19,1254516904,12736,19,25,22,2,23
144021,2023-10-09 20:22:35,1254517120,186992,63,27,20,4,23
166264,2023-10-09 20:27:35,1254521903,0,1,3,0,0,3
154900,2023-10-09 21:59:00,1254597781,0,44,29,20,0,29
154899,2023-10-09 21:59:19,1254598030,0,11,25,22,0,25
154905,2023-10-09 21:59:27,1254598134,0,5,36,30,0,36
124957,2023-10-09 21:59:40,1254598309,1333,24,62,48,2,60
154906,2023-10-09 21:59:46,1254598385,5128,49,60,45,4,56
166307,2023-10-09 22:11:12,1254607124,14084,77,34,20,6,28
166293,2023-10-09 22:23:56,1254616870,6245,8,6,2,2,4
166308,2023-10-09 22:28:09,1254620191,72034,343,64,33,20,44
166310,2023-10-09 22:34:17,1254625037,23843,33,48,20,1,47
166309,2023-10-09 22:34:25,1254625156,72924,195,66,23,11,55
166312,2023-10-09 22:37:09,1254627299,83252,98,20,11,6,14
166313,2023-10-09 22:42:29,1254631468,92,10,61,31,1,60
166326,2023-10-10 13:39:16,1254941805,3224,44,11,4,4,7
166327,2023-10-10 14:13:09,1254949904,111899,208,83,29,24,59
135599,2023-10-10 15:11:16,1254970645,0,53,16,4,0,16
145792,2023-10-10 15:19:22,1254974569,0,25,19,8,0,19
135826,2023-10-10 15:23:54,1254976790,0,0,4,2,0,4
166330,2023-10-10 15:34:14,1254982465,20279,72,48,12,5,43
114752,2023-10-10 16:40:19,1255029914,4245,45,47,11,4,43
114745,2023-10-10 16:41:07,1255030718,2035,41,27,13,2,25
114745,2023-10-10 16:41:11,1255030768,2035,41,27,13,2,25
137404,2023-10-10 16:41:33,1255031155,5008,9,13,8,1,12
137404,2023-10-10 16:41:35,1255031183,5008,9,13,8,1,12
134846,2023-10-10 16:41:55,1255031496,26452,153,163,34,7,156
134846,2023-10-10 16:41:57,1255031553,26452,153,163,34,7,156
147260,2023-10-10 16:54:03,1255042485,0,1,23,21,0,23
147260,2023-10-10 16:54:04,1255042514,0,1,23,21,0,23
147260,2023-10-10 16:54:06,1255042535,0,1,23,21,0,23
147260,2023-10-10 16:54:09,1255042577,0,1,23,21,0,23
147280,2023-10-10 16:54:26,1255042775,0,0,18,17,0,18
147280,2023-10-10 16:54:29,1255042804,0,0,18,17,0,18
155265,2023-10-10 16:55:58,1255043869,53295,122,33,13,7,26
155265,2023-10-10 16:56:00,1255043895,53295,122,33,13,7,26
114755,2023-10-10 16:57:42,1255045096,80029,104,24,18,7,17
114755,2023-10-10 16:57:44,1255045119,80029,104,24,18,7,17
166359,2023-10-10 19:31:32,1255176517,91400,95,21,10,8,13
166367,2023-10-10 20:07:54,1255213652,1281,8,10,8,1,9
156422,2023-10-10 22:09:21,1255312482,15769,90,27,12,5,22
156418,2023-10-10 22:09:46,1255312814,24738,178,30,19,5,25
155867,2023-10-10 22:10:07,1255313091,1980,14,7,5,1,6
155889,2023-10-10 22:10:32,1255313396,28955,432,76,16,8,68
155889,2023-10-10 22:10:35,1255313447,28955,432,76,16,8,68
166384,2023-10-10 22:18:17,1255319224,4806,71,6,5,1,5
135545,2023-10-10 22:20:56,1255321249,0,12,29,18,0,29
166386,2023-10-10 22:27:45,1255326189,90896,108,48,26,12,36
166385,2023-10-10 22:30:18,1255328140,184710,27,5,1,2,3
166387,2023-10-10 22:37:24,1255333510,17012,24,13,8,2,11
166390,2023-10-10 23:08:37,1255358308,22872,393,90,43,33,57
166417,2023-10-11 16:34:51,1255705056,67588,126,39,22,9,30
166419,2023-10-11 16:42:37,1255711837,47557,265,36,17,11,25
166323,2023-10-11 17:16:42,1255737863,1107,27,8,1,3,5
166311,2023-10-11 17:23:26,1255743210,25184,140,80,18,5,75
166430,2023-10-11 17:39:56,1255756636,3945,91,9,6,1,8
166439,2023-10-11 18:15:51,1255786333,5465,13,2,1,1,1
166435,2023-10-11 18:16:19,1255786743,405504,58,12,9,3,9
166431,2023-10-11 18:16:51,1255787175,30699,0,54,9,1,53
166428,2023-10-11 18:17:26,1255787635,17499,33,77,18,3,74
166447,2023-10-11 18:58:08,1255822951,127235,160,75,47,8,67
166447,2023-10-11 18:58:07,1255822967,127235,160,75,47,8,67
166447,2023-10-11 18:58:11,1255823037,127235,160,75,47,8,67
166456,2023-10-11 20:11:24,1255883730,109192,123,42,20,6,36
166457,2023-10-11 20:22:34,1255893260,8957,14,20,9,1,19
166467,2023-10-11 20:41:26,1255908952,0,2,5,3,0,5
166465,2023-10-11 20:44:21,1255911317,20466,164,34,11,5,29
166470,2023-10-11 21:02:34,1255925658,40232,66,78,53,5,73
166470,2023-10-11 21:02:39,1255925717,40232,66,78,53,5,73
166474,2023-10-11 21:31:16,1255947194,0,1,36,20,0,36
166490,2023-10-11 21:43:32,1255957446,2914,11,43,4,1,42
166496,2023-10-11 22:29:46,1255994327,158047,128,69,33,4,65
166493,2023-10-11 22:30:15,1255994699,260,11,6,0,2,4
166492,2023-10-11 22:30:48,1255995119,38592,336,35,13,21,14
166498,2023-10-11 22:39:22,1256001352,98737,166,37,22,9,28
166497,2023-10-11 23:19:17,1256030387,27264,137,17,6,6,11
166497,2023-10-11 23:19:19,1256030418,27264,137,17,6,6,11
166507,2023-10-11 23:19:32,1256030566,5808,8,11,5,1,10
166507,2023-10-11 23:19:34,1256030592,5808,8,11,5,1,10
166508,2023-10-11 23:19:46,1256030732,1110,14,46,19,1,45
166508,2023-10-11 23:19:49,1256030757,1110,14,46,19,1,45
166509,2023-10-11 23:25:02,1256034390,24700,235,25,13,5,20
166509,2023-10-11 23:25:04,1256034426,24700,235,25,13,5,20
118063,2023-10-12 14:18:00,1256292461,2902,40,48,12,5,43
118063,2023-10-12 14:18:02,1256292483,2902,40,48,12,5,43
118063,2023-10-12 14:18:04,1256292497,2902,40,48,12,5,43
166531,2023-10-12 15:03:25,1256310010,18252,166,13,7,6,7
166535,2023-10-12 15:13:53,1256315067,9874,82,12,5,3,9
166535,2023-10-12 15:14:00,1256315108,9874,82,12,5,3,9
166536,2023-10-12 15:22:15,1256319673,4069,12,68,14,2,66
166537,2023-10-12 15:22:20,1256319721,44704,345,102,53,6,96
166537,2023-10-12 15:22:22,1256319741,44704,345,102,53,6,96
166537,2023-10-12 15:22:25,1256319764,44704,345,102,53,6,96
166532,2023-10-12 15:48:40,1256335467,5814,16,6,2,2,4
166540,2023-10-12 15:49:16,1256335843,56319,282,60,36,9,51
166539,2023-10-12 15:49:32,1256336035,37026,153,30,18,10,20
166546,2023-10-12 16:17:15,1256354376,6777,132,20,8,3,17
166544,2023-10-12 16:17:44,1256354702,8073,178,76,39,4,72
166549,2023-10-12 16:40:12,1256371008,98395,161,39,18,5,34
166551,2023-10-12 16:43:07,1256373092,0,66,5,2,0,5
121898,2023-10-12 17:00:15,1256386433,153141,202,104,60,5,99
122171,2023-10-12 17:00:46,1256386788,6625,66,41,17,2,39
121900,2023-10-12 17:01:10,1256387116,0,4,71,38,0,71
121896,2023-10-12 17:01:31,1256387392,20857,19,115,69,2,113
156364,2023-10-12 17:02:09,1256387879,302,94,22,14,1,21
156387,2023-10-12 17:02:31,1256388180,3851,24,4,0,1,3
166554,2023-10-12 17:06:33,1256391272,121156,94,38,27,6,32
166556,2023-10-12 17:23:37,1256404551,3503052,164,29,16,7,22
166558,2023-10-12 17:30:23,1256409704,7541,28,41,29,2,39
166575,2023-10-12 18:55:40,1256479302,65117,204,78,31,7,71
166580,2023-10-12 19:05:15,1256486994,13636,26,13,8,2,11
166582,2023-10-12 19:06:24,1256487917,15563,138,7,2,3,4
166582,2023-10-12 19:06:27,1256487986,15563,138,7,2,3,4
166574,2023-10-12 19:06:43,1256488185,4360,8,19,2,1,18
166547,2023-10-12 19:06:59,1256488395,897,8,49,23,1,48
166542,2023-10-12 19:07:16,1256488634,128333,124,33,19,2,31
166541,2023-10-12 19:09:57,1256490914,98264,147,19,12,4,15
166587,2023-10-12 19:38:40,1256514383,0,0,1,0,0,1
166598,2023-10-12 20:12:46,1256541382,129718,94,17,6,3,14
166598,2023-10-12 20:12:50,1256541440,129718,94,17,6,3,14
166599,2023-10-12 20:39:30,1256561830,29760,48,118,76,5,113
166600,2023-10-12 20:39:50,1256562121,754,8,31,27,1,30
166600,2023-10-12 20:39:54,1256562144,754,8,31,27,1,30
166602,2023-10-12 20:40:03,1256562243,24189,179,73,28,5,68
166602,2023-10-12 20:40:04,1256562282,24189,179,73,28,5,68
166603,2023-10-12 20:40:15,1256562422,186740,184,179,56,14,165
166603,2023-10-12 20:40:17,1256562450,186740,184,179,56,14,165
166603,2023-10-12 20:40:21,1256562476,186740,184,179,56,14,165
166605,2023-10-12 20:40:25,1256562587,7428,25,11,6,2,9
166605,2023-10-12 20:40:28,1256562616,7428,25,11,6,2,9
166605,2023-10-12 20:40:30,1256562654,7428,25,11,6,2,9
166606,2023-10-12 20:43:02,1256564541,13320,20,28,16,2,26
166613,2023-10-12 22:02:54,1256625099,0,1,11,5,0,11
166626,2023-10-12 23:09:21,1256670776,699,11,30,22,1,29
166625,2023-10-12 23:13:17,1256673305,0,3,2,0,0,2
166627,2023-10-12 23:13:47,1256673620,6220,4,1,1,1,0
166628,2023-10-12 23:14:21,1256674009,0,0,1,0,0,1
166629,2023-10-12 23:16:54,1256675588,16655,130,30,17,4,26
166641,2023-10-13 14:34:15,1257231837,1967,24,8,3,2,6
166642,2023-10-13 14:34:52,1257232046,40502,88,38,27,8,30
86639,2023-10-13 14:48:48,1257237403,2052,145,114,73,1,113
86630,2023-10-13 14:50:26,1257238085,0,8,29,26,0,29
147778,2023-10-13 14:51:07,1257238411,6167,279,44,15,5,39
157412,2023-10-13 14:51:43,1257238618,4973,186,48,21,2,46
166645,2023-10-13 15:03:28,1257243681,128759,99,74,19,5,69
166647,2023-10-13 15:29:45,1257256977,72665,225,39,28,10,29
166658,2023-10-13 16:15:55,1257288176,18717,34,7,3,2,5
166658,2023-10-13 16:15:57,1257288201,18717,34,7,3,2,5
166658,2023-10-13 16:16:01,1257288256,18717,34,7,3,2,5
166659,2023-10-13 16:16:46,1257288771,13327,47,38,28,2,36
166659,2023-10-13 16:16:50,1257288833,13327,47,38,28,2,36
166660,2023-10-13 16:17:13,1257289112,16841,87,6,2,4,2
166660,2023-10-13 16:17:15,1257289135,16841,87,6,2,4,2
166662,2023-10-13 16:17:25,1257289245,72318,287,32,19,11,21
166662,2023-10-13 16:17:27,1257289283,72318,287,32,19,11,21
166663,2023-10-13 16:17:46,1257289514,59474,156,50,29,11,39
166663,2023-10-13 16:17:49,1257289578,59474,156,50,29,11,39
166665,2023-10-13 16:18:00,1257289668,3992,34,12,9,3,9
166665,2023-10-13 16:18:03,1257289710,3992,34,12,9,3,9
157132,2023-10-13 16:18:49,1257290112,20660,132,17,5,4,13
166661,2023-10-13 16:20:41,1257291453,0,3,12,9,0,12
166675,2023-10-13 16:34:26,1257301367,16552,25,2,0,1,1
166674,2023-10-13 16:34:48,1257301647,32025,91,49,29,4,45
166666,2023-10-13 16:35:06,1257301854,43569,39,52,27,1,51
166667,2023-10-13 16:35:07,1257301867,6292,15,9,2,3,6
166666,2023-10-13 16:35:09,1257301883,43569,39,52,27,1,51
166667,2023-10-13 16:35:09,1257301908,6292,15,9,2,3,6
166667,2023-10-13 16:35:11,1257301929,6292,15,9,2,3,6
166677,2023-10-13 16:52:46,1257315056,45790,118,33,20,6,27
166676,2023-10-13 16:53:12,1257315341,130727,165,81,51,10,71
166682,2023-10-13 17:13:45,1257331104,86244,187,101,39,7,94
166682,2023-10-13 17:13:52,1257331220,86244,187,101,39,7,94
90077,2023-10-13 17:14:41,1257331876,0,0,5,4,0,5
166689,2023-10-13 17:19:35,1257335658,20253,47,30,8,4,26
166692,2023-10-13 17:26:40,1257341048,22913,30,32,8,5,27
166691,2023-10-13 17:26:38,1257341057,4252,26,42,13,1,41
166687,2023-10-13 17:26:57,1257341292,0,14,29,14,0,29
166693,2023-10-13 17:34:14,1257346865,9818,24,4,0,1,3
166683,2023-10-13 17:43:39,1257354074,179031,167,109,20,11,98
166685,2023-10-13 17:44:02,1257354375,48438,133,13,4,6,7
166688,2023-10-13 17:44:17,1257354607,190709,434,84,38,13,71
166690,2023-10-13 17:44:43,1257354929,154628,50,28,19,2,26
166694,2023-10-13 17:44:59,1257355142,9727,25,13,12,1,12
166695,2023-10-13 17:47:06,1257356765,46820,71,65,28,5,60
166702,2023-10-13 18:47:28,1257408655,28083,64,12,6,5,7
166702,2023-10-13 18:47:32,1257408677,28083,64,12,6,5,7
166703,2023-10-13 18:52:53,1257412835,57814,184,63,18,6,57
166704,2023-10-13 18:57:15,1257416325,82490,56,50,21,2,48
155388,2023-10-13 19:05:43,1257422819,95190,139,18,12,7,11
155387,2023-10-13 19:06:04,1257423100,87967,73,10,5,3,7
155394,2023-10-13 19:06:24,1257423359,51046,75,46,26,5,41
155390,2023-10-13 19:06:43,1257423607,11454,40,37,27,6,31
155433,2023-10-13 19:07:05,1257423871,2842,18,9,7,1,8
155389,2023-10-13 19:07:26,1257424162,3115,59,35,10,3,32
155487,2023-10-13 19:07:47,1257424470,2162,9,13,9,1,12
166705,2023-10-13 19:19:34,1257434086,30630,67,28,16,6,22
166644,2023-10-13 19:27:51,1257440679,8108,141,16,8,3,13
166707,2023-10-13 20:03:25,1257469290,3164,28,16,13,2,14
166708,2023-10-13 20:03:40,1257469504,10182,107,6,0,1,5
166709,2023-10-13 20:03:56,1257469686,27900,260,47,27,5,42
166710,2023-10-13 20:04:26,1257470070,63302,10,5,3,2,3
126410,2023-10-13 21:29:43,1257534105,90891,45,113,68,4,109
126410,2023-10-13 21:29:46,1257534154,90891,45,113,68,4,109
126401,2023-10-13 21:30:57,1257534984,3732,39,70,23,3,67
126451,2023-10-13 21:31:54,1257535634,0,4,26,14,0,26
145946,2023-10-13 21:33:29,1257536890,13066,67,24,8,2,22
145679,2023-10-13 21:38:19,1257540617,4204,13,29,8,1,28
145679,2023-10-13 21:38:21,1257540657,4204,13,29,8,1,28
166732,2023-10-13 23:22:21,1257612599,16719,5,65,29,3,62
166732,2023-10-13 23:22:24,1257612633,16719,5,65,29,3,62
166732,2023-10-13 23:22:27,1257612658,16719,5,65,29,3,62
166732,2023-10-13 23:22:29,1257612670,16719,5,65,29,3,62
166732,2023-10-13 23:22:31,1257612703,16719,5,65,29,3,62
166732,2023-10-13 23:22:32,1257612715,16719,5,65,29,3,62
166732,2023-10-13 23:22:33,1257612725,16719,5,65,29,3,62
166727,2023-10-13 23:27:37,1257615871,3768956,120,19,11,5,14
166728,2023-10-13 23:29:32,1257617016,15610,117,20,7,9,11
166729,2023-10-13 23:29:49,1257617155,187466,154,762,58,8,754
166729,2023-10-13 23:29:54,1257617208,187466,154,762,58,8,754
166733,2023-10-13 23:30:55,1257617855,89515,164,110,70,12,98
166739,2023-10-14 15:01:35,1257832546,0,13,41,22,0,41
166741,2023-10-14 15:11:31,1257835550,19285,43,34,28,3,31
166740,2023-10-14 15:21:01,1257838739,1823,55,40,14,2,38
166740,2023-10-14 15:21:03,1257838768,1823,55,40,14,2,38
166743,2023-10-14 15:21:13,1257838772,47371,280,2014,20,5,2009
166742,2023-10-14 15:21:12,1257838824,71639,129,116,65,8,108
166742,2023-10-14 15:21:14,1257838830,71639,129,116,65,8,108
166744,2023-10-14 15:21:26,1257838889,43913,66,48,28,7,41
166744,2023-10-14 15:21:27,1257838899,43913,66,48,28,7,41
166744,2023-10-14 15:21:31,1257838916,43913,66,48,28,7,41
166745,2023-10-14 16:01:37,1257854804,56035,408,39,17,10,29
126691,2023-10-14 16:10:20,1257858776,3807,104,57,11,1,56
126691,2023-10-14 16:10:25,1257858813,3807,104,57,11,1,56
166749,2023-10-14 16:26:39,1257866309,23535,28,23,20,2,21
166760,2023-10-14 17:07:06,1257891047,4999,24,8,6,2,6
166762,2023-10-14 17:39:15,1257911504,221222,139,99,36,9,90
113717,2023-10-14 17:59:25,1257924909,44827,34,67,15,6,61
113714,2023-10-14 17:59:44,1257925123,32626,126,22,4,3,19
113712,2023-10-14 18:00:09,1257925380,1060,60,29,21,1,28
113724,2023-10-14 18:00:26,1257925517,0,0,7,4,0,7
113722,2023-10-14 18:02:17,1257926693,5995,69,17,2,1,16
113695,2023-10-14 18:02:31,1257926824,106264,377,71,15,13,58
113728,2023-10-14 18:02:51,1257926996,57355,56,26,8,4,22
166765,2023-10-14 18:43:39,1257952738,32685,175,37,16,2,35
166770,2023-10-16 15:00:04,1258741223,156268,109,60,46,7,53
166772,2023-10-16 15:18:07,1258749195,27280,137,73,39,5,68
166772,2023-10-16 15:18:08,1258749220,27280,137,73,39,5,68
166772,2023-10-16 15:18:09,1258749224,27280,137,73,39,5,68
156849,2023-10-16 15:34:02,1258757861,9719,68,43,30,2,41
156851,2023-10-16 15:34:45,1258758273,298,2,38,29,1,37
156876,2023-10-16 15:35:35,1258758771,93903,265,45,29,8,37
156872,2023-10-16 15:36:03,1258759073,70578,71,67,33,4,63
156878,2023-10-16 15:36:30,1258759333,25728,82,41,22,4,37
166783,2023-10-16 16:16:52,1258784886,147558,152,68,34,11,57
166783,2023-10-16 16:16:56,1258784932,147558,152,68,34,11,57
166784,2023-10-16 16:20:02,1258787246,1973,59,85,59,3,82
166786,2023-10-16 17:03:00,1258818543,76299,116,23,5,5,18
166787,2023-10-16 17:03:29,1258818868,42156,332,38,23,3,35
166789,2023-10-16 17:03:58,1258819198,99514,73,8,5,4,4
148676,2023-10-16 17:26:22,1258836453,5247,10,18,16,1,17
166790,2023-10-16 17:27:23,1258837312,18325,51,46,33,3,43
148675,2023-10-16 17:28:30,1258838216,0,0,25,20,0,25
148683,2023-10-16 17:29:03,1258838651,31946,104,55,36,10,45
148682,2023-10-16 17:29:31,1258839042,4335,73,33,20,2,31
148667,2023-10-16 17:30:05,1258839507,16311,105,20,14,5,15
148671,2023-10-16 17:30:25,1258839768,9610,13,4,1,2,2
166792,2023-10-16 17:40:25,1258848051,22129,209,38,28,3,35
166796,2023-10-16 17:47:20,1258853597,17159,176,16,9,2,14
166794,2023-10-16 17:47:47,1258853963,0,0,2,0,0,2
166800,2023-10-16 17:56:45,1258861207,185715,308,124,81,7,117
166804,2023-10-16 18:21:51,1258881564,65324,124,36,2,3,33
166807,2023-10-16 18:33:50,1258890762,17285,185,84,40,4,80
166807,2023-10-16 18:33:57,1258890867,17285,185,84,40,4,80
166806,2023-10-16 18:34:23,1258891242,26470,86,67,31,3,64
166806,2023-10-16 18:34:26,1258891269,26470,86,67,31,3,64
166818,2023-10-16 19:30:30,1258937695,54396,111,39,12,9,30
166821,2023-10-16 19:35:57,1258941990,9092,45,20,10,2,18
166824,2023-10-16 19:48:12,1258951707,21744,51,40,26,4,36
166826,2023-10-16 19:55:47,1258957883,41689,258,45,20,12,33
166827,2023-10-16 19:57:36,1258959230,7590,27,39,12,1,38
166718,2023-10-16 20:10:00,1258971114,191008,97,49,13,6,43
166718,2023-10-16 20:10:02,1258971168,191008,97,49,13,6,43
166718,2023-10-16 20:10:04,1258971234,191008,97,49,13,6,43
166829,2023-10-16 20:10:45,1258972239,72884,109,86,44,13,73
166830,2023-10-16 20:14:39,1258977566,31836,105,50,22,5,45
166831,2023-10-16 20:18:52,1258983281,24965,123,32,20,5,27
166832,2023-10-16 20:25:31,1258992631,33254,50,39,21,4,35
125069,2023-10-16 20:39:16,1259010329,15051,98,31,14,6,25
125069,2023-10-16 20:39:22,1259010482,15051,98,31,14,6,25
140991,2023-10-16 20:39:52,1259011024,7537,53,30,21,2,28
157439,2023-10-16 20:40:13,1259011421,11568,34,20,12,1,19
157440,2023-10-16 20:40:37,1259011808,12685,67,19,8,3,16
157441,2023-10-16 20:41:01,1259012236,19868,53,7,1,2,5
98105,2023-10-16 20:45:24,1259017039,2873,14,11,5,1,10
98131,2023-10-16 20:46:06,1259017800,7610,195,24,19,4,20
98124,2023-10-16 20:47:08,1259018850,1921,41,60,52,2,58
157406,2023-10-16 20:47:25,1259019121,29470,57,8,4,3,5
104464,2023-10-16 20:48:07,1259019901,6269,101,30,18,6,24
166828,2023-10-16 21:16:56,1259050736,90280,53,31,20,2,29
166840,2023-10-16 21:48:18,1259081871,0,9,31,15,0,31
166825,2023-10-16 21:48:55,1259082358,0,8,45,18,0,45
166841,2023-10-16 21:58:05,1259089600,2686,63,5,1,2,3
107986,2023-10-16 22:25:04,1259110037,202448,359,98,46,12,86
116265,2023-10-16 22:25:42,1259110598,80378,56,20,11,3,17
108698,2023-10-16 22:26:32,1259111243,10398,11,6,4,1,5
108698,2023-10-16 22:26:37,1259111273,10398,11,6,4,1,5
108698,2023-10-16 22:26:38,1259111317,10398,11,6,4,1,5
147198,2023-10-16 22:27:08,1259111664,48906,24,6,3,1,5
147198,2023-10-16 22:27:11,1259111730,48906,24,6,3,1,5
147198,2023-10-16 22:27:12,1259111739,48906,24,6,3,1,5
147001,2023-10-16 22:29:47,1259113654,8415,21,11,5,2,9
147001,2023-10-16 22:29:49,1259113686,8415,21,11,5,2,9
107998,2023-10-16 22:30:22,1259114063,65405,211,71,41,5,66
107998,2023-10-16 22:30:26,1259114124,65405,211,71,41,5,66
97219,2023-10-16 22:39:43,1259121082,115919,141,58,16,8,50
134308,2023-10-16 22:40:29,1259121711,9624,218,34,8,4,30
166844,2023-10-16 22:40:54,1259121981,61369,242,62,36,11,51
166844,2023-10-16 22:40:56,1259122023,61369,242,62,36,11,51
97209,2023-10-16 22:41:29,1259122416,63439,72,76,18,3,73
97209,2023-10-16 22:41:33,1259122496,63439,72,76,18,3,73
157745,2023-10-16 22:42:15,1259123113,0,1,6,2,0,6
157745,2023-10-16 22:42:18,1259123157,0,1,6,2,0,6
157745,2023-10-16 22:42:21,1259123194,0,1,6,2,0,6
166854,2023-10-16 23:36:07,1259164641,47371,280,2014,20,5,2009
166856,2023-10-16 23:41:41,1259168776,7541,28,41,29,2,39
166880,2023-10-17 14:14:02,1259383630,102634,48,66,49,4,62
166882,2023-10-17 14:49:35,1259433811,3300,80,25,15,1,24
106672,2023-10-17 15:12:47,1259486092,154620,173,129,71,7,122
116671,2023-10-17 15:13:10,1259486992,16796,197,79,46,5,74
128184,2023-10-17 15:13:41,1259488280,0,14,113,73,0,113
147785,2023-10-17 15:14:03,1259489202,48008,108,34,15,9,25
166888,2023-10-17 15:34:48,1259538810,2141,13,7,5,1,6
166889,2023-10-17 15:40:03,1259551914,4848,44,17,12,2,15
166891,2023-10-17 15:53:27,1259584750,2154,22,33,28,3,30
166895,2023-10-17 16:05:44,1259604386,0,3,2,1,0,2
166893,2023-10-17 16:06:43,1259605852,4420,10,2,1,1,1
166896,2023-10-17 16:07:12,1259606427,0,2,16,14,0,16
166896,2023-10-17 16:07:14,1259606573,0,2,16,14,0,16
131023,2023-10-17 16:09:13,1259609423,2703,31,37,26,2,35
166901,2023-10-17 16:34:16,1259646765,59488,58,111,51,5,106
166905,2023-10-17 16:56:05,1259680010,85590,29,42,31,1,41
166906,2023-10-17 17:00:27,1259686659,48794,175,65,26,5,60
166908,2023-10-17 17:07:21,1259696671,0,3,6,4,0,6
166911,2023-10-17 17:17:52,1259712134,676,185,43,11,4,39
166910,2023-10-17 17:18:26,1259712728,303443,511,195,38,41,154
166910,2023-10-17 17:18:35,1259712815,303443,511,195,38,41,154
166909,2023-10-17 17:18:48,1259713010,237558,214,182,70,13,169
166914,2023-10-17 17:23:17,1259716797,14302,61,28,21,3,25
166912,2023-10-17 17:23:19,1259716820,3907,3,6,2,2,4
166917,2023-10-17 17:26:55,1259719491,12329,114,37,21,1,36
166920,2023-10-17 17:32:51,1259724249,73161,254,58,17,9,49
97213,2023-10-17 17:35:08,1259726250,20548,86,106,25,2,104
97213,2023-10-17 17:35:12,1259726288,20548,86,106,25,2,104
97213,2023-10-17 17:35:15,1259726321,20548,86,106,25,2,104
166925,2023-10-17 17:45:22,1259734358,12656,135,32,9,3,29
166925,2023-10-17 17:45:26,1259734410,12656,135,32,9,3,29
166913,2023-10-17 17:55:52,1259742923,0,0,23,4,0,23
166918,2023-10-17 17:56:12,1259743189,99291,31,60,25,2,58
166921,2023-10-17 17:56:23,1259743338,108981,27,30,26,3,27
166922,2023-10-17 17:56:48,1259743646,1027,1,2,0,1,1
166924,2023-10-17 17:56:54,1259743727,93841,40,16,11,2,14
166926,2023-10-17 17:57:29,1259744161,111012,141,19,12,6,13
95473,2023-10-17 18:52:27,1259788062,82400,74,91,45,3,88
93733,2023-10-17 18:54:08,1259789399,117138,92,44,28,5,39
95748,2023-10-17 18:55:13,1259790255,50091,116,13,2,7,6
95605,2023-10-17 18:56:28,1259791221,1549,13,42,6,1,41
95605,2023-10-17 18:56:31,1259791248,1549,13,42,6,1,41
147887,2023-10-17 18:57:34,1259792072,0,0,2,0,0,2
97264,2023-10-17 19:09:21,1259800989,39566,59,63,27,7,56
166956,2023-10-17 21:49:14,1260011109,0,0,1,0,0,1
166957,2023-10-17 21:53:55,1260017020,20286,156,17,10,7,10
166955,2023-10-17 21:54:55,1260018396,0,0,1,0,0,1
166960,2023-10-17 22:24:49,1260056388,2700,6,28,12,1,27
166959,2023-10-17 22:25:08,1260056795,35773,135,31,28,6,25
166958,2023-10-17 22:25:29,1260057217,5993,28,35,22,2,33
166961,2023-10-17 22:33:26,1260067215,9916,64,16,12,2,14
166962,2023-10-17 22:35:08,1260069444,33973,78,14,12,5,9
166964,2023-10-17 22:43:00,1260079780,6459,14,29,24,2,27
166965,2023-10-17 22:55:48,1260095760,89334,155,36,20,8,28
166969,2023-10-17 23:05:38,1260107300,9847,72,27,3,2,25
166966,2023-10-17 23:07:47,1260109760,27220,135,13,5,4,9
166967,2023-10-17 23:07:49,1260109803,64472,228,29,17,7,22
166970,2023-10-17 23:07:51,1260109848,33540,287,18,4,4,14
166968,2023-10-17 23:46:06,1260140114,55301,34,26,5,4,22
166971,2023-10-17 23:46:32,1260140420,19983,30,47,6,6,41
166972,2023-10-17 23:46:47,1260140612,188052,103,51,37,9,42
166973,2023-10-17 23:47:01,1260140795,0,7,28,15,0,28
166974,2023-10-17 23:47:30,1260141141,45903,24,18,4,2,16
166975,2023-10-17 23:47:44,1260141301,24110,56,62,27,4,58
166984,2023-10-18 15:03:57,1260365527,6408,70,42,30,2,40
123164,2023-10-18 15:44:13,1260388188,5644,47,191,27,2,189
123028,2023-10-18 15:45:02,1260388653,328,30,23,11,1,22
123029,2023-10-18 15:45:31,1260388979,5361,35,25,18,2,23
123026,2023-10-18 15:46:04,1260389293,46731,105,49,31,7,42
123021,2023-10-18 15:46:29,1260389527,0,0,15,8,0,15
166985,2023-10-18 16:20:05,1260419970,8574,63,52,28,5,47
166988,2023-10-18 16:24:51,1260424509,56830,197,70,42,9,61
167002,2023-10-18 16:41:04,1260441102,13963,6,7,0,3,4
167022,2023-10-18 17:12:39,1260473862,36798,114,20,12,4,16
167036,2023-10-18 17:50:03,1260513260,969,1,3,1,1,2
167043,2023-10-18 18:15:30,1260540139,173129,404,97,59,6,91
167043,2023-10-18 18:15:34,1260540224,173129,404,97,59,6,91
167041,2023-10-18 18:19:44,1260544804,15381,70,59,49,1,58
167041,2023-10-18 18:19:48,1260544839,15381,70,59,49,1,58
167044,2023-10-18 18:28:46,1260554626,13384,196,15,5,3,12
167044,2023-10-18 18:28:48,1260554668,13384,196,15,5,3,12
167044,2023-10-18 18:28:51,1260554726,13384,196,15,5,3,12
167045,2023-10-18 18:44:11,1260571152,1229,4,10,1,1,9
167035,2023-10-18 19:40:17,1260633267,47371,280,2014,20,5,2009
167035,2023-10-18 19:40:34,1260633500,47371,280,2014,20,5,2009
167058,2023-10-18 20:38:55,1260695356,7113,95,30,25,3,27
167060,2023-10-18 20:56:45,1260713986,364889,144,22,9,7,15
167060,2023-10-18 20:56:48,1260714027,364889,144,22,9,7,15
167059,2023-10-18 21:07:02,1260722447,1930,58,30,13,1,29
167063,2023-10-18 21:44:27,1260751808,0,297,22,5,0,22
167062,2023-10-18 22:00:39,1260764346,0,0,2,0,0,2
167069,2023-10-18 22:23:28,1260781075,3116,8,29,6,4,25
167068,2023-10-18 22:23:55,1260781383,1059,13,43,23,2,41
167070,2023-10-18 22:24:57,1260782163,0,0,23,6,0,23
167071,2023-10-18 22:29:12,1260785153,5265,28,29,11,2,27
167071,2023-10-18 22:29:14,1260785182,5265,28,29,11,2,27
167073,2023-10-18 22:58:12,1260808764,12389,391,27,13,2,25
167080,2023-10-19 00:07:56,1260872290,65933,110,22,4,14,8
167078,2023-10-19 00:08:36,1260873174,35805,51,38,10,3,35
167093,2023-10-19 13:01:48,1261111318,12273,36,57,20,2,55
167093,2023-10-19 13:01:54,1261111326,12273,36,57,20,2,55
167104,2023-10-19 15:23:53,1261151937,57333,188,62,39,9,53
167103,2023-10-19 15:24:19,1261152173,60436,178,74,37,9,65
167108,2023-10-19 15:34:53,1261157962,77018,344,50,29,11,39
167086,2023-10-19 15:42:30,1261162493,43221,16,12,7,3,9
167101,2023-10-19 15:43:06,1261162856,68539,378,56,25,20,36
167105,2023-10-19 15:48:52,1261166332,4270,11,7,3,1,6
167105,2023-10-19 15:48:53,1261166351,4270,11,7,3,1,6
167109,2023-10-19 16:12:10,1261181066,2773,5,12,7,3,9
167123,2023-10-19 17:10:53,1261222131,77818,357,98,64,9,89
167107,2023-10-19 17:30:11,1261236665,43553,291,43,35,9,34
167122,2023-10-19 17:31:29,1261237719,20387,214,20,12,5,15
167124,2023-10-19 17:33:41,1261239373,14236,25,50,38,1,49
167126,2023-10-19 17:36:11,1261241453,0,172,66,42,0,66
167127,2023-10-19 17:49:48,1261251882,1736,12,5,3,1,4
146082,2023-10-19 18:28:03,1261281922,102434,87,31,19,6,25
146082,2023-10-19 18:28:11,1261282088,102434,87,31,19,6,25
146197,2023-10-19 18:28:31,1261282437,0,0,17,9,0,17
146107,2023-10-19 18:29:13,1261282987,0,1,97,69,0,97
146105,2023-10-19 18:29:56,1261283629,4803,182,42,29,5,37
146081,2023-10-19 18:30:29,1261284082,4995,19,11,1,1,10
122785,2023-10-19 18:35:31,1261288343,48554,141,40,27,7,33
155558,2023-10-19 18:36:06,1261288861,138937,122,62,49,10,52
122863,2023-10-19 18:36:35,1261289236,5786,224,21,7,2,19
133918,2023-10-19 18:37:43,1261290177,0,112,22,3,0,22
155569,2023-10-19 18:38:10,1261290564,104729,498,97,44,11,86
167130,2023-10-19 18:39:09,1261291458,52838,85,46,30,7,39
167134,2023-10-19 18:55:09,1261305290,54166,68,60,32,5,55
167132,2023-10-19 18:55:15,1261305365,12076,25,75,35,4,71
167144,2023-10-19 19:45:46,1261341232,2932,26,21,5,4,17
167143,2023-10-19 19:46:16,1261341680,72225,168,24,17,7,17
167141,2023-10-19 19:46:42,1261342024,100173,156,52,26,8,44
167140,2023-10-19 19:47:07,1261342391,34906,191,21,13,5,16
167139,2023-10-19 19:47:33,1261342761,48183,172,21,15,4,17
167155,2023-10-19 22:03:31,1261541203,2157,229,50,31,2,48
110298,2023-10-19 22:20:10,1261575946,31153,106,44,22,9,35
101360,2023-10-19 22:21:35,1261578847,30818,34,14,3,3,11
167166,2023-10-19 22:50:46,1261619390,21115,151,55,37,1,54
167166,2023-10-19 22:50:56,1261619461,21115,151,55,37,1,54
167168,2023-10-19 22:51:08,1261619658,3679,59,5,2,1,4
167167,2023-10-19 22:51:28,1261619836,12795,166,14,5,2,12
167182,2023-10-19 23:13:19,1261633140,0,1,4,2,0,4
167156,2023-10-19 23:15:30,1261634452,937,2,5,2,1,4
13084,2023-10-20 14:31:36,1261887878,0,101,42,20,0,42
167195,2023-10-20 14:34:44,1261888998,0,13,25,21,0,25
167202,2023-10-20 15:14:23,1261904848,0,3,16,10,0,16
167199,2023-10-20 15:33:04,1261915039,30008,297,38,14,5,33
167204,2023-10-20 15:46:36,1261923030,334,18,2,2,1,1
167211,2023-10-20 15:46:42,1261923098,62243,94,14,8,5,9
166881,2023-10-20 15:49:14,1261924616,0,9,6,2,0,6
167197,2023-10-20 15:51:45,1261926075,8719,3,4,1,2,2
167196,2023-10-20 15:52:13,1261926357,40319,71,33,4,5,28
167184,2023-10-20 16:11:12,1261937961,5453,7,6,4,1,5
167216,2023-10-20 16:26:30,1261948662,68163,251,63,48,9,54
167217,2023-10-20 16:28:25,1261950104,350,9,12,10,1,11
167218,2023-10-20 16:33:45,1261953750,62765,107,67,41,8,59
167225,2023-10-20 16:34:10,1261954052,105168,175,90,56,6,84
167228,2023-10-20 16:43:06,1261960492,0,16,10,1,0,10
167198,2023-10-20 16:54:09,1261968558,46764,198,59,24,6,53
167233,2023-10-20 16:54:18,1261968652,52442,165,112,89,9,103
167230,2023-10-20 16:56:49,1261970456,5377,17,65,46,1,64
167248,2023-10-20 17:30:52,1261996889,6612,4,1,0,1,0
167226,2023-10-20 17:46:00,1262008862,92866,134,52,32,5,47
167237,2023-10-20 17:51:20,1262013166,361100,100,44,11,5,39
167249,2023-10-20 18:36:24,1262047760,156312,267,67,33,11,56
167261,2023-10-20 18:56:46,1262063794,70338,244,62,44,9,53
167261,2023-10-20 18:56:49,1262063823,70338,244,62,44,9,53
167264,2023-10-20 19:44:29,1262099101,9217,10,16,8,2,14
167268,2023-10-20 20:38:20,1262139579,19789,2,4,2,2,2
167270,2023-10-20 20:40:48,1262141403,20720,58,38,5,3,35
167271,2023-10-20 21:12:15,1262164878,25664,65,11,8,2,9
167272,2023-10-20 21:18:14,1262169154,12320,146,19,8,10,9
167273,2023-10-20 21:25:43,1262174420,16085,69,31,17,7,24
167275,2023-10-20 22:01:36,1262200022,31315,78,16,10,1,15
167277,2023-10-20 22:04:04,1262201692,55759,65,36,20,3,33
167278,2023-10-20 22:21:57,1262214062,19600,55,24,14,2,22
167279,2023-10-20 22:22:01,1262214104,26142,28,47,21,1,46
150385,2023-10-20 22:33:34,1262223614,14229,16,27,23,2,25
167131,2023-10-20 22:40:49,1262229649,6595,25,36,17,3,33
167280,2023-10-20 22:41:01,1262229826,0,0,1,1,0,1
167281,2023-10-20 22:49:11,1262236281,178591,168,91,64,8,83
167287,2023-10-21 14:45:59,1262508447,2249,60,6,3,3,3
167286,2023-10-21 14:46:20,1262508565,78517,92,19,15,6,13
167289,2023-10-21 15:13:29,1262515714,0,6,29,26,0,29
157912,2023-10-21 15:35:34,1262523013,41592,68,70,44,2,68
157728,2023-10-21 15:36:01,1262523152,3344,121,161,63,5,156
157659,2023-10-21 15:36:46,1262523414,11162,98,58,42,2,56
157681,2023-10-21 15:37:12,1262523600,35927,162,52,35,6,46
157661,2023-10-21 15:37:43,1262523770,24182,275,72,44,4,68
157676,2023-10-21 15:38:28,1262524067,24595,93,12,6,4,8
157662,2023-10-21 15:38:52,1262524218,4006,41,60,43,1,59
157675,2023-10-21 15:39:45,1262524547,3000,117,62,37,3,59
167291,2023-10-21 16:15:35,1262539524,145726,114,27,14,5,22
167292,2023-10-21 17:38:39,1262582276,8292,66,16,11,1,15
167295,2023-10-21 17:59:37,1262594324,30014,99,21,8,6,15
167295,2023-10-21 17:59:38,1262594346,30014,99,21,8,6,15
167297,2023-10-21 18:06:04,1262598188,101925,98,49,12,5,44
167294,2023-10-21 18:06:21,1262598348,58805,5,38,12,2,36
167298,2023-10-21 18:25:57,1262609841,16171,63,7,4,4,3
167302,2023-10-21 18:26:28,1262610184,0,56,9,6,0,9
167304,2023-10-21 18:29:44,1262612180,880,5,9,5,1,8
167303,2023-10-21 18:30:02,1262612337,10895,38,37,30,2,35
167301,2023-10-21 18:30:18,1262612491,1014,10,62,27,1,61
167300,2023-10-21 18:30:33,1262612625,2769,6,11,3,2,9
167299,2023-10-21 18:30:52,1262612772,56196,56,19,12,2,17
167305,2023-10-21 18:39:25,1262617875,297250,172,101,52,12,89
94518,2023-10-21 19:00:57,1262630741,15757,69,42,22,6,36
94855,2023-10-21 19:01:33,1262631127,9737,23,29,20,1,28
94785,2023-10-21 19:04:50,1262633032,38947,83,36,23,2,34
94517,2023-10-21 19:05:42,1262633602,8598,4,39,10,1,38
94783,2023-10-21 19:06:09,1262633870,0,1,74,1,0,74
147693,2023-10-21 19:06:56,1262634335,0,0,4,1,0,4
94780,2023-10-21 19:07:20,1262634597,103830,432,56,28,18,38
157483,2023-10-21 19:12:42,1262638113,157978,33,19,16,2,17
157483,2023-10-21 19:12:45,1262638153,157978,33,19,16,2,17
157483,2023-10-21 19:12:47,1262638176,157978,33,19,16,2,17
157243,2023-10-21 19:13:23,1262638570,0,0,1,0,0,1
157310,2023-10-21 19:13:54,1262638884,0,1,28,19,0,28
157310,2023-10-21 19:13:57,1262638919,0,1,28,19,0,28
157937,2023-10-21 19:14:15,1262639114,220480,250,57,23,6,51
157937,2023-10-21 19:14:18,1262639136,220480,250,57,23,6,51
157558,2023-10-21 19:14:33,1262639302,8272,25,22,16,2,20
157558,2023-10-21 19:14:34,1262639308,8272,25,22,16,2,20
157558,2023-10-21 19:14:36,1262639326,8272,25,22,16,2,20
167316,2023-10-23 14:48:03,1263376745,14372,31,27,22,2,25
167321,2023-10-23 16:11:48,1263424007,5287,70,4,1,1,3
167323,2023-10-23 16:35:29,1263442174,8380,33,44,31,3,41
167325,2023-10-23 16:46:50,1263450827,0,0,3,2,0,3
167319,2023-10-23 16:47:14,1263451122,20290,54,9,6,3,6
167288,2023-10-23 17:20:23,1263477723,61513,183,47,29,7,40
167336,2023-10-23 18:08:05,1263516908,0,3,17,15,0,17
167337,2023-10-23 18:13:47,1263521485,15691,40,24,17,5,19
167339,2023-10-23 18:25:30,1263530720,22618,89,25,9,8,17
167338,2023-10-23 18:26:11,1263531293,11231,11,114,22,1,113
167342,2023-10-23 18:41:11,1263543791,14277,41,280,7,2,278
167334,2023-10-23 18:41:38,1263544176,56087,373,35,16,8,27
167332,2023-10-23 18:41:55,1263544432,29471,122,15,3,10,5
167331,2023-10-23 18:42:17,1263544727,21883,91,40,9,7,33
137298,2023-10-23 19:04:05,1263564105,11654,30,27,6,1,26
137054,2023-10-23 19:04:43,1263564606,3318,86,132,67,2,130
136991,2023-10-23 19:05:05,1263564903,3692,255,36,27,4,32
136780,2023-10-23 19:05:35,1263565180,20866,235,84,53,4,80
136780,2023-10-23 19:05:43,1263565232,20866,235,84,53,4,80
136776,2023-10-23 19:06:02,1263565320,34843,114,75,57,5,70
148986,2023-10-23 19:06:37,1263565574,0,34,12,0,0,12
148986,2023-10-23 19:06:40,1263565604,0,34,12,0,0,12
89990,2023-10-23 19:29:06,1263575264,12368,41,9,5,4,5
105326,2023-10-23 19:30:38,1263576779,27607,36,43,23,3,40
105429,2023-10-23 19:32:11,1263578244,15764,48,12,3,2,10
148005,2023-10-23 19:34:27,1263580480,0,0,10,8,0,10
148436,2023-10-23 19:35:56,1263581803,721,49,37,9,2,35
167346,2023-10-23 19:47:35,1263591900,0,3,31,14,0,31
167282,2023-10-23 19:54:12,1263597489,29371,76,5,2,1,4
167328,2023-10-23 19:55:02,1263598174,29811,81,114,53,6,108
167349,2023-10-23 20:16:01,1263614443,106928,131,16,10,8,8
167352,2023-10-23 20:40:02,1263635335,38631,28,49,14,3,46
167370,2023-10-23 21:40:58,1263686180,6595,25,36,17,3,33
90041,2023-10-23 22:16:27,1263715520,192340,262,127,70,10,117
167374,2023-10-23 22:22:29,1263720211,93184,46,35,27,4,31
167384,2023-10-23 22:44:16,1263737934,249498,196,68,37,10,58
167344,2023-10-23 22:50:50,1263743030,0,0,16,13,0,16
167284,2023-10-23 22:51:37,1263743590,28661,12,14,7,1,13
167413,2023-10-24 14:47:00,1264030578,183,8,14,7,1,13
167421,2023-10-24 14:54:12,1264034057,5496,21,47,21,4,43
157656,2023-10-24 15:01:25,1264037440,232564,106,60,32,7,53
167422,2023-10-24 15:01:50,1264037625,17476,30,27,8,2,25
158226,2023-10-24 15:02:37,1264037964,153112,60,34,24,3,31
158232,2023-10-24 15:03:08,1264038192,142368,75,22,7,5,17
158216,2023-10-24 15:03:55,1264038589,142976,46,32,19,4,28
158125,2023-10-24 15:04:32,1264038903,65316,80,51,5,4,47
167423,2023-10-24 15:08:38,1264040848,35575,21,17,13,4,13
167425,2023-10-24 15:12:41,1264042924,60361,45,39,5,2,37
167426,2023-10-24 15:20:04,1264047074,16027,176,20,8,4,16
167426,2023-10-24 15:20:10,1264047149,16027,176,20,8,4,16
167371,2023-10-24 15:42:48,1264062428,5980,17,21,6,1,20
167371,2023-10-24 15:42:51,1264062449,5980,17,21,6,1,20
167431,2023-10-24 15:52:15,1264068690,5963,172,26,15,3,23
158022,2023-10-24 15:53:20,1264069410,1318,33,22,19,1,21
157719,2023-10-24 15:53:27,1264069494,23788,55,68,35,4,64
157602,2023-10-24 15:53:35,1264069594,13857,81,10,6,3,7
142943,2023-10-24 15:53:43,1264069684,9669,71,32,8,5,27
157598,2023-10-24 15:53:50,1264069768,6887,296,38,19,3,35
158128,2023-10-24 15:53:58,1264069849,739,23,19,13,1,18
157608,2023-10-24 15:54:05,1264069947,17589,83,17,3,3,14
167428,2023-10-24 16:00:37,1264074397,161720,57,31,14,4,27
104136,2023-10-24 16:04:37,1264077144,5615,93,35,7,2,33
149237,2023-10-24 16:06:58,1264078764,0,0,48,37,0,48
149252,2023-10-24 16:07:20,1264079016,4861,33,15,10,2,13
149253,2023-10-24 16:07:41,1264079237,19413,111,71,41,3,68
149253,2023-10-24 16:07:43,1264079251,19413,111,71,41,3,68
149236,2023-10-24 16:08:03,1264079488,12599,16,50,32,2,48
149236,2023-10-24 16:08:05,1264079522,12599,16,50,32,2,48
149557,2023-10-24 16:08:38,1264079936,11005,18,10,5,3,7
149557,2023-10-24 16:08:41,1264079975,11005,18,10,5,3,7
122656,2023-10-24 16:12:29,1264082646,0,36,53,7,0,53
97102,2023-10-24 16:25:30,1264093133,0,0,4,3,0,4
97100,2023-10-24 16:25:57,1264093461,14500,129,53,21,2,51
97098,2023-10-24 16:26:17,1264093731,3397,26,20,6,1,19
97091,2023-10-24 16:26:57,1264094196,38723,44,32,21,4,28
138470,2023-10-24 16:27:29,1264094627,15676,70,91,19,3,88
148350,2023-10-24 16:27:53,1264094969,41218,150,87,42,6,81
167446,2023-10-24 17:07:43,1264126374,14124,87,37,21,3,34
167445,2023-10-24 17:11:34,1264129344,32685,175,37,17,2,35
167452,2023-10-24 17:34:09,1264147693,0,0,2,0,0,2
167452,2023-10-24 17:34:13,1264147743,0,0,2,0,0,2
90248,2023-10-24 17:59:42,1264168776,51995,214,45,31,5,40
167429,2023-10-24 18:10:05,1264177284,5697,14,4,0,1,3
167485,2023-10-24 20:06:36,1264383472,49954,103,9,4,3,6
167496,2023-10-24 20:28:33,1264430332,25217,12,21,17,2,19
167511,2023-10-24 20:45:09,1264443359,126596,82,45,32,4,41
167512,2023-10-24 20:46:56,1264444559,14437,22,31,11,2,29
167513,2023-10-24 20:49:12,1264446036,32622,19,17,10,2,15
74349,2023-10-24 21:59:05,1264681480,44153,61,56,25,3,53
167527,2023-10-24 22:33:51,1264747801,4697,56,62,24,1,61
167526,2023-10-24 22:34:00,1264747892,11432,65,35,14,2,33
167528,2023-10-24 22:39:32,1264753819,0,0,12,1,0,12
167529,2023-10-24 22:43:18,1264757842,6574,22,9,2,2,7
167530,2023-10-24 22:43:30,1264758008,46053,48,93,38,5,88
167531,2023-10-24 22:56:33,1264779085,29118,193,25,18,3,22
167532,2023-10-24 23:02:12,1264798706,2321,2,12,6,2,10
167533,2023-10-24 23:09:32,1264821203,90709,378,50,33,8,42
167534,2023-10-24 23:20:13,1264852700,70249,28,24,17,2,22
167536,2023-10-24 23:39:02,1264908110,136020,59,33,28,6,27
167537,2023-10-24 23:40:16,1264911633,65895,236,61,27,7,54
167538,2023-10-24 23:43:19,1264920715,4880,0,18,5,1,17
167542,2023-10-24 23:53:16,1264949596,166903,76,45,20,5,40
167545,2023-10-24 23:54:44,1264953863,3594,31,34,18,2,32
167544,2023-10-24 23:54:47,1264954058,385,2,4,1,1,3
167543,2023-10-24 23:54:54,1264954298,44069,79,49,24,5,44
167541,2023-10-24 23:55:00,1264954606,7880,31,21,12,2,19
167539,2023-10-24 23:55:08,1264954998,121324,80,53,20,7,46
167546,2023-10-25 00:18:45,1265022318,2522,62,32,27,2,30
167547,2023-10-25 00:36:19,1265073127,28733,32,75,29,2,73
167570,2023-10-25 15:15:08,1265938572,0,11,74,37,0,74
167573,2023-10-25 15:28:55,1265951862,44385,185,10,3,5,5
167572,2023-10-25 15:29:18,1265952223,28284,112,9,5,3,6
167580,2023-10-25 16:40:50,1266025720,19159,43,13,8,4,9
167580,2023-10-25 16:40:52,1266025770,19159,43,13,8,4,9
167580,2023-10-25 16:40:56,1266025855,19159,43,13,8,4,9
118373,2023-10-25 17:10:49,1266074154,24199,66,89,73,7,82
132264,2023-10-25 17:18:23,1266086455,49595,51,58,29,3,55
95704,2023-10-25 17:22:49,1266093962,31046,76,59,21,5,54
95711,2023-10-25 17:23:15,1266094639,52033,273,83,36,5,78
167583,2023-10-25 17:23:36,1266095239,0,0,4,0,0,4
95714,2023-10-25 17:23:38,1266095267,136913,85,49,23,7,42
95715,2023-10-25 17:24:04,1266095948,58118,67,51,24,4,47
167605,2023-10-25 18:29:03,1266201023,18713,107,18,10,1,17
167610,2023-10-25 19:51:57,1266281790,44451,128,68,43,12,56
167613,2023-10-25 20:09:06,1266295028,17031,11,64,27,1,63
167617,2023-10-25 20:12:35,1266297518,78004,209,43,32,5,38
167619,2023-10-25 20:19:09,1266302651,24769,262,27,21,6,21
167616,2023-10-25 20:19:33,1266302972,49000,122,71,29,5,66
167612,2023-10-25 20:19:53,1266303225,27169,184,62,42,7,55
167611,2023-10-25 20:20:21,1266303582,175185,212,36,27,10,26
167620,2023-10-25 20:20:56,1266304114,52207,13,8,4,3,5
167326,2023-10-25 20:28:31,1266307761,252056,63,25,9,8,17
167615,2023-10-25 20:38:08,1266313342,50303,230,63,22,3,60
167618,2023-10-25 20:38:51,1266313910,7181,220,67,26,14,53
167621,2023-10-25 20:39:12,1266314207,37873,51,37,29,2,35
167624,2023-10-25 20:39:36,1266314496,21477,33,43,22,1,42
167626,2023-10-25 21:20:24,1266344920,0,31,33,17,0,33
167626,2023-10-25 21:20:30,1266345002,0,31,33,17,0,33
167628,2023-10-25 21:20:37,1266345099,0,0,9,3,0,9
167628,2023-10-25 21:20:39,1266345123,0,0,9,3,0,9
86466,2023-10-25 21:24:38,1266348128,84415,54,83,53,4,79
167629,2023-10-25 21:38:26,1266358327,305859,215,16,7,8,8
167632,2023-10-25 21:47:10,1266364732,175901,352,143,31,16,127
167632,2023-10-25 21:47:17,1266364821,175901,352,143,31,16,127
167631,2023-10-25 21:48:12,1266365481,4993,4,11,4,1,10
167296,2023-10-25 21:51:15,1266367751,4315,12,8,3,2,6
167293,2023-10-25 21:51:35,1266367989,83308,160,37,30,4,33
167343,2023-10-25 21:58:28,1266373080,46714,108,8,1,4,4
167630,2023-10-25 22:05:05,1266377643,9960,248,70,57,3,67
167630,2023-10-25 22:05:07,1266377660,9960,248,70,57,3,67
167630,2023-10-25 22:05:10,1266377706,9960,248,70,57,3,67
158090,2023-10-25 22:51:22,1266410216,11218,8,31,27,2,29
122172,2023-10-25 22:52:05,1266410699,36770,63,128,84,8,120
145993,2023-10-25 22:52:31,1266411001,81972,81,51,42,6,45
158292,2023-10-25 22:52:57,1266411270,24098,6,38,10,3,35
158625,2023-10-25 22:53:26,1266411624,159199,116,72,44,11,61
167653,2023-10-25 22:53:33,1266411724,46941,4,1,1,1,0
122184,2023-10-25 22:53:52,1266411909,39545,80,141,79,13,128
167655,2023-10-25 22:59:10,1266415481,10240,43,11,2,3,8
167658,2023-10-25 23:15:13,1266426409,14861,40,24,14,3,21
167660,2023-10-25 23:17:49,1266428012,64789,193,35,26,4,31
159151,2023-10-26 14:07:58,1266652847,2960,13,31,17,1,30
167677,2023-10-26 14:50:00,1266667020,0,1,10,9,0,10
167689,2023-10-26 15:25:30,1266683854,26569,57,60,27,5,55
137245,2023-10-26 15:25:36,1266683908,9634,222,43,21,1,42
137086,2023-10-26 15:32:30,1266687690,14028,325,57,29,7,50
167691,2023-10-26 15:33:44,1266688389,33935,183,10,2,3,7
167700,2023-10-26 15:39:11,1266691739,19714,158,5,4,3,2
167701,2023-10-26 15:42:16,1266693491,50108,93,39,24,8,31
167692,2023-10-26 15:50:24,1266698316,50825,263,137,72,21,116
167670,2023-10-26 16:01:22,1266705018,3724,131,45,23,3,42
158884,2023-10-26 16:14:22,1266713213,0,38,34,32,0,34
158889,2023-10-26 16:14:48,1266713525,1480,64,46,29,1,45
159517,2023-10-26 16:15:29,1266713991,51495,48,14,11,3,11
159518,2023-10-26 16:15:55,1266714269,54894,17,64,36,4,60
159525,2023-10-26 16:16:21,1266714521,60150,299,81,43,5,76
167712,2023-10-26 16:37:00,1266730116,1960,3,5,0,1,4
167711,2023-10-26 16:42:38,1266734180,7593,93,30,17,3,27
158678,2023-10-26 16:51:41,1266741559,15820,41,61,38,4,57
158677,2023-10-26 16:52:10,1266741987,2601,18,7,5,2,5
158818,2023-10-26 16:52:36,1266742311,59091,36,30,18,3,27
158675,2023-10-26 16:53:01,1266742616,2029,26,30,25,2,28
158717,2023-10-26 16:53:33,1266743034,1532,21,72,8,2,70
158673,2023-10-26 16:53:56,1266743342,193191,58,50,30,5,45
167724,2023-10-26 17:07:40,1266754278,16009,58,85,1,3,82
167723,2023-10-26 17:09:22,1266755704,15316,105,8,7,4,4
167726,2023-10-26 17:17:08,1266762264,6594,33,9,5,3,6
167727,2023-10-26 17:23:58,1266768244,21866,71,33,18,1,32
138907,2023-10-26 17:27:36,1266771403,9052,16,30,22,3,27
138907,2023-10-26 17:27:40,1266771454,9052,16,30,22,3,27
138908,2023-10-26 17:28:13,1266771909,39209,76,66,26,5,61
136079,2023-10-26 17:28:22,1266772028,8010,22,94,70,2,92
138910,2023-10-26 17:29:33,1266772953,3264,17,4,2,1,3
138911,2023-10-26 17:30:13,1266773508,15009,72,74,32,3,71
138911,2023-10-26 17:30:16,1266773545,15009,72,74,32,3,71
148781,2023-10-26 17:30:34,1266773788,30589,41,32,17,3,29
159297,2023-10-26 17:32:01,1266774946,206189,241,54,23,12,42
156157,2023-10-26 17:32:32,1266775325,83642,158,41,19,6,35
143185,2023-10-26 17:32:38,1266775441,19046,142,31,25,5,26
167722,2023-10-26 18:04:02,1266797309,0,0,2,2,0,2
138912,2023-10-26 18:18:19,1266809327,15062,63,32,13,4,28
138912,2023-10-26 18:18:24,1266809420,15062,63,32,13,4,28
147254,2023-10-26 19:00:22,1266843537,55970,138,15,6,2,13
146250,2023-10-26 19:01:25,1266844295,63215,279,36,11,10,26
146321,2023-10-26 19:01:46,1266844553,57337,189,70,51,4,66
146345,2023-10-26 19:02:14,1266844881,13401,24,35,23,1,34
103405,2023-10-26 19:02:19,1266844927,83642,158,41,19,6,35
123105,2023-10-26 20:15:58,1266905219,84377,98,36,31,3,33
123106,2023-10-26 20:16:29,1266905657,198575,220,45,35,10,35
123107,2023-10-26 20:16:52,1266905924,46043,123,83,36,9,74
135856,2023-10-26 20:17:20,1266906343,6792,21,22,15,2,20
146779,2023-10-26 20:18:06,1266906978,54101,51,11,5,1,10
167756,2023-10-26 20:28:39,1266915367,0,0,2,0,0,2
156140,2023-10-26 20:32:50,1266918659,6176,23,12,4,2,10
156129,2023-10-26 20:33:15,1266918980,26196,35,61,16,5,56
156138,2023-10-26 20:33:43,1266919354,30520,34,33,21,5,28
156130,2023-10-26 20:34:10,1266919699,19277,271,27,12,6,21
156128,2023-10-26 20:34:34,1266920007,9606,23,23,10,4,19
167786,2023-10-26 22:28:03,1267008861,66532,37,11,4,2,9
167802,2023-10-26 22:37:23,1267016150,0,0,5,2,0,5
136077,2023-10-26 22:54:03,1267031341,74059,75,41,30,6,35
136080,2023-10-27 14:59:21,1267284584,8242,37,76,48,3,73
167837,2023-10-27 15:03:29,1267286244,5112,10,36,8,2,34
167836,2023-10-27 15:03:46,1267286378,0,0,5,0,0,5
167835,2023-10-27 15:04:07,1267286536,69988,161,52,15,8,44
84967,2023-10-27 15:23:52,1267296683,114776,236,80,42,10,70
84967,2023-10-27 15:23:56,1267296715,114776,236,80,42,10,70
84967,2023-10-27 15:23:57,1267296728,114776,236,80,42,10,70
84967,2023-10-27 15:23:58,1267296738,114776,236,80,42,10,70
84967,2023-10-27 15:23:59,1267296745,114776,236,80,42,10,70
85126,2023-10-27 15:25:16,1267297585,44942,213,69,40,9,60
85126,2023-10-27 15:25:20,1267297623,44942,213,69,40,9,60
85121,2023-10-27 15:26:55,1267298602,35845,218,35,18,4,31
98096,2023-10-27 15:28:45,1267299762,20325,147,22,10,2,20
167845,2023-10-27 15:38:29,1267305789,0,0,82,25,0,82
167845,2023-10-27 15:38:32,1267305817,0,0,82,25,0,82
138340,2023-10-27 15:43:21,1267309102,0,3,9,4,0,9
167852,2023-10-27 15:43:44,1267309372,16404,33,48,24,2,46
167852,2023-10-27 15:43:47,1267309408,16404,33,48,24,2,46
138346,2023-10-27 15:54:16,1267316631,248,4,11,7,1,10
138346,2023-10-27 15:54:21,1267316680,248,4,11,7,1,10
167856,2023-10-27 16:16:33,1267333147,12319,46,16,13,2,14
167858,2023-10-27 16:27:55,1267341939,46935,154,21,14,4,17
167657,2023-10-27 16:31:20,1267344672,0,26,21,3,0,21
167860,2023-10-27 16:45:31,1267355983,92608,122,28,16,5,23
167867,2023-10-27 17:11:34,1267377173,16538,134,11,7,2,9
167868,2023-10-27 17:15:23,1267380392,39894,38,11,6,2,9
167870,2023-10-27 17:19:30,1267383705,111603,165,37,14,6,31
167871,2023-10-27 17:23:10,1267386670,46650,276,53,14,3,50
167872,2023-10-27 17:28:00,1267390541,6578,40,13,8,3,10
167874,2023-10-27 17:43:36,1267402942,12315,70,25,17,5,20
167882,2023-10-27 18:24:25,1267437425,16855,76,29,19,3,26
167884,2023-10-27 18:39:39,1267450147,2701,18,58,24,2,56
159144,2023-10-27 18:57:21,1267466054,0,0,4,2,0,4
159058,2023-10-27 18:58:04,1267466666,142083,36,35,29,4,31
158871,2023-10-27 18:58:42,1267467175,1205,8,13,5,1,12
158867,2023-10-27 18:59:15,1267467626,65823,125,48,25,13,35
158865,2023-10-27 19:00:00,1267468272,161774,124,60,34,5,55
158860,2023-10-27 19:00:53,1267468932,78394,301,53,28,9,44
167899,2023-10-27 20:09:27,1267527543,128444,113,94,61,10,84
167900,2023-10-27 20:10:45,1267528645,2697,115,22,9,4,18
167902,2023-10-27 20:15:50,1267532904,0,0,25,9,0,25
167903,2023-10-27 20:17:10,1267534048,1075,19,14,10,1,13
167907,2023-10-27 20:39:34,1267554115,31277,41,124,4,2,122
167910,2023-10-27 20:51:59,1267565376,13311,15,121,63,1,120
167921,2023-10-27 21:02:08,1267575518,0,0,5,4,0,5
167901,2023-10-27 21:35:41,1267611576,0,1,9,9,0,9
167896,2023-10-27 21:48:07,1267623116,0,9,33,10,0,33
167887,2023-10-27 22:12:04,1267641337,0,42,120,54,0,120
167886,2023-10-27 22:16:23,1267644713,17163,25,38,21,1,37
167935,2023-10-27 22:26:38,1267652236,20410,45,35,31,2,33
125983,2023-10-30 16:59:40,1269359418,0,7,66,57,0,66
109956,2023-10-30 17:05:51,1269365242,1147,51,27,13,1,26
125980,2023-10-30 17:07:21,1269366716,18733,25,32,22,3,29
168018,2023-10-30 17:08:08,1269367455,13279,38,5,4,3,2
126018,2023-10-30 17:08:29,1269367735,201246,279,56,30,11,45
137297,2023-10-30 17:08:32,1269367790,0,1,28,20,0,28
125986,2023-10-30 17:08:43,1269367979,13264,11,9,8,1,8
158126,2023-10-30 17:09:08,1269368386,12953,17,32,24,2,30
157986,2023-10-30 17:09:31,1269368745,34603,147,14,4,10,4
157987,2023-10-30 17:09:57,1269369148,30485,39,20,9,3,17
167971,2023-10-30 17:10:01,1269369218,42995,447,46,9,5,41
158131,2023-10-30 17:10:15,1269369462,7337,10,7,4,1,6
157946,2023-10-30 17:11:21,1269370518,5344,13,9,5,2,7
168013,2023-10-30 17:12:23,1269371558,12754,113,59,49,2,57
133431,2023-10-30 17:12:55,1269372077,0,0,80,50,0,80
133015,2023-10-30 17:12:57,1269372120,60796,105,28,15,4,24
133107,2023-10-30 17:13:00,1269372173,109964,112,76,47,8,68
133497,2023-10-30 17:13:02,1269372219,5966,23,70,30,2,68
133496,2023-10-30 17:13:06,1269372281,57638,55,43,34,6,37
167956,2023-10-30 17:13:23,1269372591,0,1,18,16,0,18
126668,2023-10-30 17:14:09,1269373278,9399,43,94,83,2,92
167989,2023-10-30 17:19:08,1269378003,3737,73,15,2,1,14
168014,2023-10-30 17:21:21,1269380182,175040,269,68,51,13,55
168012,2023-10-30 17:21:44,1269380520,76576,90,65,35,6,59
168011,2023-10-30 17:22:06,1269380890,36578,96,6,3,6,0
168010,2023-10-30 17:22:34,1269381346,4130,3,15,12,2,13
167975,2023-10-30 17:23:15,1269382005,185792,208,73,47,17,56
168024,2023-10-30 17:23:27,1269382175,59565,106,80,49,7,73
167973,2023-10-30 17:23:44,1269382467,104191,79,108,56,4,104
167974,2023-10-30 17:23:48,1269382536,115239,130,34,17,6,28
167969,2023-10-30 17:24:16,1269382980,7211,85,32,15,5,27
167955,2023-10-30 17:24:51,1269383523,2678,11,4,1,2,2
167954,2023-10-30 17:25:14,1269383898,31935,99,78,63,4,74
167953,2023-10-30 17:25:39,1269384275,56681,47,43,35,3,40
167952,2023-10-30 17:26:03,1269384620,21600,70,54,46,3,51
122810,2023-10-30 17:28:12,1269386641,41979,127,72,58,9,63
158789,2023-10-30 17:42:13,1269399767,6813,50,15,4,4,11
158782,2023-10-30 17:44:59,1269402363,2564,19,44,16,1,43
158785,2023-10-30 17:45:29,1269402918,13845,56,52,22,3,49
159000,2023-10-30 17:46:46,1269404170,39696,38,32,18,2,30
158784,2023-10-30 17:48:59,1269406211,57986,165,181,24,4,177
158882,2023-10-30 17:50:14,1269407393,46701,188,51,27,4,47
158787,2023-10-30 17:51:52,1269408846,13092,193,47,26,4,43
168045,2023-10-30 18:49:32,1269462207,37824,64,154,31,3,151
114240,2023-10-30 19:06:27,1269478744,37965,231,74,38,21,53
147755,2023-10-30 19:06:43,1269478998,0,0,2,1,0,2
147756,2023-10-30 19:07:01,1269479252,0,0,9,7,0,9
147642,2023-10-30 19:07:18,1269479503,14681,47,47,30,2,45
147526,2023-10-30 19:07:36,1269479778,96642,136,48,38,4,44
147532,2023-10-30 19:07:55,1269480098,0,0,14,11,0,14
147876,2023-10-30 19:08:15,1269480418,22075,125,17,9,3,14
157491,2023-10-30 19:10:40,1269482625,941,2,27,11,1,26
158134,2023-10-30 19:11:06,1269483028,111350,85,35,28,6,29
158143,2023-10-30 19:11:22,1269483255,166051,112,67,24,12,55
157487,2023-10-30 19:11:45,1269483602,914,6,48,18,1,47
158666,2023-10-30 19:12:06,1269483902,28450,14,43,30,5,38
168007,2023-10-30 19:25:10,1269495965,0,3,15,14,0,15
150831,2023-10-30 19:26:53,1269497675,58737,119,92,51,5,87
152943,2023-10-30 19:27:14,1269498000,51052,329,99,44,20,79
168048,2023-10-30 19:45:09,1269515108,4545,13,124,11,1,123
168048,2023-10-30 19:45:16,1269515230,4545,13,124,11,1,123
168050,2023-10-30 19:45:27,1269515425,122699,211,60,35,11,49
168060,2023-10-30 19:45:41,1269515685,12007,42,10,9,2,8
168062,2023-10-30 19:45:58,1269515930,56507,139,109,51,6,103
168073,2023-10-30 19:46:22,1269516327,7683,131,26,7,10,16
168073,2023-10-30 19:46:26,1269516388,7683,131,26,7,10,16
159065,2023-10-30 20:31:06,1269558890,22190,40,35,28,5,30
158920,2023-10-30 20:31:25,1269559198,3109,17,11,8,2,9
159066,2023-10-30 20:31:47,1269559554,101657,97,51,39,7,44
159152,2023-10-30 20:32:09,1269559939,7730,24,10,7,1,9
159820,2023-10-30 20:32:33,1269560306,145626,197,26,13,4,22
167690,2023-10-30 20:33:22,1269561149,21112,159,45,31,7,38
168081,2023-10-30 20:33:42,1269561513,13714,85,22,13,6,16
168086,2023-10-30 20:50:26,1269577449,3226,90,5,0,4,1
168088,2023-10-30 21:01:05,1269588343,14567,62,81,21,5,76
168089,2023-10-30 21:08:52,1269596129,18349,62,35,21,4,31
168102,2023-10-30 21:31:21,1269619650,63888,55,8,4,4,4
168130,2023-10-30 23:09:49,1269724007,2218,39,9,3,3,6
168027,2023-10-31 14:22:03,1270189605,26669,57,28,17,1,27
167968,2023-10-31 14:22:45,1270189787,29172,35,17,12,2,15
167961,2023-10-31 14:23:17,1270189944,26669,21,10,9,1,9
167960,2023-10-31 14:23:39,1270190053,2074,22,3,2,1,2
167958,2023-10-31 14:24:37,1270190344,17968,35,34,16,3,31
95659,2023-10-31 14:33:13,1270192598,31553,47,23,12,2,21
168191,2023-10-31 15:21:06,1270210788,45373,78,65,16,4,61
168221,2023-10-31 16:52:08,1270265302,141541,102,107,66,10,97
168230,2023-10-31 17:03:11,1270272522,0,0,14,12,0,14
168235,2023-10-31 17:27:05,1270287903,386,177,139,70,1,138
126698,2023-10-31 18:06:40,1270313664,6245,247,54,25,2,52
168266,2023-10-31 19:22:17,1270363864,20883,77,78,51,4,74
168266,2023-10-31 19:22:22,1270363919,20883,77,78,51,4,74
168267,2023-10-31 19:22:47,1270364178,36341,74,115,82,7,108
168267,2023-10-31 19:22:51,1270364234,34257,70,114,82,6,108
168269,2023-10-31 19:23:22,1270364599,55950,97,98,73,7,91
168269,2023-10-31 19:23:23,1270364625,55950,97,98,73,7,91
168273,2023-10-31 19:24:27,1270365330,15057,36,95,65,7,88
168273,2023-10-31 19:24:29,1270365353,15057,36,95,65,7,88
168273,2023-10-31 19:24:31,1270365381,15057,36,95,65,7,88
168274,2023-10-31 19:24:54,1270365631,12010,37,110,83,1,109
168279,2023-10-31 19:32:56,1270371327,87705,168,96,55,12,84
168279,2023-10-31 19:32:58,1270371346,87705,168,96,55,12,84
168279,2023-10-31 19:33:02,1270371392,87705,168,96,55,12,84
168272,2023-10-31 19:45:38,1270379957,72236,168,129,89,6,123
168272,2023-10-31 19:45:39,1270379976,72236,168,129,89,6,123
168272,2023-10-31 19:45:42,1270380002,72236,168,129,89,6,123
168272,2023-10-31 19:45:44,1270380024,72236,168,129,89,6,123
168272,2023-10-31 19:45:46,1270380041,72236,168,129,89,6,123
168285,2023-10-31 20:19:19,1270402227,12949,123,89,56,3,86
168285,2023-10-31 20:19:21,1270402248,12949,123,89,56,3,86
168285,2023-10-31 20:19:25,1270402282,12949,123,89,56,3,86
158848,2023-10-31 21:39:28,1270456937,130595,247,33,22,8,25
168322,2023-10-31 22:50:13,1270504907,0,55,57,38,0,57
168330,2023-10-31 23:33:11,1270535270,36518,85,126,92,8,118
168395,2023-11-01 18:43:15,1270954578,21391,95,17,7,4,13
168392,2023-11-01 19:06:29,1270970336,38062,268,64,23,9,55
118664,2023-11-01 19:49:02,1270998840,83642,158,41,20,6,35
168381,2023-11-01 19:50:30,1270999865,2376,14,86,34,1,85
72316,2023-11-01 21:25:49,1271072322,2376,14,86,34,1,85
168416,2023-11-03 16:20:25,1271954457,4889,16,4,1,3,1
168417,2023-11-03 16:24:43,1271957271,0,101,42,20,0,42
168419,2023-11-03 16:30:35,1271961002,893,24,3,1,1,2
168420,2023-11-03 16:36:48,1271964738,0,3,5,1,0,5
168421,2023-11-03 16:45:36,1271970426,50602,167,155,91,5,150
168421,2023-11-03 16:45:43,1271970496,50602,167,155,91,5,150
45740,2023-11-03 16:51:42,1271974256,30983,171,108,26,7,101
168433,2023-11-03 18:32:43,1272047107,2244,81,20,5,4,16
158405,2023-11-03 19:20:17,1272086823,75974,213,20,10,9,11
158405,2023-11-03 19:20:20,1272086856,75974,213,20,10,9,11
158405,2023-11-03 19:20:22,1272086884,75974,213,20,10,9,11
158612,2023-11-03 19:24:03,1272089845,1166,4,3,1,1,2
158612,2023-11-03 19:24:04,1272089864,1166,4,3,1,1,2
158584,2023-11-03 19:24:25,1272090110,808,5,12,5,2,10
158584,2023-11-03 19:24:27,1272090151,808,5,12,5,2,10
158582,2023-11-03 19:24:48,1272090397,41193,33,40,18,7,33
158582,2023-11-03 19:24:49,1272090414,41193,33,40,18,7,33
168451,2023-11-03 20:14:15,1272130854,0,0,14,12,0,14
168455,2023-11-03 20:30:55,1272142525,21781,133,47,13,5,42
168475,2023-11-03 21:52:26,1272223556,95358,108,34,21,9,25
108748,2023-11-03 22:03:46,1272227834,31518,31,61,24,2,59
108748,2023-11-03 22:03:51,1272227906,31518,31,61,24,2,59
168478,2023-11-03 22:29:17,1272247815,15316,105,8,7,4,4
160011,2023-11-04 14:26:56,1272466950,0,4,45,40,0,45
160010,2023-11-04 14:27:24,1272467052,27045,89,48,27,3,45
160020,2023-11-04 14:28:04,1272467185,0,2,165,86,0,165
160015,2023-11-04 14:28:50,1272467340,2171,43,91,52,1,90
168495,2023-11-04 17:11:27,1272525379,43887,36,155,61,5,150
168494,2023-11-04 17:11:52,1272525574,194904,143,40,27,10,30
168493,2023-11-04 17:12:10,1272525733,9861,46,27,20,3,24
168496,2023-11-04 17:17:57,1272528533,0,2,15,11,0,15
168496,2023-11-04 17:17:58,1272528545,0,2,15,11,0,15
168498,2023-11-04 18:24:32,1272562503,4471,7,14,6,1,13
168499,2023-11-04 18:28:30,1272564690,53649,51,63,41,4,59
168500,2023-11-04 18:32:23,1272566760,16568,56,41,20,3,38
168501,2023-11-04 18:34:48,1272568045,9147,37,16,7,2,14
168502,2023-11-04 18:43:07,1272572479,5717,34,14,6,1,13
168503,2023-11-04 18:53:19,1272577946,13117,40,17,6,2,15
168503,2023-11-04 18:53:25,1272577989,13117,40,17,6,2,15
98890,2023-11-05 01:08:07,1272746457,112577,169,102,71,8,94
168519,2023-11-06 14:38:32,1273233917,0,0,14,12,0,14
168526,2023-11-06 15:06:55,1273244087,51542,20,43,32,2,41
168524,2023-11-06 15:07:36,1273244328,124261,78,44,34,3,41
168523,2023-11-06 15:08:13,1273244581,4224,23,6,2,3,3
168522,2023-11-06 15:08:51,1273244808,1265,1,8,1,1,7
168520,2023-11-06 15:09:28,1273245037,226577,222,47,35,8,39
168518,2023-11-06 15:10:04,1273245319,91676,121,84,24,19,65
168511,2023-11-06 15:10:33,1273245491,5515,12,15,7,2,13
168509,2023-11-06 15:11:27,1273245881,14194,5,24,12,4,20
159406,2023-11-06 16:59:25,1273312232,67303,198,60,21,7,53
157538,2023-11-06 16:59:57,1273312628,13953,13,16,11,1,15
157541,2023-11-06 17:00:22,1273312941,1601,3,5,2,1,4
158945,2023-11-06 17:00:51,1273313247,109649,217,48,30,7,41
157537,2023-11-06 17:01:12,1273313493,28707,209,48,16,3,45
159499,2023-11-06 17:11:08,1273320405,47508,35,72,53,4,68
159500,2023-11-06 17:11:31,1273320659,72091,261,60,43,9,51
159501,2023-11-06 17:11:47,1273320853,57364,154,34,12,7,27
159502,2023-11-06 17:12:00,1273321013,4,5,15,7,1,14
159505,2023-11-06 17:12:16,1273321227,0,1,18,10,0,18
159507,2023-11-06 17:12:34,1273321438,12025,39,28,11,2,26
159509,2023-11-06 17:12:51,1273321645,94587,28,98,57,3,95
159510,2023-11-06 17:13:06,1273321836,33398,45,22,13,3,19
159549,2023-11-06 17:13:22,1273322023,39424,29,111,72,3,108
159557,2023-11-06 17:13:38,1273322211,2843,17,32,21,1,31
159558,2023-11-06 17:13:53,1273322403,30238,91,11,7,2,9
168541,2023-11-06 17:25:26,1273331198,19288,81,34,23,5,29
168544,2023-11-06 17:28:54,1273334014,77184,223,151,43,19,132
168551,2023-11-06 18:05:42,1273363027,23138,118,27,21,2,25
168550,2023-11-06 18:06:04,1273363322,11085,3,21,19,1,20
168549,2023-11-06 18:06:22,1273363587,16305,132,32,8,1,31
168548,2023-11-06 18:06:40,1273363833,0,1,18,15,0,18
168546,2023-11-06 18:07:12,1273364229,342031,309,73,27,12,61
168545,2023-11-06 18:07:31,1273364463,745846,75,30,24,4,26
168542,2023-11-06 18:07:53,1273364750,172946,203,65,33,10,55
168554,2023-11-06 18:13:16,1273369138,0,0,5,4,0,5
157711,2023-11-06 18:39:02,1273389846,0,0,15,7,0,15
157706,2023-11-06 18:39:27,1273390214,0,4,13,8,0,13
157818,2023-11-06 18:39:51,1273390508,286,1,6,1,1,5
157714,2023-11-06 18:40:19,1273390877,14704,115,54,14,2,52
157717,2023-11-06 18:40:42,1273391158,62057,74,40,25,5,35
157707,2023-11-06 18:41:05,1273391452,126957,25,42,29,3,39
168590,2023-11-06 20:21:48,1273469505,4624,33,9,7,1,8
168593,2023-11-06 20:51:15,1273493439,0,4,13,9,0,13
168599,2023-11-06 21:57:41,1273545052,761,70,43,6,1,42
168600,2023-11-06 22:09:35,1273553765,102775,396,78,46,17,61
168619,2023-11-06 22:49:33,1273583713,88827,162,14,3,11,3
168628,2023-11-06 23:24:14,1273608443,92636,68,46,9,4,42
168629,2023-11-06 23:29:20,1273612019,5765,7,58,34,1,57
168575,2023-11-06 23:36:18,1273616809,118105,123,53,36,7,46
168649,2023-11-07 12:45:33,1273821555,189562,253,62,29,20,42
168647,2023-11-07 12:45:57,1273821602,219191,197,67,32,8,59
168646,2023-11-07 12:46:17,1273821667,25935,553,44,12,4,40
168645,2023-11-07 12:46:49,1273821718,371280,382,69,11,4,65
168654,2023-11-07 14:35:07,1273842540,28767,140,16,13,7,9
168653,2023-11-07 14:35:35,1273842661,76736,357,64,21,46,18
142574,2023-11-07 14:58:26,1273850574,35361,79,86,43,3,83
142676,2023-11-07 14:58:57,1273850759,26140,176,38,23,8,30
142677,2023-11-07 14:59:38,1273850997,1661,33,62,36,1,61
142678,2023-11-07 15:00:02,1273851123,15287,19,39,29,2,37
149886,2023-11-07 15:00:34,1273851326,12561,270,50,19,10,40
147428,2023-11-07 15:06:05,1273853532,8990,33,86,66,5,81
168664,2023-11-07 15:18:51,1273859542,1897,15,8,6,2,6
168666,2023-11-07 15:20:42,1273860529,35856,49,80,52,3,77
168669,2023-11-07 15:45:29,1273874764,56927,76,15,15,5,10
159838,2023-11-07 17:13:17,1273936357,78191,173,58,38,9,49
159797,2023-11-07 17:14:09,1273937025,120853,226,95,60,13,82
159792,2023-11-07 17:15:04,1273937802,254564,104,57,12,12,45
147492,2023-11-07 17:16:10,1273938695,12382,84,19,14,5,14
147489,2023-11-07 17:16:51,1273939251,25149,193,31,9,9,22
119716,2023-11-07 17:19:36,1273941384,158734,138,68,35,3,65
159828,2023-11-07 17:22:28,1273943674,8501,31,28,12,5,23
159825,2023-11-07 17:23:16,1273944320,126294,79,13,9,5,8
159822,2023-11-07 17:23:58,1273944858,84190,87,40,14,6,34
159823,2023-11-07 17:24:30,1273945304,0,0,13,9,0,13
159821,2023-11-07 17:25:01,1273945715,0,0,7,5,0,7
157525,2023-11-07 17:30:16,1273949895,15750,13,20,15,2,18
157177,2023-11-07 17:30:59,1273950449,16890,284,27,6,9,18
158847,2023-11-07 17:31:35,1273950889,15461,138,16,8,7,9
159061,2023-11-07 17:34:04,1273952773,23033,130,47,35,8,39
159062,2023-11-07 17:34:35,1273953175,2740,23,32,22,2,30
159142,2023-11-07 17:35:14,1273953701,15246,34,6,1,3,3
159830,2023-11-07 17:46:14,1273962365,14187,224,39,28,7,32
160227,2023-11-07 17:46:56,1273962909,217955,224,64,27,16,48
159837,2023-11-07 17:48:07,1273963879,6333,152,28,12,2,26
156718,2023-11-07 17:49:21,1273964863,12858,139,63,49,4,59
160616,2023-11-07 17:58:58,1273972587,59953,164,100,65,5,95
160613,2023-11-07 17:59:43,1273973166,61201,163,74,45,8,66
168681,2023-11-07 18:40:41,1274006209,3275,1,4,0,1,3
168683,2023-11-07 18:47:07,1274011416,25059,25,103,74,3,100
168682,2023-11-07 18:54:11,1274017102,58726,186,60,8,9,51
168696,2023-11-07 19:26:48,1274043270,35784,80,20,12,5,15
168695,2023-11-07 19:27:10,1274043583,6707,36,5,2,3,2
168693,2023-11-07 19:27:36,1274043884,69617,209,21,7,7,14
168691,2023-11-07 19:27:59,1274044224,19301,84,31,5,7,24
168684,2023-11-07 19:28:26,1274044612,13579,48,16,12,3,13
168707,2023-11-07 22:01:35,1274158602,68528,275,33,20,15,18
168706,2023-11-07 22:01:59,1274158891,87792,223,168,25,5,163
168709,2023-11-07 22:04:29,1274160700,25632,74,29,23,4,25
168708,2023-11-07 22:05:04,1274161115,10726,338,64,15,4,60
168716,2023-11-07 22:33:27,1274181075,24965,153,14,8,3,11
168719,2023-11-07 23:11:04,1274206636,31388,118,15,8,9,6
168722,2023-11-07 23:20:25,1274212893,0,3,4,1,0,4
168723,2023-11-07 23:27:49,1274217906,50599,231,49,32,12,37
168721,2023-11-07 23:31:35,1274220374,50162,147,37,9,8,29
168720,2023-11-07 23:31:56,1274220565,39278,44,25,9,5,20
168729,2023-11-08 13:07:34,1274451148,37923,227,51,33,5,46
168728,2023-11-08 13:08:08,1274451242,67651,141,29,14,7,22
168727,2023-11-08 13:08:29,1274451293,16850,65,25,18,3,22
143242,2023-11-08 13:42:43,1274458100,0,0,5,2,0,5
168732,2023-11-08 15:11:37,1274485703,0,1,9,7,0,9
160674,2023-11-08 15:13:36,1274486650,48568,119,19,6,8,11
160674,2023-11-08 15:13:39,1274486670,48568,119,19,6,8,11
160675,2023-11-08 15:15:29,1274487580,19613,106,31,18,5,26
160668,2023-11-08 15:15:50,1274487768,11955,27,36,13,3,33
160668,2023-11-08 15:15:52,1274487776,11955,27,36,13,3,33
160668,2023-11-08 15:15:53,1274487789,11955,27,36,13,3,33
160671,2023-11-08 15:16:19,1274488024,0,3,16,7,0,16
160671,2023-11-08 15:16:21,1274488043,0,3,16,7,0,16
168734,2023-11-08 15:18:37,1274489168,26669,27,44,36,1,43
160728,2023-11-08 15:20:45,1274490235,47661,43,57,34,4,53
160728,2023-11-08 15:20:48,1274490264,47661,43,57,34,4,53
160814,2023-11-08 15:21:03,1274490383,49252,49,38,29,4,34
160814,2023-11-08 15:21:07,1274490425,49252,49,38,29,4,34
159584,2023-11-08 15:24:27,1274492301,7326,27,65,44,1,64
159606,2023-11-08 15:24:41,1274492422,221,31,38,24,4,34
159791,2023-11-08 15:24:55,1274492560,67279,95,95,49,7,88
159547,2023-11-08 15:25:14,1274492739,849,40,43,18,2,41
159772,2023-11-08 15:25:30,1274492897,25354,146,21,9,3,18
108672,2023-11-08 16:26:59,1274533909,41042,107,45,29,3,42
108501,2023-11-08 16:27:53,1274534563,32917,92,92,58,6,86
108499,2023-11-08 16:28:25,1274534965,41042,99,91,39,3,88
108479,2023-11-08 16:30:41,1274536715,58702,76,119,59,14,105
108479,2023-11-08 16:30:45,1274536744,58702,76,119,59,14,105
149448,2023-11-08 16:33:59,1274539126,72654,62,35,16,5,30
106899,2023-11-08 16:45:31,1274549868,30106,19,57,24,5,52
160687,2023-11-08 17:32:45,1274587253,522,30,26,21,1,25
160689,2023-11-08 17:33:03,1274587458,60507,266,70,48,10,60
150698,2023-11-08 17:33:24,1274587714,13681,44,51,24,5,46
116128,2023-11-08 17:33:43,1274587988,15136,81,56,35,2,54
116844,2023-11-08 17:34:01,1274588241,39462,32,32,19,3,29
105234,2023-11-08 17:34:22,1274588534,13047,43,41,14,4,37
112961,2023-11-08 17:37:19,1274590850,24925,23,60,46,1,59
112963,2023-11-08 17:37:31,1274590994,6567,48,45,29,2,43
147596,2023-11-08 17:37:52,1274591296,23078,54,16,13,5,11
147603,2023-11-08 17:38:15,1274591574,12264,84,78,57,3,75
111206,2023-11-08 17:38:35,1274591794,45618,160,87,63,9,78
168794,2023-11-08 18:28:43,1274634394,30304,78,36,21,5,31
168799,2023-11-08 18:54:26,1274671062,2260,9,5,4,1,4
168797,2023-11-08 18:54:53,1274671617,65556,319,33,21,9,24
168769,2023-11-08 18:55:13,1274672069,224913,273,97,45,20,77
168801,2023-11-08 19:06:23,1274686062,290420,615,92,24,33,59
168802,2023-11-08 19:13:40,1274695366,0,85,22,4,0,22
168803,2023-11-08 19:16:27,1274698917,6040,4,65,25,1,64
168811,2023-11-08 19:38:56,1274728602,63,58,16,8,1,15
168812,2023-11-08 19:43:21,1274734482,43721,36,92,25,4,88
168818,2023-11-08 21:16:59,1274811172,2424,14,19,13,1,18
168821,2023-11-08 21:24:50,1274816996,86486,78,17,8,5,12
168822,2023-11-08 21:32:08,1274822411,28395,27,36,30,3,33
168826,2023-11-08 22:05:41,1274848109,0,0,1,0,0,1
168824,2023-11-08 22:13:06,1274853857,11036,44,22,7,5,17
150322,2023-11-08 22:20:01,1274859155,9431,171,42,10,3,39
168828,2023-11-08 22:21:01,1274859862,12832,69,27,13,3,24
150323,2023-11-08 22:21:01,1274859865,225144,155,90,62,10,80
150324,2023-11-08 22:21:23,1274860156,7078,333,48,5,7,41
150324,2023-11-08 22:21:29,1274860167,6438,332,46,4,6,40
150328,2023-11-08 22:21:38,1274860324,192051,115,34,25,5,29
150330,2023-11-08 22:23:33,1274861850,2733,28,54,31,1,53
156285,2023-11-08 22:24:19,1274862486,4168,38,64,46,4,60
156284,2023-11-08 22:24:45,1274862728,8251,171,92,60,2,90
130871,2023-11-08 22:25:02,1274863022,14337,53,24,18,3,21
157718,2023-11-08 22:25:42,1274863505,54006,41,21,16,3,18
157110,2023-11-08 22:26:02,1274863711,42637,577,78,28,6,72
159668,2023-11-09 14:44:56,1275179067,15047,149,7,3,4,3
159670,2023-11-09 14:45:42,1275179410,20371,95,50,32,3,47
159679,2023-11-09 14:46:11,1275179613,13481,26,16,9,3,13
159680,2023-11-09 14:47:05,1275179932,41583,144,39,11,8,31
159682,2023-11-09 14:47:24,1275180053,4658,5,13,9,1,12
159684,2023-11-09 14:47:56,1275180261,42256,200,151,38,12,139
168830,2023-11-09 14:57:12,1275184398,42780,112,19,10,7,12
168830,2023-11-09 14:57:14,1275184403,42780,112,19,10,7,12
168830,2023-11-09 14:57:17,1275184428,42780,112,19,10,7,12
168830,2023-11-09 14:57:19,1275184440,42780,112,19,10,7,12
168845,2023-11-09 14:57:27,1275184493,10909,33,53,32,6,47
168845,2023-11-09 14:57:28,1275184508,10909,33,53,32,6,47
168845,2023-11-09 14:57:30,1275184518,10909,33,53,32,6,47
168848,2023-11-09 15:53:38,1275218352,47091,123,45,6,5,40
168859,2023-11-09 16:55:40,1275264595,27366,37,16,8,3,13
168869,2023-11-09 17:05:01,1275272057,11571,37,70,43,6,64
168858,2023-11-09 17:11:35,1275277854,70173,494,103,53,25,78
168856,2023-11-09 17:11:58,1275278164,111455,113,55,48,7,48
168854,2023-11-09 17:12:58,1275279217,188593,199,73,45,7,66
168854,2023-11-09 17:12:59,1275279233,188593,199,73,45,7,66
168853,2023-11-09 17:13:47,1275280101,107704,311,46,35,7,39
168852,2023-11-09 17:14:36,1275281005,19508,63,27,10,7,20
168850,2023-11-09 17:15:59,1275282555,30329,57,5,3,3,2
168886,2023-11-09 18:25:30,1275357415,66177,57,67,34,2,65
168907,2023-11-09 21:02:48,1275482790,12754,113,59,49,2,57
168909,2023-11-09 21:07:03,1275485951,68278,268,36,24,11,25
168910,2023-11-09 21:10:17,1275488467,0,0,2,2,0,2
168908,2023-11-09 21:10:37,1275488718,264087,173,47,37,5,42
168906,2023-11-09 21:10:55,1275488949,3162,72,20,2,4,16
168903,2023-11-09 21:11:15,1275489216,57828,31,24,23,4,20
168902,2023-11-09 21:11:42,1275489564,397,1,6,3,1,5
168893,2023-11-09 21:12:03,1275489796,199605,137,109,57,6,103
168916,2023-11-09 21:31:15,1275504813,13323,148,32,11,2,30
168915,2023-11-09 21:32:19,1275505544,3815,54,13,5,5,8
168912,2023-11-09 21:34:35,1275507258,41860,94,75,58,8,67
168920,2023-11-09 22:26:32,1275546169,1682,4,3,0,1,2
168919,2023-11-09 22:31:46,1275550084,95368,55,50,47,5,45
168921,2023-11-09 22:41:02,1275556579,16046,69,56,37,4,52
168924,2023-11-09 22:59:25,1275569775,25641,102,62,28,16,46
168923,2023-11-09 22:59:48,1275570063,26092,55,76,34,6,70
168922,2023-11-09 23:00:10,1275570347,111470,116,80,48,7,73
168944,2023-11-10 14:22:33,1275859048,143963,802,122,75,28,94
168959,2023-11-10 14:58:00,1275871211,12517,116,15,12,5,10
168960,2023-11-10 15:08:56,1275875641,75049,334,94,75,8,86
168960,2023-11-10 15:08:57,1275875642,75049,334,94,75,8,86
168960,2023-11-10 15:09:03,1275875688,75049,334,94,75,8,86
168961,2023-11-10 15:12:56,1275877411,57560,40,8,8,2,6
168963,2023-11-10 15:29:36,1275886091,0,9,68,0,0,68
168962,2023-11-10 15:29:58,1275886261,54546,42,14,8,3,11
151740,2023-11-10 15:55:09,1275900998,1350,15,54,44,2,52
168970,2023-11-10 15:59:23,1275903695,3923,18,7,4,2,5
168970,2023-11-10 15:59:25,1275903718,3923,18,7,4,2,5
168972,2023-11-10 16:14:09,1275913154,21810,69,20,7,3,17
168972,2023-11-10 16:14:13,1275913201,21810,69,20,7,3,17
168946,2023-11-10 16:28:07,1275922728,17482,33,17,9,2,15
106920,2023-11-10 16:46:57,1275936794,30013,1,34,14,1,33
106886,2023-11-10 16:47:19,1275937099,34114,11,72,41,2,70
129501,2023-11-10 16:47:35,1275937331,0,1,3,1,0,3
131017,2023-11-10 16:47:50,1275937554,36708,264,52,17,4,48
131141,2023-11-10 16:48:05,1275937789,0,44,11,6,0,11
160382,2023-11-10 16:48:20,1275937994,11743,76,6,3,2,4
123227,2023-11-10 16:54:08,1275942735,82719,208,71,53,9,62
123320,2023-11-10 16:54:30,1275942994,35685,73,32,22,4,28
123226,2023-11-10 16:54:45,1275943174,15640,52,15,12,3,12
135940,2023-11-10 16:54:56,1275943315,0,5,8,6,0,8
150374,2023-11-10 16:55:19,1275943663,422,60,14,10,1,13
159079,2023-11-10 18:39:31,1276027079,21352,87,43,21,4,39
159832,2023-11-10 18:39:48,1276027289,10461,21,21,16,3,18
159834,2023-11-10 18:50:51,1276036002,5854,26,15,3,4,11
148939,2023-11-10 19:33:43,1276070020,108501,151,36,17,4,32
148894,2023-11-10 19:34:10,1276070417,35068,49,38,30,4,34
148906,2023-11-10 19:34:37,1276070756,101493,17,50,44,2,48
148907,2023-11-10 19:35:03,1276071102,162739,28,26,9,2,24
148911,2023-11-10 19:35:30,1276071479,27870,106,74,34,4,70
168983,2023-11-10 20:11:08,1276099447,6658,13,45,27,1,44
168984,2023-11-10 20:19:59,1276106234,27086,88,78,35,6,72
168986,2023-11-10 20:25:51,1276110622,40230,294,113,42,7,106
168988,2023-11-10 20:35:19,1276117838,3992,89,55,29,2,53
168990,2023-11-10 21:15:47,1276148301,32428,276,26,18,4,22
168992,2023-11-10 21:22:45,1276153643,55481,74,39,12,1,38
168994,2023-11-10 21:30:40,1276159770,31169,252,45,23,12,33
159747,2023-11-10 22:58:40,1276235014,32918,113,38,11,6,32
159744,2023-11-10 22:59:03,1276235417,14822,99,22,16,1,21
159749,2023-11-10 22:59:20,1276235788,72257,75,67,25,3,64
159745,2023-11-10 22:59:38,1276236109,102932,60,80,57,7,73
159750,2023-11-10 22:59:59,1276236512,65311,49,13,4,5,8
159748,2023-11-10 23:00:26,1276237028,51765,53,44,26,4,40
2564,2023-11-10 23:45:49,1276282012,47116,101,32,19,7,25
74420,2023-11-10 23:46:22,1276282377,56132,162,41,9,7,34
126185,2023-11-11 14:41:07,1276905492,26394,32,15,4,10,5
126189,2023-11-11 14:42:03,1276905685,177129,149,36,24,10,26
126191,2023-11-11 14:42:28,1276905789,103130,55,16,8,3,13
148645,2023-11-11 14:42:55,1276905884,854,48,120,108,1,119
133749,2023-11-11 14:43:29,1276906024,70074,297,50,26,8,42
143349,2023-11-11 15:08:10,1276912611,26595,11,75,37,2,73
143731,2023-11-11 15:08:12,1276912635,0,0,23,14,0,23
142171,2023-11-11 15:08:52,1276912846,32531,39,65,38,2,63
143361,2023-11-11 15:09:38,1276913095,0,11,89,68,0,89
143340,2023-11-11 15:09:45,1276913132,7772,53,69,28,7,62
143381,2023-11-11 15:09:50,1276913149,25744,9,63,40,1,62
169021,2023-11-11 15:52:00,1276929008,246,24,18,15,1,17
133748,2023-11-11 15:59:33,1276932132,2344,28,10,4,1,9
101336,2023-11-11 16:41:05,1276953232,29928,69,8,4,6,2
101336,2023-11-11 16:41:10,1276953283,29928,69,8,4,6,2
124746,2023-11-11 16:41:49,1276953568,14320,147,145,23,7,138
147029,2023-11-11 16:42:40,1276954044,31,21,28,18,1,27
101066,2023-11-11 16:43:14,1276954334,6805,18,87,40,1,86
130446,2023-11-11 16:47:09,1276956407,40760,152,26,9,8,18
117813,2023-11-11 16:47:47,1276956753,0,0,2,0,0,2
97550,2023-11-11 16:49:00,1276957385,1693,11,21,7,1,20
97550,2023-11-11 16:49:02,1276957407,1693,11,21,7,1,20
97548,2023-11-11 16:49:40,1276957761,603,7,68,17,1,67
97552,2023-11-11 16:50:16,1276958113,156240,208,52,25,14,38
97568,2023-11-11 16:51:07,1276958594,23846,140,46,24,5,41
169026,2023-11-11 16:51:41,1276958938,45671,289,36,15,4,32
169027,2023-11-11 16:52:19,1276959305,4544,28,25,19,1,24
157308,2023-11-11 17:00:23,1276963887,0,6,33,20,0,33
157285,2023-11-11 17:00:22,1276963894,34779,77,30,12,5,25
157320,2023-11-11 17:00:33,1276963988,31955,111,59,26,6,53
157386,2023-11-11 17:01:48,1276964731,410410,366,97,37,20,77
157803,2023-11-11 17:01:50,1276964760,0,5,32,20,0,32
157398,2023-11-11 17:01:54,1276964785,2672,42,24,8,6,18
169029,2023-11-11 17:25:42,1276978371,22891,35,56,34,4,52
169031,2023-11-11 17:25:59,1276978511,32072,114,29,18,2,27
169032,2023-11-11 17:26:17,1276978738,0,0,62,38,0,62
120016,2023-11-11 18:55:41,1277034336,55664,98,60,44,7,53
120023,2023-11-11 18:55:44,1277034380,5402,19,29,13,1,28
130978,2023-11-11 18:56:16,1277034680,13413,59,33,26,4,29
149404,2023-11-11 18:56:49,1277035000,0,2,34,27,0,34
159598,2023-11-11 18:57:29,1277035463,6533,223,12,7,2,10
159599,2023-11-11 18:57:29,1277035464,4602,21,14,2,2,12
159116,2023-11-11 19:05:16,1277040542,3213,22,15,11,1,14
159124,2023-11-11 19:05:19,1277040591,22873,51,34,17,5,29
159110,2023-11-11 19:05:22,1277040631,9878,107,24,17,2,22
159015,2023-11-11 19:05:25,1277040662,16682,49,14,6,2,12
159006,2023-11-11 19:05:28,1277040695,96368,283,20,13,8,12
123980,2023-11-11 19:10:16,1277043837,21868,167,34,25,8,26
152440,2023-11-11 19:11:22,1277044542,63384,136,28,22,4,24
141864,2023-11-11 19:11:25,1277044563,15897,68,86,65,4,82
123983,2023-11-11 19:11:26,1277044582,12600,183,36,25,6,30
123984,2023-11-11 19:11:29,1277044601,4741,47,30,20,3,27
169047,2023-11-13 14:40:26,1277823292,27797,165,23,18,6,17
169043,2023-11-13 15:38:46,1277848893,1521,85,86,35,2,84
169061,2023-11-13 15:47:18,1277854125,13794,171,142,69,2,140
169062,2023-11-13 15:52:37,1277857442,1944,7,85,44,1,84
169063,2023-11-13 15:53:54,1277858156,18799,198,43,34,2,41
169064,2023-11-13 15:58:31,1277861036,9872,34,53,37,1,52
169067,2023-11-13 16:02:37,1277863752,0,10,51,36,0,51
169070,2023-11-13 16:06:41,1277866309,6149,18,43,29,1,42
123185,2023-11-13 16:16:19,1277872756,0,1,70,38,0,70
123188,2023-11-13 16:16:44,1277873043,766,7,22,4,1,21
123182,2023-11-13 16:17:07,1277873322,20944,15,94,47,1,93
135725,2023-11-13 16:17:25,1277873535,1516,26,42,36,1,41
123180,2023-11-13 16:17:42,1277873716,828,11,2,2,1,1
153239,2023-11-13 17:05:33,1277909622,157425,156,131,52,8,123
153145,2023-11-13 17:07:38,1277911144,38934,268,53,16,8,45
169099,2023-11-13 17:44:53,1277941940,0,0,7,0,0,7
169097,2023-11-13 17:46:58,1277943769,5266,55,23,12,2,21
169101,2023-11-13 17:52:43,1277948859,0,2,36,12,0,36
169101,2023-11-13 17:52:49,1277948980,0,2,36,12,0,36
169042,2023-11-13 18:13:00,1277966598,50408,233,95,46,9,86
169102,2023-11-13 18:16:57,1277970209,122615,67,33,22,4,29
97777,2023-11-13 18:18:32,1277971572,147546,343,164,33,16,148
98276,2023-11-13 18:18:34,1277971604,61292,132,20,9,5,15
108975,2023-11-13 18:18:36,1277971629,17925,47,11,3,5,6
149818,2023-11-13 18:18:37,1277971667,31045,32,25,9,8,17
149293,2023-11-13 18:18:41,1277971710,12439,184,60,20,10,50
169104,2023-11-13 18:20:53,1277973693,91755,31,23,9,5,18
132917,2023-11-13 18:23:02,1277975508,50963,184,57,22,9,48
133137,2023-11-13 18:23:18,1277975755,11400,174,40,21,3,37
133141,2023-11-13 18:23:36,1277975989,21790,62,40,33,5,35
111272,2023-11-13 18:24:19,1277976617,42862,116,35,29,6,29
101349,2023-11-13 18:24:48,1277977001,52934,68,36,22,4,32
101349,2023-11-13 18:24:50,1277977041,52934,68,36,22,4,32
169105,2023-11-13 18:25:04,1277977233,23309,141,27,14,4,23
169114,2023-11-13 18:48:32,1277997947,17773,57,55,38,2,53
169115,2023-11-13 18:53:36,1278002535,0,0,8,8,0,8
169116,2023-11-13 19:18:50,1278025456,23301,65,22,16,3,19
169028,2023-11-13 20:47:15,1278102470,18217,69,85,45,5,80
169136,2023-11-13 22:24:34,1278184316,16272,61,8,0,6,2
169138,2023-11-13 23:04:07,1278216548,10680,28,28,18,1,27
169137,2023-11-13 23:04:41,1278216990,201,15,44,16,1,43
169141,2023-11-13 23:15:21,1278225522,24477,31,12,5,2,10
169140,2023-11-13 23:15:47,1278225913,118148,125,54,36,7,47
169139,2023-11-13 23:16:06,1278226214,22613,231,14,5,6,8
169167,2023-11-14 15:21:20,1278509920,1239,5,2,1,1,1
169167,2023-11-14 15:21:24,1278509944,1239,5,2,1,1,1
169168,2023-11-14 15:44:38,1278522992,0,2,82,71,0,82
169170,2023-11-14 15:57:37,1278531038,1379,8,10,4,1,9
169171,2023-11-14 15:57:57,1278531252,8102,179,77,38,4,73
169173,2023-11-14 15:58:40,1278531688,65264,209,86,31,7,79
169187,2023-11-14 16:49:12,1278567897,11239,6,70,37,2,68
169191,2023-11-14 17:12:10,1278586974,24739,96,55,39,5,50
169195,2023-11-14 17:20:49,1278594274,3354,25,13,9,1,12
169194,2023-11-14 17:21:08,1278594556,32149,36,11,2,3,8
169151,2023-11-14 17:39:07,1278610130,31098,267,84,64,11,73
148520,2023-11-14 17:44:23,1278614731,8459,23,27,17,2,25
148521,2023-11-14 17:44:38,1278614971,12883,48,24,14,2,22
148524,2023-11-14 17:44:53,1278615188,31224,39,26,18,4,22
148550,2023-11-14 17:45:08,1278615415,8051,22,64,52,3,61
149119,2023-11-14 17:45:22,1278615682,1094,8,5,0,1,4
169209,2023-11-14 18:27:36,1278652498,18410,7,7,5,1,6
169210,2023-11-14 18:28:06,1278652979,55129,151,12,8,5,7
101320,2023-11-14 18:37:45,1278661783,6150,75,31,8,1,30
101668,2023-11-14 18:38:12,1278662171,6150,22,17,10,1,16
101668,2023-11-14 18:38:14,1278662202,6150,22,17,10,1,16
101401,2023-11-14 18:38:43,1278662638,6150,22,27,10,1,26
101308,2023-11-14 18:41:13,1278664842,36805,51,55,28,2,53
101379,2023-11-14 18:41:42,1278665322,17734,188,81,13,19,62
101314,2023-11-14 18:42:11,1278665767,56099,190,140,20,13,127
101350,2023-11-14 18:42:40,1278666233,431364,375,73,29,9,64
101642,2023-11-14 18:43:08,1278666625,40219,47,58,35,2,56
169215,2023-11-14 18:49:32,1278672517,9316,9,3,0,2,1
169220,2023-11-14 19:21:18,1278701092,35432,87,8,2,4,4
169221,2023-11-14 19:26:40,1278705762,244320,102,33,10,3,30
169218,2023-11-14 19:27:52,1278706759,38869,45,9,1,6,3
60176,2023-11-14 19:59:41,1278734492,18976,27,82,33,1,81
169219,2023-11-14 20:10:03,1278743396,185533,73,48,37,5,43
169229,2023-11-14 20:10:27,1278743715,0,7,69,27,0,69
169238,2023-11-14 20:16:23,1278748638,7867,29,9,8,2,7
169239,2023-11-14 20:21:07,1278752802,0,0,2,2,0,2
169230,2023-11-14 20:21:34,1278753135,22348,21,50,31,2,48
169231,2023-11-14 20:21:47,1278753327,160654,152,43,32,5,38
169232,2023-11-14 20:22:04,1278753566,28452,79,36,10,2,34
169237,2023-11-14 20:22:47,1278754190,19836,25,2,2,1,1
147802,2023-11-14 21:18:46,1278802131,11048,73,36,25,12,24
147827,2023-11-14 21:19:07,1278802407,20108,29,49,29,2,47
169241,2023-11-14 21:31:16,1278812718,130523,30,44,28,2,42
169246,2023-11-14 21:32:17,1278813627,16342,136,51,21,6,45
169244,2023-11-14 21:32:40,1278813937,7169,34,34,6,2,32
169243,2023-11-14 21:33:10,1278814412,28892,20,9,6,2,7
169242,2023-11-14 21:33:32,1278814747,22225,36,48,15,4,44
169247,2023-11-14 21:41:15,1278821498,5942,108,20,9,2,18
169248,2023-11-14 21:46:37,1278826062,102463,146,158,5,7,151
169249,2023-11-14 22:01:54,1278839233,18096,74,15,7,1,14
169250,2023-11-14 22:02:54,1278840070,169849,67,36,25,4,32
169251,2023-11-14 22:05:42,1278842350,10222,25,13,3,1,12
169253,2023-11-14 22:36:22,1278867418,56348,85,27,24,3,24
169214,2023-11-14 23:01:57,1278887805,6036,165,48,14,7,41
169303,2023-11-15 16:23:53,1279263875,25322,46,25,13,9,16
169303,2023-11-15 16:24:43,1279264637,25322,46,25,13,9,16
169303,2023-11-15 16:25:57,1279265658,25322,46,25,13,9,16
169304,2023-11-15 16:31:33,1279270525,38683,94,13,8,8,5
150511,2023-11-15 18:44:28,1279394002,80138,76,132,38,11,121
101401,2023-11-15 18:53:44,1279403326,6150,22,27,10,1,26
169327,2023-11-15 19:28:11,1279436803,46444,44,32,13,4,28
169218,2023-11-15 19:30:53,1279439307,44884,47,9,1,8,1
169331,2023-11-15 19:43:22,1279450902,29504,217,25,6,5,20
169331,2023-11-15 19:43:26,1279450962,29504,217,25,6,5,20
169331,2023-11-15 19:43:33,1279451052,29504,217,25,6,5,20
169331,2023-11-15 19:43:36,1279451104,29504,217,25,6,5,20
169331,2023-11-15 19:50:43,1279458370,29504,217,25,6,5,20
169331,2023-11-15 19:50:51,1279458500,29504,217,25,6,5,20
169331,2023-11-15 19:50:52,1279458515,29504,217,25,6,5,20
169331,2023-11-15 20:06:18,1279473382,29504,217,25,6,5,20
169331,2023-11-15 20:06:20,1279473410,29504,217,25,6,5,20
169331,2023-11-15 20:06:22,1279473423,29504,217,25,6,5,20
169334,2023-11-15 20:49:56,1279514144,25859,125,10,2,5,5
169334,2023-11-15 20:50:08,1279514334,25859,125,10,2,5,5
169334,2023-11-15 20:50:10,1279514382,25859,125,10,2,5,5
169337,2023-11-15 21:06:45,1279530368,259033,72,29,27,5,24
169326,2023-11-15 21:20:05,1279543566,204134,74,66,44,7,59
169326,2023-11-15 21:20:10,1279543661,204134,74,66,44,7,59
169326,2023-11-15 21:20:21,1279543835,204134,74,66,44,7,59
169326,2023-11-15 21:20:23,1279543861,204134,74,66,44,7,59
169326,2023-11-15 21:20:25,1279543886,204134,74,66,44,7,59
169342,2023-11-15 21:26:56,1279549984,90658,213,46,38,8,38
169342,2023-11-15 21:26:58,1279550014,90658,213,46,38,8,38
169342,2023-11-15 21:27:01,1279550077,90658,213,46,38,8,38
169346,2023-11-15 21:48:52,1279570482,4903,102,21,10,4,17
169346,2023-11-15 21:48:53,1279570495,4903,102,21,10,4,17
169346,2023-11-15 21:48:57,1279570561,4903,102,21,10,4,17
169328,2023-11-15 22:18:07,1279596622,11629,42,4,1,2,2
169328,2023-11-15 22:18:08,1279596645,11629,42,4,1,2,2
169328,2023-11-15 22:18:11,1279596690,11629,42,4,1,2,2
169328,2023-11-15 22:18:12,1279596710,11629,42,4,1,2,2
169338,2023-11-15 22:19:52,1279598156,5485,12,1,0,1,0
169338,2023-11-15 22:19:54,1279598179,5485,12,1,0,1,0
169339,2023-11-15 22:20:19,1279598539,31717,35,18,15,2,16
169355,2023-11-15 22:52:52,1279627078,11335,214,84,67,5,79
169375,2023-11-16 14:19:48,1280037875,3503291,163,29,16,7,22
169375,2023-11-16 14:20:04,1280037964,3503291,163,29,16,7,22
169375,2023-11-16 14:20:25,1280038058,3503291,163,29,16,7,22
169403,2023-11-16 14:27:21,1280040623,84989,168,41,32,3,38
169403,2023-11-16 14:28:00,1280040853,84989,168,41,32,3,38
169329,2023-11-16 14:29:34,1280041586,52101,90,24,17,4,20
169329,2023-11-16 14:29:37,1280041606,52101,90,24,17,4,20
169329,2023-11-16 14:34:54,1280043822,52101,90,24,17,4,20
169329,2023-11-16 14:34:58,1280043848,52101,90,24,17,4,20
169336,2023-11-16 14:40:06,1280046092,93049,117,23,17,7,16
169411,2023-11-16 15:18:22,1280066851,140598,119,97,62,12,85
95676,2023-11-16 15:40:59,1280082705,2686,20,4,1,2,2
95703,2023-11-16 15:42:56,1280084084,111884,157,23,12,8,15
130217,2023-11-16 15:50:44,1280089864,3279,321,14,4,2,12
118742,2023-11-16 15:54:18,1280092600,5048,8,58,43,4,54
169377,2023-11-16 16:16:44,1280111147,91742,365,118,57,17,101
169377,2023-11-16 16:17:44,1280112028,91742,365,118,57,17,101
169433,2023-11-16 16:24:51,1280118264,29803,71,20,10,4,16
169434,2023-11-16 16:36:13,1280128746,27986,67,19,12,7,12
169373,2023-11-16 16:38:06,1280130590,13582,48,49,32,9,40
169373,2023-11-16 16:38:08,1280130625,13582,48,49,32,9,40
169373,2023-11-16 16:38:09,1280130668,13582,48,49,32,9,40
169373,2023-11-16 16:39:42,1280132104,13582,48,49,32,9,40
169439,2023-11-16 16:55:33,1280146380,35959,88,92,52,4,88
169332,2023-11-16 17:23:44,1280171449,0,34,49,2,0,49
169333,2023-11-16 17:23:49,1280171531,0,20,9,0,0,9
169289,2023-11-16 17:25:02,1280172535,23384,91,61,38,4,57
169289,2023-11-16 17:26:59,1280174478,23384,91,61,38,4,57
169441,2023-11-16 17:27:16,1280174775,1196,2,11,9,1,10
169290,2023-11-16 17:27:32,1280175012,31577,35,14,3,2,12
169291,2023-11-16 17:27:46,1280175257,5539,45,30,18,6,24
169435,2023-11-16 17:28:00,1280175453,10205,178,26,16,5,21
169450,2023-11-16 18:33:02,1280234005,3495,12,51,31,2,49
169451,2023-11-16 18:35:09,1280236015,2028,21,8,3,1,7
169453,2023-11-16 18:50:06,1280250647,5649,102,2,1,1,1
169452,2023-11-16 18:54:38,1280255092,45234,31,20,6,3,17
169456,2023-11-16 18:54:53,1280255321,87097,92,28,21,3,25
169454,2023-11-16 18:55:00,1280255425,44936,199,61,29,10,51
169455,2023-11-16 18:55:27,1280255923,0,34,6,3,0,6
169379,2023-11-16 19:01:07,1280261525,3991,35,21,18,1,20
169374,2023-11-16 19:06:20,1280266566,38286,236,26,18,3,23
169456,2023-11-16 19:06:21,1280266594,87097,92,28,21,3,25
169463,2023-11-16 19:21:50,1280281742,31285,30,4,4,3,1
169458,2023-11-16 19:28:28,1280288141,4183,5,4,1,1,3
169458,2023-11-16 19:28:32,1280288195,4183,5,4,1,1,3
169459,2023-11-16 19:28:41,1280288320,38566,50,22,15,3,19
169459,2023-11-16 19:28:42,1280288343,38566,50,22,15,3,19
169462,2023-11-16 19:28:53,1280288503,3548,5,6,1,2,4
169462,2023-11-16 19:28:54,1280288523,3548,5,6,1,2,4
169462,2023-11-16 19:28:55,1280288540,3548,5,6,1,2,4
169341,2023-11-16 19:58:58,1280315960,7239,9,3,2,1,2
169341,2023-11-16 20:02:05,1280318520,7239,9,3,2,1,2
169345,2023-11-16 20:02:40,1280318974,63183,124,16,15,5,11
169487,2023-11-16 20:18:52,1280333369,0,0,1,1,0,1
110747,2023-11-16 20:22:31,1280336620,28312,125,78,61,5,73
110612,2023-11-16 20:24:18,1280338136,288,199,106,58,2,104
110612,2023-11-16 20:24:46,1280338596,288,199,106,58,2,104
110610,2023-11-16 20:29:43,1280342980,15302,18,50,39,3,47
110599,2023-11-16 20:49:04,1280360269,41044,94,329,38,3,326
110596,2023-11-16 21:39:33,1280406227,12059,29,22,11,3,19
169494,2023-11-16 22:07:51,1280431540,153366,137,33,21,10,23
169494,2023-11-16 22:07:52,1280431558,153366,137,33,21,10,23
169494,2023-11-16 22:07:55,1280431600,153366,137,33,21,10,23
169497,2023-11-16 22:21:15,1280444406,30120,188,50,36,8,42
169497,2023-11-16 22:21:21,1280444438,30120,183,49,36,8,41
169497,2023-11-16 22:21:23,1280444474,30120,183,49,36,8,41
169498,2023-11-16 22:43:58,1280464321,19364,99,19,14,2,17
169520,2023-11-17 14:40:30,1280889388,57561,141,49,44,5,44
169520,2023-11-17 14:40:47,1280889537,57561,141,49,44,5,44
169520,2023-11-17 14:41:19,1280889891,57561,141,49,44,5,44
169520,2023-11-17 14:41:22,1280889909,57561,141,49,44,5,44
169520,2023-11-17 14:41:23,1280889926,57561,141,49,44,5,44
169520,2023-11-17 14:41:24,1280889944,57561,141,49,44,5,44
169520,2023-11-17 14:41:25,1280889955,57561,141,49,44,5,44
169520,2023-11-17 14:41:27,1280889970,57561,141,49,44,5,44
169520,2023-11-17 14:41:28,1280889981,57561,141,49,44,5,44
169520,2023-11-17 14:41:29,1280889997,57561,141,49,44,5,44
169520,2023-11-17 14:41:31,1280890025,57561,141,49,44,5,44
169520,2023-11-17 14:41:32,1280890026,57561,141,49,44,5,44
169520,2023-11-17 14:41:33,1280890042,57561,141,49,44,5,44
169520,2023-11-17 14:41:34,1280890050,57561,141,49,44,5,44
169520,2023-11-17 14:41:35,1280890071,57561,141,49,44,5,44
169520,2023-11-17 14:41:36,1280890082,57561,141,49,44,5,44
169520,2023-11-17 14:41:38,1280890099,57561,141,49,44,5,44
169520,2023-11-17 14:41:42,1280890136,57561,141,49,44,5,44
169520,2023-11-17 14:41:44,1280890157,57561,141,49,44,5,44
169520,2023-11-17 14:41:46,1280890170,57561,141,49,44,5,44
169520,2023-11-17 14:41:48,1280890181,57561,141,49,44,5,44
169520,2023-11-17 14:41:49,1280890199,57561,141,49,44,5,44
169520,2023-11-17 14:41:51,1280890209,57561,141,49,44,5,44
169520,2023-11-17 14:41:52,1280890213,57561,141,49,44,5,44
169520,2023-11-17 14:41:53,1280890220,57561,141,49,44,5,44
169520,2023-11-17 14:41:55,1280890254,57561,141,49,44,5,44
169520,2023-11-17 14:41:56,1280890277,57561,141,49,44,5,44
169520,2023-11-17 14:41:57,1280890284,57561,141,49,44,5,44
169520,2023-11-17 14:41:59,1280890322,57561,141,49,44,5,44
169520,2023-11-17 14:42:01,1280890339,57561,141,49,44,5,44
169520,2023-11-17 14:42:03,1280890380,57561,141,49,44,5,44
169520,2023-11-17 14:42:04,1280890398,57561,141,49,44,5,44
169520,2023-11-17 14:42:06,1280890422,57561,141,49,44,5,44
169520,2023-11-17 14:42:07,1280890427,57561,141,49,44,5,44
169520,2023-11-17 14:42:08,1280890439,57561,141,49,44,5,44
169520,2023-11-17 14:42:09,1280890451,57561,141,49,44,5,44
169520,2023-11-17 14:42:30,1280890675,57561,141,49,44,5,44
169520,2023-11-17 14:42:33,1280890705,57561,141,49,44,5,44
169520,2023-11-17 14:42:38,1280890751,57561,141,49,44,5,44
169520,2023-11-17 14:42:39,1280890757,57561,141,49,44,5,44
169520,2023-11-17 14:42:42,1280890789,57561,141,49,44,5,44
169520,2023-11-17 14:42:43,1280890799,57561,141,49,44,5,44
169520,2023-11-17 14:42:44,1280890813,57561,141,49,44,5,44
169520,2023-11-17 14:42:45,1280890824,57561,141,49,44,5,44
169520,2023-11-17 14:42:49,1280890861,57561,141,49,44,5,44
169520,2023-11-17 14:42:57,1280890943,57561,141,49,44,5,44
169520,2023-11-17 14:43:00,1280890972,57561,141,49,44,5,44
169520,2023-11-17 14:43:01,1280890979,57561,141,49,44,5,44
169520,2023-11-17 14:43:02,1280891000,57561,141,49,44,5,44
169520,2023-11-17 14:43:05,1280891050,57561,141,49,44,5,44
169520,2023-11-17 14:43:06,1280891079,57561,141,49,44,5,44
169520,2023-11-17 14:43:08,1280891098,57561,141,49,44,5,44
169520,2023-11-17 14:43:09,1280891100,57561,141,49,44,5,44
169520,2023-11-17 14:43:31,1280891316,57561,141,49,44,5,44
169520,2023-11-17 14:43:33,1280891343,57561,141,49,44,5,44
169520,2023-11-17 14:43:34,1280891361,57561,141,49,44,5,44
169520,2023-11-17 14:43:35,1280891373,57561,141,49,44,5,44
169520,2023-11-17 14:43:43,1280891451,57561,141,49,44,5,44
169520,2023-11-17 14:43:45,1280891472,57561,141,49,44,5,44
169520,2023-11-17 14:43:46,1280891479,57561,141,49,44,5,44
169520,2023-11-17 14:43:47,1280891482,57561,141,49,44,5,44
169520,2023-11-17 14:43:51,1280891527,57561,141,49,44,5,44
169520,2023-11-17 14:43:52,1280891544,57561,141,49,44,5,44
169520,2023-11-17 14:43:53,1280891555,57561,141,49,44,5,44
169520,2023-11-17 14:43:56,1280891586,57561,141,49,44,5,44
169520,2023-11-17 14:44:00,1280891620,57561,141,49,44,5,44
169520,2023-11-17 14:44:01,1280891629,57561,141,49,44,5,44
169520,2023-11-17 14:44:02,1280891641,57561,141,49,44,5,44
169520,2023-11-17 14:44:03,1280891665,57561,141,49,44,5,44
169520,2023-11-17 14:44:06,1280891693,57561,141,49,44,5,44
169520,2023-11-17 14:44:07,1280891701,57561,141,49,44,5,44
169520,2023-11-17 14:44:08,1280891710,57561,141,49,44,5,44
169520,2023-11-17 14:44:12,1280891743,57561,141,49,44,5,44
169520,2023-11-17 14:44:16,1280891790,57561,141,49,44,5,44
169520,2023-11-17 14:44:17,1280891807,57561,141,49,44,5,44
169520,2023-11-17 14:44:18,1280891819,57561,141,49,44,5,44
169520,2023-11-17 14:44:19,1280891827,57561,141,49,44,5,44
169520,2023-11-17 14:44:20,1280891836,57561,141,49,44,5,44
169520,2023-11-17 14:44:21,1280891846,57561,141,49,44,5,44
169520,2023-11-17 14:44:22,1280891860,57561,141,49,44,5,44
169520,2023-11-17 14:44:23,1280891871,57561,141,49,44,5,44
169520,2023-11-17 14:44:24,1280891884,57561,141,49,44,5,44
169520,2023-11-17 14:44:26,1280891899,57561,141,49,44,5,44
169520,2023-11-17 14:44:27,1280891911,57561,141,49,44,5,44
169520,2023-11-17 14:44:30,1280891934,57561,141,49,44,5,44
169520,2023-11-17 14:44:33,1280891959,57561,141,49,44,5,44
169520,2023-11-17 14:44:37,1280891998,57561,141,49,44,5,44
169520,2023-11-17 14:44:38,1280892017,57561,141,49,44,5,44
169520,2023-11-17 14:44:39,1280892028,57561,141,49,44,5,44
169520,2023-11-17 14:44:41,1280892044,57561,141,49,44,5,44
169520,2023-11-17 14:44:42,1280892053,57561,141,49,44,5,44
169520,2023-11-17 14:44:43,1280892062,57561,141,49,44,5,44
169520,2023-11-17 14:44:44,1280892074,57561,141,49,44,5,44
169520,2023-11-17 14:44:45,1280892084,57561,141,49,44,5,44
169520,2023-11-17 14:44:46,1280892088,57561,141,49,44,5,44
169520,2023-11-17 14:44:48,1280892118,57561,141,49,44,5,44
169520,2023-11-17 14:44:49,1280892133,57561,141,49,44,5,44
169520,2023-11-17 14:44:51,1280892156,57561,141,49,44,5,44
169520,2023-11-17 14:44:52,1280892167,57561,141,49,44,5,44
169520,2023-11-17 14:44:53,1280892173,57561,141,49,44,5,44
169520,2023-11-17 14:44:55,1280892194,57561,141,49,44,5,44
169520,2023-11-17 14:44:56,1280892201,57561,141,49,44,5,44
169520,2023-11-17 14:44:59,1280892224,57561,141,49,44,5,44
169520,2023-11-17 14:45:00,1280892234,57561,141,49,44,5,44
169347,2023-11-17 15:26:28,1280920938,22740,39,3,2,2,1
169529,2023-11-17 15:26:31,1280920969,0,67,42,1,0,42
169529,2023-11-17 15:26:36,1280921067,0,67,42,1,0,42
169347,2023-11-17 15:29:09,1280923212,22740,39,3,2,2,1
169347,2023-11-17 15:29:24,1280923413,22740,39,3,2,2,1
169347,2023-11-17 15:29:49,1280923687,22740,39,3,2,2,1
169347,2023-11-17 15:32:43,1280926031,22740,39,3,2,2,1
169534,2023-11-17 15:54:36,1280946512,104630,215,38,16,8,30
169534,2023-11-17 15:54:41,1280946576,104630,215,38,16,8,30
169534,2023-11-17 15:54:44,1280946631,104630,215,38,16,8,30
169534,2023-11-17 15:54:49,1280946710,104630,215,38,16,8,30
169534,2023-11-17 15:55:04,1280946950,104630,215,38,16,8,30
169534,2023-11-17 15:55:14,1280947147,104630,215,38,16,8,30
169534,2023-11-17 15:55:16,1280947176,104630,215,38,16,8,30
169534,2023-11-17 15:55:23,1280947311,104630,215,38,16,8,30
169534,2023-11-17 15:55:25,1280947352,104630,215,38,16,8,30
169534,2023-11-17 15:55:27,1280947377,104630,215,38,16,8,30
169534,2023-11-17 15:55:28,1280947400,104630,215,38,16,8,30
169534,2023-11-17 15:55:30,1280947424,104630,215,38,16,8,30
169534,2023-11-17 15:55:32,1280947456,104630,215,38,16,8,30
169534,2023-11-17 15:55:33,1280947473,104630,215,38,16,8,30
169534,2023-11-17 15:55:34,1280947494,104630,215,38,16,8,30
169363,2023-11-17 16:03:55,1280954991,11120,27,56,38,1,55
169363,2023-11-17 16:04:04,1280955139,11120,27,56,38,1,55
158846,2023-11-17 16:04:23,1280955445,7964,60,47,9,2,45
158846,2023-11-17 16:05:22,1280956373,7964,60,47,9,2,45
158846,2023-11-17 16:05:23,1280956396,7964,60,47,9,2,45
169536,2023-11-17 16:05:40,1280956634,0,0,36,23,0,36
169536,2023-11-17 16:05:41,1280956655,0,0,36,23,0,36
169363,2023-11-17 16:05:42,1280956658,11120,27,56,38,1,55
169536,2023-11-17 16:05:42,1280956671,0,0,36,23,0,36
169536,2023-11-17 16:05:47,1280956743,0,0,36,23,0,36
169536,2023-11-17 16:05:48,1280956759,0,0,36,23,0,36
169536,2023-11-17 16:05:49,1280956772,0,0,36,23,0,36
169536,2023-11-17 16:05:52,1280956797,0,0,36,23,0,36
169536,2023-11-17 16:05:54,1280956832,0,0,36,23,0,36
169536,2023-11-17 16:05:55,1280956853,0,0,36,23,0,36
169536,2023-11-17 16:05:56,1280956856,0,0,36,23,0,36
169536,2023-11-17 16:05:59,1280956860,0,0,36,23,0,36
169536,2023-11-17 16:05:57,1280956886,0,0,36,23,0,36
169536,2023-11-17 16:06:00,1280956914,0,0,36,23,0,36
169536,2023-11-17 16:06:01,1280956933,0,0,36,23,0,36
169536,2023-11-17 16:06:03,1280956972,0,0,36,23,0,36
169536,2023-11-17 16:06:04,1280956997,0,0,36,23,0,36
169536,2023-11-17 16:06:05,1280957008,0,0,36,23,0,36
169536,2023-11-17 16:06:06,1280957035,0,0,36,23,0,36
169536,2023-11-17 16:06:07,1280957044,0,0,36,23,0,36
169536,2023-11-17 16:06:08,1280957071,0,0,36,23,0,36
169536,2023-11-17 16:06:10,1280957108,0,0,36,23,0,36
169536,2023-11-17 16:06:11,1280957110,0,0,36,23,0,36
169536,2023-11-17 16:06:12,1280957134,0,0,36,23,0,36
169536,2023-11-17 16:06:13,1280957152,0,0,36,23,0,36
169536,2023-11-17 16:06:14,1280957167,0,0,36,23,0,36
169536,2023-11-17 16:06:15,1280957187,0,0,36,23,0,36
169536,2023-11-17 16:06:17,1280957211,0,0,36,23,0,36
169536,2023-11-17 16:06:18,1280957229,0,0,36,23,0,36
169536,2023-11-17 16:06:21,1280957269,0,0,36,23,0,36
169536,2023-11-17 16:06:22,1280957291,0,0,36,23,0,36
169536,2023-11-17 16:06:23,1280957304,0,0,36,23,0,36
169536,2023-11-17 16:06:24,1280957332,0,0,36,23,0,36
169536,2023-11-17 16:06:25,1280957343,0,0,36,23,0,36
169537,2023-11-17 16:09:58,1280960376,1391,20,34,28,1,33
169457,2023-11-17 16:14:15,1280964501,71776,192,50,35,9,41
169457,2023-11-17 16:14:19,1280964542,71776,192,50,35,9,41
169457,2023-11-17 16:14:20,1280964579,71776,192,50,35,9,41
169457,2023-11-17 16:14:22,1280964600,71776,192,50,35,9,41
169457,2023-11-17 16:14:24,1280964632,71776,192,50,35,9,41
169457,2023-11-17 16:14:26,1280964662,71776,192,50,35,9,41
169537,2023-11-17 16:16:24,1280966524,1391,20,34,28,1,33
158846,2023-11-17 16:23:10,1280973028,7964,60,47,9,2,45
158846,2023-11-17 16:23:11,1280973057,7964,60,47,9,2,45
169467,2023-11-17 16:28:28,1280978183,3456,92,1,1,1,0
169538,2023-11-17 16:28:41,1280978332,66829,41,36,17,7,29
169538,2023-11-17 16:28:45,1280978403,66829,41,36,17,7,29
169538,2023-11-17 16:29:14,1280978882,66829,41,36,17,7,29
169538,2023-11-17 16:29:16,1280978931,66829,41,36,17,7,29
169538,2023-11-17 16:29:17,1280978951,66829,41,36,17,7,29
169467,2023-11-17 16:29:26,1280979090,3456,92,1,1,1,0
158846,2023-11-17 16:33:19,1280982908,7964,60,47,9,2,45
158862,2023-11-17 16:36:10,1280985654,90205,118,28,12,11,17
158862,2023-11-17 16:36:11,1280985668,90205,118,28,12,11,17
169541,2023-11-17 16:47:50,1280997534,35161,223,22,10,3,19
169541,2023-11-17 16:48:02,1280997706,35161,223,22,10,3,19
169466,2023-11-17 17:06:45,1281020787,11793,199,14,3,2,12
169466,2023-11-17 17:07:18,1281021700,11793,199,14,3,2,12
169466,2023-11-17 17:16:25,1281038221,11793,199,14,3,2,12
84722,2023-11-17 17:30:19,1281064303,0,35,127,48,0,127
84722,2023-11-17 17:30:20,1281064336,0,35,127,48,0,127
84722,2023-11-17 17:30:25,1281064504,0,35,127,48,0,127
84722,2023-11-17 17:30:27,1281064547,0,35,127,48,0,127
84726,2023-11-17 17:31:15,1281066169,174554,122,147,43,5,142
84726,2023-11-17 17:31:17,1281066224,174554,122,147,43,5,142
84726,2023-11-17 17:31:22,1281066401,174554,122,147,43,5,142
84726,2023-11-17 17:31:25,1281066475,174554,122,147,43,5,142
84734,2023-11-17 17:32:03,1281067620,13436,50,88,33,1,87
84734,2023-11-17 17:32:04,1281067685,13436,50,88,33,1,87
84738,2023-11-17 17:32:39,1281068772,87311,90,208,18,18,190
84738,2023-11-17 17:32:41,1281068825,87311,90,208,18,18,190
84738,2023-11-17 17:32:43,1281068929,87311,90,208,18,18,190
84738,2023-11-17 17:32:49,1281069087,87311,90,208,18,18,190
84738,2023-11-17 17:32:51,1281069192,87311,90,208,18,18,190
169548,2023-11-17 17:36:01,1281075418,6200,11,2,1,1,1
169548,2023-11-17 17:36:02,1281075468,6200,11,2,1,1,1
169548,2023-11-17 17:36:03,1281075489,6200,11,2,1,1,1
169548,2023-11-17 17:36:06,1281075584,6200,11,2,1,1,1
169548,2023-11-17 17:36:07,1281075612,6200,11,2,1,1,1
84762,2023-11-17 17:37:46,1281078683,104562,115,105,20,12,93
84762,2023-11-17 17:37:48,1281078728,104562,115,105,20,12,93
84762,2023-11-17 17:37:50,1281078813,104562,115,105,20,12,93
87512,2023-11-17 17:38:24,1281079921,9705,156,24,8,9,15
87512,2023-11-17 17:38:26,1281080005,9705,156,24,8,9,15
87512,2023-11-17 17:38:28,1281080052,9705,156,24,8,9,15
87512,2023-11-17 17:38:32,1281080190,9705,156,24,8,9,15
87512,2023-11-17 17:38:34,1281080256,9705,156,24,8,9,15
87529,2023-11-17 17:39:26,1281081930,39874,154,45,31,6,39
87529,2023-11-17 17:39:28,1281081976,39874,154,45,31,6,39
87529,2023-11-17 17:39:35,1281082193,39874,154,45,31,6,39
87529,2023-11-17 17:39:37,1281082261,39874,154,45,31,6,39
87529,2023-11-17 17:39:41,1281082413,39874,154,45,31,6,39
87529,2023-11-17 17:39:43,1281082489,39874,154,45,31,6,39
87532,2023-11-17 17:40:15,1281083577,20770,28,21,13,3,18
87532,2023-11-17 17:40:17,1281083623,20770,28,21,13,3,18
87534,2023-11-17 17:41:03,1281085112,36529,111,10,8,6,4
87534,2023-11-17 17:41:09,1281085329,36529,111,10,8,6,4
87534,2023-11-17 17:41:11,1281085417,36529,111,10,8,6,4
87534,2023-11-17 17:41:14,1281085511,36529,111,10,8,6,4
87534,2023-11-17 17:41:16,1281085587,36529,111,10,8,6,4
169549,2023-11-17 17:41:24,1281085846,12179,63,62,51,3,59
169549,2023-11-17 17:41:25,1281085866,12179,63,62,51,3,59
169549,2023-11-17 17:41:27,1281085909,12179,63,62,51,3,59
169549,2023-11-17 17:41:29,1281085971,12179,63,62,51,3,59
169549,2023-11-17 17:41:30,1281085994,12179,63,62,51,3,59
87537,2023-11-17 17:42:02,1281087077,30025,67,38,28,4,34
87537,2023-11-17 17:42:05,1281087172,30025,67,38,28,4,34
87537,2023-11-17 17:42:08,1281087256,30025,67,38,28,4,34
87537,2023-11-17 17:42:12,1281087399,30025,67,38,28,4,34
95546,2023-11-17 17:43:20,1281089625,1918,41,21,2,4,17
95567,2023-11-17 17:50:20,1281102999,6820,9,11,5,1,10
95567,2023-11-17 17:50:25,1281103118,6820,9,11,5,1,10
95567,2023-11-17 17:50:26,1281103164,6820,9,11,5,1,10
95567,2023-11-17 17:51:18,1281104784,6820,9,11,5,1,10
95567,2023-11-17 17:51:20,1281104859,6820,9,11,5,1,10
95567,2023-11-17 17:51:22,1281104915,6820,9,11,5,1,10
95567,2023-11-17 17:51:25,1281105001,6820,9,11,5,1,10
95567,2023-11-17 17:51:28,1281105104,6820,9,11,5,1,10
95567,2023-11-17 17:51:31,1281105178,6820,9,11,5,1,10
95567,2023-11-17 17:51:30,1281105184,6820,9,11,5,1,10
95567,2023-11-17 17:51:37,1281105374,6820,9,11,5,1,10
125648,2023-11-17 18:02:17,1281124919,36364,70,14,10,5,9
125648,2023-11-17 18:02:19,1281124976,36364,70,14,10,5,9
125648,2023-11-17 18:02:21,1281125043,36364,70,14,10,5,9
125648,2023-11-17 18:02:22,1281125083,36364,70,14,10,5,9
125648,2023-11-17 18:02:23,1281125092,36364,70,14,10,5,9
169551,2023-11-17 18:07:09,1281132539,27822,48,3,0,2,1
169551,2023-11-17 18:07:35,1281133140,27822,48,3,0,2,1
169551,2023-11-17 18:08:26,1281134433,27822,48,3,0,2,1
95547,2023-11-17 18:16:03,1281146624,12801,82,26,10,3,23
95547,2023-11-17 18:16:08,1281146743,12801,82,26,10,3,23
95990,2023-11-17 18:18:55,1281151605,134520,217,59,31,10,49
95990,2023-11-17 18:18:57,1281151650,134520,217,59,31,10,49
95990,2023-11-17 18:19:09,1281151985,134520,217,59,31,10,49
95990,2023-11-17 18:19:11,1281152020,134520,217,59,31,10,49
95990,2023-11-17 18:19:13,1281152079,134520,217,59,31,10,49
95990,2023-11-17 18:19:16,1281152150,134520,217,59,31,10,49
96209,2023-11-17 18:19:48,1281153121,468,23,53,18,1,52
96165,2023-11-17 18:20:33,1281154401,14977,40,42,27,4,38
96165,2023-11-17 18:20:37,1281154563,14977,40,42,27,4,38
96165,2023-11-17 18:20:38,1281154574,14977,40,42,27,4,38
96165,2023-11-17 18:20:39,1281154624,14977,40,42,27,4,38
96165,2023-11-17 18:20:40,1281154648,14977,40,42,27,4,38
96165,2023-11-17 18:20:45,1281154776,14977,40,42,27,4,38
96170,2023-11-17 18:22:34,1281157937,63752,314,97,57,10,87
96170,2023-11-17 18:22:38,1281158046,63752,314,97,57,10,87
96170,2023-11-17 18:22:44,1281158255,63752,314,97,57,10,87
96170,2023-11-17 18:23:14,1281159025,63752,314,97,57,10,87
96172,2023-11-17 18:24:11,1281160686,28744,23,36,28,3,33
96172,2023-11-17 18:24:16,1281160862,28744,23,36,28,3,33
96172,2023-11-17 18:24:17,1281160917,28744,23,36,28,3,33
96172,2023-11-17 18:24:19,1281160973,28744,23,36,28,3,33
169554,2023-11-17 18:26:32,1281164842,82869,184,61,35,10,51
169554,2023-11-17 18:26:41,1281165105,82869,184,61,35,10,51
169554,2023-11-17 18:26:47,1281165294,82869,184,61,35,10,51
169554,2023-11-17 18:26:49,1281165329,82869,184,61,35,10,51
169554,2023-11-17 18:26:51,1281165395,82869,184,61,35,10,51
169554,2023-11-17 18:26:56,1281165546,82869,184,61,35,10,51
96169,2023-11-17 18:27:17,1281166239,90442,47,30,26,4,26
96169,2023-11-17 18:27:21,1281166351,90442,47,30,26,4,26
96169,2023-11-17 18:27:23,1281166433,90442,47,30,26,4,26
96169,2023-11-17 18:27:26,1281166522,90442,47,30,26,4,26
96169,2023-11-17 18:27:36,1281166864,90442,47,30,26,4,26
96156,2023-11-17 18:28:09,1281167838,0,9,70,40,0,70
96156,2023-11-17 18:28:14,1281168003,0,9,70,40,0,70
96156,2023-11-17 18:28:27,1281168400,0,9,70,40,0,70
96156,2023-11-17 18:28:37,1281168654,0,9,70,40,0,70
96156,2023-11-17 18:28:47,1281168955,0,9,70,40,0,70
96156,2023-11-17 18:29:05,1281169470,0,9,70,40,0,70
96157,2023-11-17 18:30:09,1281171469,14093,32,70,34,2,68
96157,2023-11-17 18:30:13,1281171552,14093,32,70,34,2,68
96343,2023-11-17 18:30:51,1281172706,44964,97,37,19,3,34
96343,2023-11-17 18:30:57,1281172921,44964,97,37,19,3,34
169354,2023-11-17 18:31:04,1281173147,15524,74,9,5,1,8
169354,2023-11-17 18:31:08,1281173298,15524,74,9,5,1,8
169354,2023-11-17 18:31:09,1281173348,15524,74,9,5,1,8
169354,2023-11-17 18:31:11,1281173412,15524,74,9,5,1,8
169354,2023-11-17 18:31:12,1281173465,15524,74,9,5,1,8
169354,2023-11-17 18:31:15,1281173529,15524,74,9,5,1,8
169354,2023-11-17 18:31:16,1281173550,15524,74,9,5,1,8
169372,2023-11-17 18:31:20,1281173698,67746,71,26,24,3,23
169372,2023-11-17 18:31:21,1281173716,67746,71,26,24,3,23
169372,2023-11-17 18:31:24,1281173820,67746,71,26,24,3,23
169372,2023-11-17 18:31:27,1281173925,67746,71,26,24,3,23
169372,2023-11-17 18:31:30,1281173999,67746,71,26,24,3,23
96163,2023-11-17 18:31:33,1281174097,22327,113,27,13,5,22
169468,2023-11-17 18:31:33,1281174108,4400,11,10,0,1,9
169468,2023-11-17 18:31:34,1281174109,4400,11,10,0,1,9
96163,2023-11-17 18:31:37,1281174241,22327,113,27,13,5,22
169465,2023-11-17 18:31:48,1281174481,1663,35,29,13,2,27
169465,2023-11-17 18:31:49,1281174497,1663,35,29,13,2,27
100330,2023-11-17 18:32:23,1281175422,28431,36,32,12,2,30
100337,2023-11-17 18:32:59,1281176490,0,4,16,11,0,16
100337,2023-11-17 18:33:02,1281176569,0,4,16,11,0,16
169555,2023-11-17 18:36:04,1281181996,0,0,23,14,0,23
169555,2023-11-17 18:36:05,1281182049,0,0,23,14,0,23
100342,2023-11-17 18:37:29,1281184616,78,3,8,1,1,7
169555,2023-11-17 18:37:32,1281184734,0,0,23,14,0,23
169555,2023-11-17 18:37:34,1281184750,0,0,23,14,0,23
123280,2023-11-17 18:38:42,1281186715,2197,39,48,17,1,47
123280,2023-11-17 18:38:44,1281186776,2197,39,48,17,1,47
123282,2023-11-17 18:39:43,1281188434,0,24,13,9,0,13
123282,2023-11-17 18:39:44,1281188488,0,24,13,9,0,13
123282,2023-11-17 18:39:48,1281188638,0,24,13,9,0,13
123279,2023-11-17 18:41:06,1281190765,23493,133,124,42,4,120
123279,2023-11-17 18:41:11,1281190905,23493,133,124,42,4,120
123279,2023-11-17 18:41:14,1281191013,23493,133,124,42,4,120
123279,2023-11-17 18:41:18,1281191101,23493,133,124,42,4,120
100482,2023-11-17 18:53:00,1281212802,0,2,1,0,0,1
100482,2023-11-17 18:53:02,1281212852,0,2,1,0,0,1
101630,2023-11-17 18:54:14,1281214999,104050,27,27,4,2,25
101630,2023-11-17 18:54:15,1281215034,104050,27,27,4,2,25
160632,2023-11-17 19:01:58,1281229639,17184,105,11,4,2,9
160632,2023-11-17 19:02:00,1281229716,17184,105,11,4,2,9
160632,2023-11-17 19:02:01,1281229754,17184,105,11,4,2,9
160632,2023-11-17 19:02:02,1281229788,17184,105,11,4,2,9
160632,2023-11-17 19:02:03,1281229846,17184,105,11,4,2,9
160632,2023-11-17 19:02:04,1281229853,17184,105,11,4,2,9
160632,2023-11-17 19:02:05,1281229867,17184,105,11,4,2,9
160632,2023-11-17 19:02:06,1281229947,17184,105,11,4,2,9
160632,2023-11-17 19:02:07,1281229957,17184,105,11,4,2,9
160630,2023-11-17 19:02:34,1281230911,17605,39,11,2,3,8
160630,2023-11-17 19:02:35,1281230946,17605,39,11,2,3,8
161624,2023-11-17 19:03:03,1281231847,16955,77,89,20,4,85
161624,2023-11-17 19:03:04,1281231867,16955,77,89,20,4,85
161624,2023-11-17 19:03:05,1281231886,16955,77,89,20,4,85
161624,2023-11-17 19:03:06,1281231917,16955,77,89,20,4,85
161624,2023-11-17 19:03:07,1281231973,16955,77,89,20,4,85
161624,2023-11-17 19:03:09,1281232015,16955,77,89,20,4,85
160716,2023-11-17 19:03:18,1281232334,448,21,9,2,3,6
160716,2023-11-17 19:03:19,1281232379,448,21,9,2,3,6
160716,2023-11-17 19:03:21,1281232430,448,21,9,2,3,6
161734,2023-11-17 19:03:31,1281232773,48757,140,17,6,2,15
161734,2023-11-17 19:03:32,1281232793,48757,140,17,6,2,15
161734,2023-11-17 19:03:33,1281232815,48757,140,17,6,2,15
161734,2023-11-17 19:03:34,1281232875,48757,140,17,6,2,15
130165,2023-11-17 20:04:35,1281348059,70846,166,251,27,7,244
130165,2023-11-17 20:04:51,1281348339,70846,166,251,27,7,244
141878,2023-11-17 20:04:56,1281348458,108283,403,69,55,11,58
141878,2023-11-17 20:05:06,1281348692,108283,403,69,55,11,58
141878,2023-11-17 20:05:18,1281348939,108283,403,69,55,11,58
141878,2023-11-17 20:05:19,1281348969,108283,403,69,55,11,58
153166,2023-11-17 20:05:50,1281349555,26191,26,11,3,5,6
153166,2023-11-17 20:06:02,1281349747,26191,26,11,3,5,6
160528,2023-11-17 20:06:08,1281349862,0,138,22,11,0,22
160528,2023-11-17 20:06:12,1281349930,0,138,22,11,0,22
130115,2023-11-17 20:06:32,1281350202,13461,44,142,77,3,139
153167,2023-11-17 20:06:37,1281350273,32428,217,72,24,4,68
153172,2023-11-17 20:06:51,1281350493,53457,164,36,13,3,33
153163,2023-11-17 20:07:17,1281350971,60229,37,91,40,3,88
74111,2023-11-17 20:11:04,1281354882,20450,59,103,49,2,101
88820,2023-11-17 20:12:11,1281355980,16311,111,35,19,3,32
88820,2023-11-17 20:12:12,1281355995,16311,111,35,19,3,32
88820,2023-11-17 20:12:13,1281356014,16311,111,35,19,3,32
88822,2023-11-17 20:12:27,1281356257,20571,81,77,23,5,72
88822,2023-11-17 20:12:31,1281356318,20571,81,77,23,5,72
88848,2023-11-17 20:12:46,1281356575,39619,108,86,47,2,84
88848,2023-11-17 20:12:48,1281356599,39619,108,86,47,2,84
88848,2023-11-17 20:12:50,1281356616,39619,108,86,47,2,84
88845,2023-11-17 20:13:09,1281356959,0,0,11,3,0,11
88845,2023-11-17 20:13:10,1281356969,0,0,11,3,0,11
88845,2023-11-17 20:13:12,1281357000,0,0,11,3,0,11
159050,2023-11-17 20:13:13,1281357023,1812,3,21,16,1,20
88845,2023-11-17 20:13:13,1281357030,0,0,11,3,0,11
88845,2023-11-17 20:13:14,1281357037,0,0,11,3,0,11
159050,2023-11-17 20:13:17,1281357083,1812,3,21,16,1,20
159050,2023-11-17 20:13:19,1281357110,1812,3,21,16,1,20
159050,2023-11-17 20:13:20,1281357123,1812,3,21,16,1,20
159050,2023-11-17 20:13:22,1281357169,1812,3,21,16,1,20
88844,2023-11-17 20:13:32,1281357302,219,9,42,21,1,41
88844,2023-11-17 20:13:33,1281357310,219,9,42,21,1,41
88844,2023-11-17 20:13:34,1281357318,219,9,42,21,1,41
88844,2023-11-17 20:13:36,1281357349,219,9,42,21,1,41
88925,2023-11-17 20:13:48,1281357529,4325,101,54,13,1,53
88925,2023-11-17 20:13:49,1281357540,4325,101,54,13,1,53
88925,2023-11-17 20:13:50,1281357577,4325,101,54,13,1,53
88925,2023-11-17 20:13:52,1281357606,4325,101,54,13,1,53
88925,2023-11-17 20:13:53,1281357619,4325,101,54,13,1,53
88925,2023-11-17 20:13:54,1281357635,4325,101,54,13,1,53
159760,2023-11-17 20:14:03,1281357796,12315,37,11,6,3,8
159760,2023-11-17 20:14:04,1281357802,12315,37,11,6,3,8
159760,2023-11-17 20:14:05,1281357824,12315,37,11,6,3,8
159760,2023-11-17 20:14:06,1281357840,12315,37,11,6,3,8
159760,2023-11-17 20:14:07,1281357867,12315,37,11,6,3,8
159760,2023-11-17 20:14:08,1281357882,12315,37,11,6,3,8
159760,2023-11-17 20:14:09,1281357906,12315,37,11,6,3,8
159760,2023-11-17 20:14:11,1281357921,12315,37,11,6,3,8
159760,2023-11-17 20:14:12,1281357944,12315,37,11,6,3,8
159760,2023-11-17 20:14:13,1281357968,12315,37,11,6,3,8
159760,2023-11-17 20:14:14,1281357971,12315,37,11,6,3,8
159760,2023-11-17 20:14:16,1281358002,12315,37,11,6,3,8
159760,2023-11-17 20:14:15,1281358003,12315,37,11,6,3,8
159769,2023-11-17 20:14:32,1281358206,48807,333,292,45,7,285
159769,2023-11-17 20:14:34,1281358216,48807,333,292,45,7,285
159769,2023-11-17 20:14:33,1281358241,48807,333,292,45,7,285
159769,2023-11-17 20:14:38,1281358339,48807,333,292,45,7,285
159769,2023-11-17 20:14:39,1281358345,48807,333,292,45,7,285
159769,2023-11-17 20:14:43,1281358390,48807,333,292,45,7,285
159769,2023-11-17 20:14:46,1281358402,48807,333,292,45,7,285
159769,2023-11-17 20:14:44,1281358408,48807,333,292,45,7,285
159769,2023-11-17 20:14:49,1281358471,48807,333,292,45,7,285
93859,2023-11-17 20:15:24,1281359010,33090,4,33,18,1,32
93859,2023-11-17 20:15:25,1281359023,33090,4,33,18,1,32
93859,2023-11-17 20:15:26,1281359051,33090,4,33,18,1,32
93859,2023-11-17 20:15:27,1281359081,33090,4,33,18,1,32
93859,2023-11-17 20:15:29,1281359116,33090,4,33,18,1,32
93856,2023-11-17 20:15:54,1281359520,12674,157,26,8,5,21
93856,2023-11-17 20:15:55,1281359526,12674,157,26,8,5,21
93856,2023-11-17 20:15:56,1281359537,12674,157,26,8,5,21
93856,2023-11-17 20:15:57,1281359563,12674,157,26,8,5,21
93856,2023-11-17 20:15:58,1281359575,12674,157,26,8,5,21
93853,2023-11-17 20:16:25,1281359986,877,21,21,11,2,19
93853,2023-11-17 20:16:26,1281360010,877,21,21,11,2,19
93853,2023-11-17 20:16:27,1281360026,877,21,21,11,2,19
93853,2023-11-17 20:16:28,1281360057,877,21,21,11,2,19
93853,2023-11-17 20:16:29,1281360059,877,21,21,11,2,19
93853,2023-11-17 20:16:30,1281360075,877,21,21,11,2,19
94637,2023-11-17 20:17:00,1281360508,12591,84,9,1,4,5
94637,2023-11-17 20:17:01,1281360521,12591,84,9,1,4,5
94637,2023-11-17 20:17:02,1281360534,12591,84,9,1,4,5
94637,2023-11-17 20:17:03,1281360561,12591,84,9,1,4,5
93851,2023-11-17 20:17:41,1281361122,0,9,33,15,0,33
93851,2023-11-17 20:17:42,1281361138,0,9,33,15,0,33
93851,2023-11-17 20:17:43,1281361149,0,9,33,15,0,33
93851,2023-11-17 20:17:44,1281361162,0,9,33,15,0,33
93851,2023-11-17 20:17:45,1281361174,0,9,33,15,0,33
93851,2023-11-17 20:17:46,1281361188,0,9,33,15,0,33
93851,2023-11-17 20:17:47,1281361206,0,9,33,15,0,33
93851,2023-11-17 20:17:48,1281361220,0,9,33,15,0,33
114188,2023-11-17 20:18:26,1281361805,22129,91,11,9,3,8
114188,2023-11-17 20:18:27,1281361807,22129,91,11,9,3,8
114188,2023-11-17 20:18:28,1281361830,22129,91,11,9,3,8
114188,2023-11-17 20:18:29,1281361845,22129,91,11,9,3,8
114328,2023-11-17 20:19:04,1281362355,105931,10,21,9,3,18
114328,2023-11-17 20:19:05,1281362374,105931,10,21,9,3,18
114328,2023-11-17 20:19:06,1281362387,105931,10,21,9,3,18
114328,2023-11-17 20:19:07,1281362414,105931,10,21,9,3,18
114328,2023-11-17 20:19:09,1281362438,105931,10,21,9,3,18
114328,2023-11-17 20:20:08,1281363309,105931,10,21,9,3,18
114187,2023-11-17 20:20:19,1281363473,130482,11,61,22,5,56
114187,2023-11-17 20:20:20,1281363482,130482,11,61,22,5,56
114187,2023-11-17 20:20:21,1281363492,130482,11,61,22,5,56
114187,2023-11-17 20:20:22,1281363511,130482,11,61,22,5,56
114187,2023-11-17 20:20:24,1281363538,130482,11,61,22,5,56
114342,2023-11-17 20:20:50,1281363966,5871,37,11,6,4,7
114342,2023-11-17 20:20:51,1281363972,5871,37,11,6,4,7
114342,2023-11-17 20:20:52,1281363985,5871,37,11,6,4,7
102725,2023-11-17 20:23:03,1281365851,58858,210,69,54,14,55
102741,2023-11-17 20:23:25,1281366178,30469,65,23,11,3,20
102741,2023-11-17 20:23:39,1281366374,30469,65,23,11,3,20
132492,2023-11-17 20:23:48,1281366498,10939,30,58,20,1,57
102725,2023-11-17 20:23:49,1281366505,58858,210,69,54,14,55
132492,2023-11-17 20:23:53,1281366561,10939,30,58,20,1,57
132492,2023-11-17 20:23:54,1281366579,10939,30,58,20,1,57
131437,2023-11-17 20:24:20,1281366964,4437,125,6,1,3,3
131437,2023-11-17 20:24:21,1281366983,4437,125,6,1,3,3
131437,2023-11-17 20:24:23,1281366995,4437,125,6,1,3,3
131060,2023-11-17 20:24:52,1281367380,9356,154,11,1,9,2
131060,2023-11-17 20:24:55,1281367414,9356,154,11,1,9,2
161102,2023-11-17 20:25:16,1281367696,0,2,41,22,0,41
161102,2023-11-17 20:25:30,1281367908,0,2,41,22,0,41
131018,2023-11-17 20:25:38,1281368019,5213,24,7,5,1,6
131018,2023-11-17 20:25:39,1281368034,5213,24,7,5,1,6
131018,2023-11-17 20:25:40,1281368050,5213,24,7,5,1,6
100541,2023-11-17 20:26:02,1281368342,24998,248,173,11,6,167
100541,2023-11-17 20:26:08,1281368460,24998,248,173,11,6,167
106363,2023-11-17 20:26:52,1281369071,1125,20,7,1,1,6
100565,2023-11-17 20:27:39,1281369778,11545,29,19,9,2,17
133307,2023-11-17 20:28:14,1281370294,0,36,52,14,0,52
133307,2023-11-17 20:28:15,1281370308,0,36,52,14,0,52
133307,2023-11-17 20:28:16,1281370322,0,36,52,14,0,52
133307,2023-11-17 20:28:17,1281370332,0,36,52,14,0,52
100767,2023-11-17 20:28:36,1281370646,34575,183,16,11,7,9
133307,2023-11-17 20:28:57,1281370955,0,36,52,14,0,52
142121,2023-11-17 20:29:34,1281371583,0,0,5,2,0,5
133411,2023-11-17 20:30:01,1281371969,4755,49,36,28,1,35
133411,2023-11-17 20:30:02,1281371985,4755,49,36,28,1,35
133411,2023-11-17 20:30:07,1281372072,4755,49,36,28,1,35
133308,2023-11-17 20:30:30,1281372452,0,0,80,41,0,80
133308,2023-11-17 20:30:31,1281372481,0,0,80,41,0,80
133308,2023-11-17 20:30:36,1281372537,0,0,80,41,0,80
133308,2023-11-17 20:30:37,1281372542,0,0,80,41,0,80
133312,2023-11-17 20:31:00,1281372872,56200,140,29,8,6,23
133312,2023-11-17 20:31:02,1281372904,56200,140,29,8,6,23
108875,2023-11-17 20:31:00,1281372942,0,0,27,11,0,27
133312,2023-11-17 20:31:06,1281372966,56200,140,29,8,6,23
133312,2023-11-17 20:31:08,1281373013,52906,123,28,8,5,23
133312,2023-11-17 20:31:09,1281373035,52906,123,28,8,5,23
134933,2023-11-17 20:31:41,1281373591,1527,49,33,19,3,30
134933,2023-11-17 20:31:42,1281373602,1527,49,33,19,3,30
134933,2023-11-17 20:31:43,1281373617,1527,49,33,19,3,30
134933,2023-11-17 20:31:44,1281373624,1527,49,33,19,3,30
108874,2023-11-17 20:31:44,1281373630,9861,34,11,6,3,8
99371,2023-11-17 20:32:35,1281374387,29884,38,36,27,3,33
99371,2023-11-17 20:32:36,1281374402,29884,38,36,27,3,33
99371,2023-11-17 20:32:38,1281374439,29884,38,36,27,3,33
108895,2023-11-17 20:33:03,1281374905,6574,34,7,2,2,5
99374,2023-11-17 20:33:07,1281374971,7491,6,50,25,1,49
99374,2023-11-17 20:33:08,1281374980,7491,6,50,25,1,49
99374,2023-11-17 20:33:09,1281374994,7491,6,50,25,1,49
99374,2023-11-17 20:33:11,1281375025,7491,6,50,25,1,49
99372,2023-11-17 20:33:36,1281375569,0,13,44,22,0,44
99372,2023-11-17 20:33:37,1281375586,0,13,44,22,0,44
99372,2023-11-17 20:33:38,1281375612,0,13,44,22,0,44
99372,2023-11-17 20:33:39,1281375638,0,13,44,22,0,44
99372,2023-11-17 20:33:40,1281375644,0,13,44,22,0,44
135525,2023-11-17 20:34:11,1281376297,1494,113,19,7,2,17
135525,2023-11-17 20:34:13,1281376327,1494,113,19,7,2,17
135506,2023-11-17 20:34:49,1281376985,0,0,22,18,0,22
135506,2023-11-17 20:34:50,1281376998,0,0,22,18,0,22
135526,2023-11-17 20:35:17,1281377446,20794,85,51,8,9,42
135526,2023-11-17 20:35:18,1281377452,20794,85,51,8,9,42
135526,2023-11-17 20:35:19,1281377474,20794,85,51,8,9,42
135526,2023-11-17 20:35:20,1281377511,20794,85,51,8,9,42
135526,2023-11-17 20:35:21,1281377520,20794,85,51,8,9,42
135526,2023-11-17 20:35:22,1281377531,20794,85,51,8,9,42
169565,2023-11-17 20:35:22,1281377536,9703,11,35,22,2,33
169565,2023-11-17 20:35:28,1281377637,9703,11,35,22,2,33
135510,2023-11-17 20:35:48,1281377981,7150,11,2,1,1,1
135510,2023-11-17 20:35:49,1281377995,7150,11,2,1,1,1
135510,2023-11-17 20:35:50,1281378017,7150,11,2,1,1,1
135510,2023-11-17 20:35:51,1281378049,7150,11,2,1,1,1
135510,2023-11-17 20:35:53,1281378085,7150,11,2,1,1,1
135194,2023-11-17 20:36:31,1281378822,60527,63,110,77,6,104
135194,2023-11-17 20:36:32,1281378839,60527,63,110,77,6,104
135194,2023-11-17 20:36:33,1281378864,60527,63,110,77,6,104
135194,2023-11-17 20:36:35,1281378906,60527,63,110,77,6,104
135529,2023-11-17 20:36:56,1281379328,3489,8,5,1,1,4
135529,2023-11-17 20:36:57,1281379350,3489,8,5,1,1,4
135529,2023-11-17 20:36:58,1281379379,3489,8,5,1,1,4
135529,2023-11-17 20:36:59,1281379389,3489,8,5,1,1,4
135197,2023-11-17 20:37:28,1281379973,30166,101,59,10,2,57
135197,2023-11-17 20:37:29,1281379975,30166,101,59,10,2,57
135197,2023-11-17 20:37:30,1281379995,30166,101,59,10,2,57
135197,2023-11-17 20:37:31,1281380037,30166,101,59,10,2,57
135197,2023-11-17 20:37:59,1281380553,30166,101,59,10,2,57
135227,2023-11-17 20:38:09,1281380761,25544,36,30,16,2,28
135227,2023-11-17 20:38:11,1281380777,25544,36,30,16,2,28
135227,2023-11-17 20:38:10,1281380788,25544,36,30,16,2,28
135227,2023-11-17 20:38:13,1281380837,25544,36,30,16,2,28
135227,2023-11-17 20:38:14,1281380854,25544,36,30,16,2,28
135195,2023-11-17 20:38:40,1281381216,0,0,5,3,0,5
135195,2023-11-17 20:38:41,1281381236,0,0,5,3,0,5
135195,2023-11-17 20:38:43,1281381250,0,0,5,3,0,5
135195,2023-11-17 20:38:44,1281381266,0,0,5,3,0,5
135195,2023-11-17 20:38:45,1281381303,0,0,5,3,0,5
148070,2023-11-17 20:38:54,1281381428,0,0,19,17,0,19
135195,2023-11-17 20:40:13,1281382893,0,0,5,3,0,5
116393,2023-11-17 20:40:31,1281383268,0,0,24,16,0,24
116393,2023-11-17 20:40:33,1281383317,0,0,24,16,0,24
116393,2023-11-17 20:40:34,1281383330,0,0,24,16,0,24
116393,2023-11-17 20:40:35,1281383331,0,0,24,16,0,24
116393,2023-11-17 20:40:37,1281383362,0,0,24,16,0,24
104468,2023-11-17 20:40:50,1281383649,37974,283,33,26,3,30
116393,2023-11-17 20:40:55,1281383733,0,0,24,16,0,24
116393,2023-11-17 20:40:56,1281383746,0,0,24,16,0,24
116387,2023-11-17 20:41:10,1281384028,2406,5,43,35,2,41
116387,2023-11-17 20:41:11,1281384043,2406,5,43,35,2,41
116387,2023-11-17 20:41:12,1281384055,2406,5,43,35,2,41
116387,2023-11-17 20:41:13,1281384085,2406,5,43,35,2,41
116387,2023-11-17 20:41:14,1281384086,2406,5,43,35,2,41
116390,2023-11-17 20:41:41,1281384624,19907,86,36,22,4,32
116390,2023-11-17 20:41:42,1281384628,19907,86,36,22,4,32
116390,2023-11-17 20:41:43,1281384645,19907,86,36,22,4,32
116390,2023-11-17 20:41:44,1281384686,19907,86,36,22,4,32
116390,2023-11-17 20:41:45,1281384690,19907,86,36,22,4,32
116390,2023-11-17 20:41:46,1281384709,19907,86,36,22,4,32
116390,2023-11-17 20:41:47,1281384731,19907,86,36,22,4,32
116390,2023-11-17 20:42:02,1281384990,19907,86,36,22,4,32
116392,2023-11-17 20:42:14,1281385195,0,0,21,6,0,21
116392,2023-11-17 20:42:15,1281385211,0,0,21,6,0,21
116392,2023-11-17 20:42:17,1281385236,0,0,21,6,0,21
116413,2023-11-17 20:42:48,1281385673,1922,0,56,23,1,55
116413,2023-11-17 20:42:49,1281385681,1922,0,56,23,1,55
116413,2023-11-17 20:42:50,1281385696,1922,0,56,23,1,55
116413,2023-11-17 20:42:51,1281385733,1922,0,56,23,1,55
116413,2023-11-17 20:42:52,1281385741,1922,0,56,23,1,55
116413,2023-11-17 20:42:53,1281385759,1922,0,56,23,1,55
116413,2023-11-17 20:42:54,1281385772,1922,0,56,23,1,55
116413,2023-11-17 20:43:55,1281386956,1922,0,56,23,1,55
100290,2023-11-17 21:03:49,1281405736,35653,16,21,15,1,20
100280,2023-11-17 21:04:50,1281406673,52572,79,50,38,5,45
100278,2023-11-17 21:05:01,1281406863,65320,257,49,34,7,42
100278,2023-11-17 21:05:07,1281406950,65320,257,49,34,7,42
100278,2023-11-17 21:05:08,1281406969,65320,257,49,34,7,42
100274,2023-11-17 21:05:13,1281407035,38779,26,18,11,2,16
107166,2023-11-17 21:14:31,1281415537,70732,53,63,21,4,59
107166,2023-11-17 21:14:40,1281415680,70732,53,63,21,4,59
107486,2023-11-17 21:15:23,1281416370,1258,15,17,8,1,16
116500,2023-11-17 21:16:12,1281417071,62933,23,5,5,2,3
116500,2023-11-17 21:16:21,1281417198,68159,98,26,8,4,22
128281,2023-11-17 21:17:47,1281418529,22695,27,27,10,5,22
169574,2023-11-17 21:21:56,1281422343,0,0,20,16,0,20
169574,2023-11-17 21:22:27,1281422838,0,0,20,16,0,20
169574,2023-11-17 21:22:28,1281422860,0,0,20,16,0,20
169574,2023-11-17 21:22:30,1281422887,0,0,20,16,0,20
169575,2023-11-17 21:26:22,1281426487,33442,10,20,17,1,19
169575,2023-11-17 21:26:27,1281426562,33442,10,20,17,1,19
169576,2023-11-17 21:29:14,1281429184,342,18,42,36,1,41
169576,2023-11-17 21:29:32,1281429451,342,18,42,36,1,41
169577,2023-11-17 21:34:27,1281433999,97972,79,12,5,5,7
169577,2023-11-17 21:34:30,1281434037,97972,79,12,5,5,7
120833,2023-11-17 21:55:15,1281458358,0,56,14,10,0,14
120835,2023-11-17 21:55:30,1281458651,37306,89,49,28,4,45
132435,2023-11-17 21:56:02,1281459319,6515,14,18,12,1,17
151800,2023-11-17 21:58:15,1281462345,57566,229,16,8,4,12
120838,2023-11-17 21:58:20,1281462453,117501,210,44,30,6,38
132434,2023-11-17 21:58:23,1281462517,55931,97,56,36,5,51
132435,2023-11-17 21:58:26,1281462584,6515,14,18,12,1,17
120835,2023-11-17 21:58:30,1281462682,37306,89,49,28,4,45
120833,2023-11-17 21:58:32,1281462755,0,56,14,10,0,14
131217,2023-11-17 22:10:34,1281478983,0,94,53,18,0,53
131217,2023-11-17 22:10:35,1281479004,0,94,53,18,0,53
131217,2023-11-17 22:10:45,1281479219,0,94,53,18,0,53
169580,2023-11-17 22:11:13,1281479830,62097,77,42,33,4,38
169581,2023-11-17 22:11:27,1281480131,0,0,15,6,0,15
169581,2023-11-17 22:11:31,1281480217,0,0,15,6,0,15
169582,2023-11-17 22:11:45,1281480526,48353,134,13,9,3,10
169582,2023-11-17 22:11:47,1281480573,48353,134,13,9,3,10
169582,2023-11-17 22:11:48,1281480604,48353,134,13,9,3,10
169582,2023-11-17 22:11:50,1281480637,48353,134,13,9,3,10
169583,2023-11-17 22:12:08,1281481061,2693,12,33,26,1,32
169583,2023-11-17 22:12:09,1281481093,2693,12,33,26,1,32
169583,2023-11-17 22:12:12,1281481133,2693,12,33,26,1,32
95566,2023-11-17 22:30:55,1281504681,4949,50,19,13,1,18
95566,2023-11-17 22:31:02,1281504812,4949,50,19,13,1,18
123278,2023-11-17 22:43:17,1281519778,32246,60,123,49,4,119
169602,2023-11-17 23:23:40,1281567352,8982,64,29,23,2,27
169602,2023-11-17 23:23:46,1281567449,8982,64,29,23,2,27
169602,2023-11-17 23:23:47,1281567460,8982,64,29,23,2,27
169602,2023-11-17 23:23:48,1281567483,8982,64,29,23,2,27
121436,2023-11-18 14:44:21,1282035987,1489,58,43,27,1,42
121430,2023-11-18 14:44:23,1282036004,29654,106,19,8,1,18
121428,2023-11-18 14:44:28,1282036037,48740,128,62,34,3,59
121432,2023-11-18 14:44:33,1282036069,30450,40,50,38,1,49
121439,2023-11-18 14:44:38,1282036101,7670,149,22,7,5,17
121455,2023-11-18 14:44:43,1282036142,0,4,17,14,0,17
121435,2023-11-18 14:44:48,1282036170,0,19,19,12,0,19
169619,2023-11-18 14:57:15,1282040701,1553,11,7,2,1,6
169619,2023-11-18 14:57:18,1282040725,1553,11,7,2,1,6
169619,2023-11-18 14:57:20,1282040731,1553,11,7,2,1,6
169619,2023-11-18 14:57:21,1282040741,1553,11,7,2,1,6
169620,2023-11-18 14:57:38,1282040820,0,65,7,1,0,7
169620,2023-11-18 14:57:39,1282040827,0,65,7,1,0,7
169620,2023-11-18 14:57:42,1282040855,0,65,7,1,0,7
169620,2023-11-18 14:57:43,1282040860,0,65,7,1,0,7
169622,2023-11-18 14:58:18,1282041146,3595,15,3,0,1,2
124100,2023-11-18 14:58:45,1282041305,0,2,29,12,0,29
124101,2023-11-18 14:58:49,1282041321,0,0,3,1,0,3
124102,2023-11-18 14:58:53,1282041337,1460,25,71,41,2,69
124103,2023-11-18 14:58:56,1282041352,45107,51,67,23,3,64
124104,2023-11-18 14:59:00,1282041377,5624,73,17,13,1,16
124125,2023-11-18 14:59:04,1282041414,6260,54,42,6,4,38
124125,2023-11-18 14:59:20,1282041534,6260,54,42,6,4,38
124104,2023-11-18 14:59:22,1282041562,5624,73,17,13,1,16
124103,2023-11-18 14:59:25,1282041575,45107,51,67,23,3,64
124102,2023-11-18 14:59:27,1282041595,1460,25,71,41,2,69
124101,2023-11-18 14:59:29,1282041603,0,0,3,1,0,3
124100,2023-11-18 14:59:31,1282041620,0,2,29,12,0,29
107117,2023-11-18 15:01:55,1282042653,52928,77,801,34,6,795
107117,2023-11-18 15:02:05,1282042707,52928,77,801,34,6,795
129284,2023-11-18 15:06:59,1282047121,2701,100,18,4,8,10
129291,2023-11-18 15:07:02,1282047172,0,41,59,50,0,59
129289,2023-11-18 15:07:04,1282047242,16115,183,80,53,4,76
129281,2023-11-18 15:07:06,1282047292,21682,216,98,65,3,95
129288,2023-11-18 15:07:19,1282047590,8075,17,31,16,2,29
129284,2023-11-18 15:07:23,1282047712,2701,100,18,4,8,10
129291,2023-11-18 15:07:26,1282047760,0,41,59,50,0,59
129289,2023-11-18 15:07:28,1282047805,16115,183,80,53,4,76
129281,2023-11-18 15:07:30,1282047855,21682,216,98,65,3,95
129288,2023-11-18 15:07:32,1282047919,8075,17,31,16,2,29
169624,2023-11-18 15:29:25,1282079854,0,3,53,8,0,53
169624,2023-11-18 15:30:08,1282080887,0,3,53,8,0,53
169631,2023-11-18 16:06:01,1282125584,63621,87,13,3,4,9
169631,2023-11-18 16:06:18,1282125788,63621,87,13,3,4,9
123581,2023-11-18 16:33:39,1282144044,0,245,112,86,0,112
123587,2023-11-18 16:33:42,1282144097,0,1,54,49,0,54
124017,2023-11-18 16:33:44,1282144122,3775,186,134,39,13,121
124014,2023-11-18 16:33:45,1282144147,7903,33,37,32,4,33
124016,2023-11-18 16:33:47,1282144180,0,1,31,22,0,31
169633,2023-11-18 16:49:57,1282155854,68138,123,91,47,11,80
169633,2023-11-18 16:50:05,1282155968,68138,123,91,47,11,80
169634,2023-11-18 16:52:24,1282157707,121973,124,48,9,5,43
169635,2023-11-18 16:57:43,1282161540,16976,231,34,21,8,26
169636,2023-11-18 17:08:26,1282169231,365996,145,20,9,10,10
169636,2023-11-18 17:08:27,1282169239,365996,145,20,9,10,10
169636,2023-11-18 17:08:28,1282169262,365996,145,20,9,10,10
169637,2023-11-18 17:10:20,1282170683,0,0,19,2,0,19
169637,2023-11-18 17:10:29,1282170809,0,0,19,2,0,19
169638,2023-11-18 17:36:25,1282189635,28320,26,29,8,3,26
169638,2023-11-18 17:36:27,1282189664,28320,26,29,8,3,26
169640,2023-11-18 17:46:50,1282197544,41387,48,111,67,4,107
169640,2023-11-18 17:46:53,1282197586,41387,48,111,67,4,107
81301,2023-11-18 17:59:59,1282207588,63516,80,61,21,4,57
122922,2023-11-18 18:01:12,1282208523,12083,122,6,5,3,3
123421,2023-11-18 18:02:16,1282209336,9513,107,35,8,3,32
135219,2023-11-18 18:03:09,1282209997,34715,104,45,20,5,40
122986,2023-11-18 18:03:55,1282210537,39674,165,20,12,8,12
122986,2023-11-18 18:04:18,1282210812,39674,165,20,12,8,12
122986,2023-11-18 18:04:52,1282211264,39674,165,20,12,8,12
169642,2023-11-18 18:06:15,1282212297,105217,73,13,9,5,8
169644,2023-11-18 18:26:23,1282228105,0,60,13,6,0,13
169644,2023-11-18 18:26:36,1282228295,0,60,13,6,0,13
169645,2023-11-18 18:27:01,1282228591,0,0,10,1,0,10
123074,2023-11-18 18:42:34,1282243112,11350,11,16,8,3,13
169647,2023-11-18 18:43:41,1282244972,62896,188,60,8,9,51
169647,2023-11-18 18:43:46,1282245115,62896,188,60,8,9,51
134853,2023-11-18 18:44:20,1282245990,15848,46,29,5,5,24
161843,2023-11-18 18:45:12,1282247467,0,4,4,1,0,4
132440,2023-11-18 18:46:06,1282249084,50071,356,60,40,4,56
132440,2023-11-18 18:46:41,1282250003,50071,356,60,40,4,56
169649,2023-11-18 18:49:31,1282254880,0,0,1,0,0,1
169648,2023-11-18 18:50:53,1282257338,2581,47,15,8,2,13
169651,2023-11-18 18:57:05,1282268063,73682,76,76,47,8,68
169651,2023-11-18 18:57:10,1282268236,73682,76,76,47,8,68
169652,2023-11-18 19:03:46,1282279809,21313,55,13,4,6,7
123197,2023-11-18 19:05:16,1282282489,0,0,15,4,0,15
123192,2023-11-18 19:05:57,1282283590,12290,64,98,25,7,91
123195,2023-11-18 19:06:18,1282284288,0,0,15,6,0,15
123195,2023-11-18 19:06:27,1282284559,0,0,15,6,0,15
123198,2023-11-18 19:06:44,1282285016,1325,3,104,7,1,103
160761,2023-11-18 19:07:19,1282286075,0,0,19,5,0,19
160761,2023-11-18 19:07:24,1282286252,0,0,19,5,0,19
169654,2023-11-18 19:13:16,1282296415,33301,160,34,11,5,29
169655,2023-11-18 19:16:49,1282302513,78004,209,43,32,5,38
169655,2023-11-18 19:16:55,1282302651,78004,209,43,32,5,38
169646,2023-11-18 19:24:07,1282315147,92868,354,40,16,8,32
169646,2023-11-18 19:24:11,1282315240,92868,354,40,16,8,32
169657,2023-11-21 14:26:39,1284282564,8582,60,14,4,4,10
169657,2023-11-21 14:26:40,1284282575,8582,60,14,4,4,10
169657,2023-11-21 14:26:44,1284282599,8582,60,14,4,4,10
169658,2023-11-21 14:27:21,1284282782,0,0,3,1,0,3
169658,2023-11-21 14:27:22,1284282787,0,0,3,1,0,3
169659,2023-11-21 14:27:47,1284282928,10174,6,12,12,1,11
169659,2023-11-21 14:27:48,1284282934,10174,6,12,12,1,11
169659,2023-11-21 14:27:53,1284282973,10174,6,12,12,1,11
169659,2023-11-21 14:27:54,1284282980,10174,6,12,12,1,11
169659,2023-11-21 14:27:55,1284282987,10174,6,12,12,1,11
169659,2023-11-21 14:27:56,1284282992,10174,6,12,12,1,11
169660,2023-11-21 14:28:29,1284283189,6793,30,8,2,1,7
169660,2023-11-21 14:28:30,1284283191,6793,30,8,2,1,7
169661,2023-11-21 14:28:58,1284283321,0,9,36,22,0,36
169661,2023-11-21 14:28:59,1284283324,0,9,36,22,0,36
169661,2023-11-21 14:29:06,1284283378,0,9,36,22,0,36
169662,2023-11-21 14:30:04,1284283657,35799,24,36,19,1,35
169662,2023-11-21 14:30:09,1284283706,35799,24,36,19,1,35
169662,2023-11-21 14:30:10,1284283713,35799,24,36,19,1,35
169662,2023-11-21 14:30:11,1284283719,35799,24,36,19,1,35
169663,2023-11-21 14:30:50,1284283969,0,11,29,14,0,29
169663,2023-11-21 14:30:51,1284283972,0,11,29,14,0,29
169663,2023-11-21 14:30:57,1284284012,0,11,29,14,0,29
169663,2023-11-21 14:30:58,1284284016,0,11,29,14,0,29
169702,2023-11-21 14:41:55,1284288073,50452,197,61,49,5,56
169702,2023-11-21 14:41:57,1284288080,50452,197,61,49,5,56
169705,2023-11-21 14:54:29,1284293686,127944,72,29,9,14,15
169707,2023-11-21 14:58:50,1284295639,23016,95,45,22,4,41
169707,2023-11-21 14:59:07,1284295762,23016,95,45,22,4,41
169705,2023-11-21 14:59:15,1284295819,127944,72,29,9,14,15
169705,2023-11-21 14:59:16,1284295828,127944,72,29,9,14,15
169705,2023-11-21 14:59:17,1284295839,127944,72,29,9,14,15
169708,2023-11-21 15:06:13,1284298946,193466,142,19,6,8,11
169711,2023-11-21 15:26:03,1284309372,0,3,4,0,0,4
169711,2023-11-21 15:26:06,1284309400,0,3,4,0,0,4
169703,2023-11-21 15:26:36,1284309668,98006,233,40,31,7,33
169703,2023-11-21 15:26:40,1284309712,98006,233,40,31,7,33
169703,2023-11-21 15:26:42,1284309729,98006,233,40,31,7,33
169704,2023-11-21 15:26:53,1284309831,15310,29,26,20,2,24
169704,2023-11-21 15:26:54,1284309837,15310,29,26,20,2,24
169704,2023-11-21 15:26:55,1284309854,15310,29,26,20,2,24
169704,2023-11-21 15:26:56,1284309872,15310,29,26,20,2,24
169709,2023-11-21 15:27:04,1284309969,45769,25,29,9,2,27
169709,2023-11-21 15:27:08,1284310015,45769,25,29,9,2,27
169709,2023-11-21 15:27:09,1284310025,45769,25,29,9,2,27
169710,2023-11-21 15:27:18,1284310117,31539,56,14,7,5,9
169710,2023-11-21 15:27:19,1284310125,31539,56,14,7,5,9
169710,2023-11-21 15:27:20,1284310140,31539,56,14,7,5,9
169710,2023-11-21 15:27:21,1284310154,31539,56,14,7,5,9
28889,2023-11-21 15:32:37,1284313479,68616,93,21,13,5,16
169714,2023-11-21 16:03:01,1284333682,0,0,1,0,0,1
169719,2023-11-21 16:22:23,1284348709,9940,57,16,9,2,14
169720,2023-11-21 16:24:50,1284350648,96448,12,37,20,2,35
169720,2023-11-21 16:25:23,1284351105,96448,12,37,20,2,35
169720,2023-11-21 16:25:24,1284351119,96448,12,37,20,2,35
92981,2023-11-21 16:38:18,1284361868,0,0,16,8,0,16
92981,2023-11-21 16:38:20,1284361879,0,0,16,8,0,16
124922,2023-11-21 16:38:37,1284362089,26049,104,34,23,6,28
124922,2023-11-21 16:38:40,1284362128,26049,104,34,23,6,28
124922,2023-11-21 16:38:41,1284362155,26049,104,34,23,6,28
93038,2023-11-21 16:39:03,1284362466,0,7,53,30,0,53
93038,2023-11-21 16:39:05,1284362484,0,7,53,30,0,53
169724,2023-11-21 16:39:41,1284362980,45199,76,13,7,4,9
169724,2023-11-21 16:39:42,1284363002,45199,76,13,7,4,9
169724,2023-11-21 16:39:45,1284363051,45199,76,13,7,4,9
169725,2023-11-21 16:40:19,1284363514,11553,115,26,12,5,21
169725,2023-11-21 16:40:35,1284363737,11553,115,26,12,5,21
169725,2023-11-21 16:40:36,1284363747,11553,115,26,12,5,21
169733,2023-11-21 17:01:46,1284381638,16239,122,72,45,6,66
169733,2023-11-21 17:01:57,1284381780,16239,122,72,45,6,66
169733,2023-11-21 17:02:02,1284381858,16239,122,72,45,6,66
169735,2023-11-21 17:05:51,1284385072,18266,341,27,6,7,20
169737,2023-11-21 17:10:24,1284388916,70833,82,32,21,4,28
169737,2023-11-21 17:10:36,1284389075,70833,82,32,21,4,28
169734,2023-11-21 17:11:14,1284389665,30104,66,12,6,3,9
169734,2023-11-21 17:11:18,1284389712,30104,66,12,6,3,9
169741,2023-11-21 17:29:24,1284406005,2236,2,2,0,1,1
169745,2023-11-21 17:30:52,1284407247,96874,27,30,23,3,27
169656,2023-11-21 17:36:37,1284412453,67963,255,63,48,9,54
161911,2023-11-21 18:04:48,1284437883,46650,107,62,41,7,55
161911,2023-11-21 18:05:37,1284438618,46650,107,62,41,7,55
156210,2023-11-21 18:05:41,1284438666,139211,282,49,30,9,40
156219,2023-11-21 18:05:47,1284438747,11192,192,24,9,3,21
156222,2023-11-21 18:06:30,1284439370,41352,231,27,14,7,20
156216,2023-11-21 18:06:45,1284439592,153615,309,68,52,7,61
156213,2023-11-21 18:06:50,1284439636,19928,51,34,27,3,31
169727,2023-11-21 18:12:24,1284444628,5007,32,25,11,1,24
169757,2023-11-21 19:05:56,1284492757,17530,36,11,6,4,7
169758,2023-11-21 19:07:19,1284494038,0,103,23,12,0,23
169767,2023-11-21 19:24:32,1284509975,52291,90,62,44,5,57
169767,2023-11-21 19:25:26,1284510810,52291,90,62,44,5,57
169769,2023-11-21 19:29:24,1284514409,5446,95,45,26,3,42
169769,2023-11-21 19:29:27,1284514498,5446,95,45,26,3,42
126749,2023-11-21 19:38:24,1284522842,8978,110,18,14,3,15
126749,2023-11-21 19:38:25,1284522874,8978,110,18,14,3,15
126749,2023-11-21 19:38:27,1284522896,8978,110,18,14,3,15
137763,2023-11-21 19:42:54,1284526858,5718,20,57,38,1,56
137763,2023-11-21 19:42:55,1284526869,5718,20,57,38,1,56
137763,2023-11-21 19:42:57,1284526892,5718,20,57,38,1,56
137763,2023-11-21 19:42:58,1284526893,5718,20,57,38,1,56
169771,2023-11-21 19:49:49,1284533251,116210,26,23,14,2,21
169771,2023-11-21 19:49:55,1284533327,116210,26,23,14,2,21
169773,2023-11-21 19:52:59,1284536156,76119,187,77,41,4,73
169773,2023-11-21 19:53:12,1284536415,76119,187,77,41,4,73
169773,2023-11-21 19:59:46,1284542643,76119,187,77,41,4,73
169742,2023-11-21 20:17:15,1284558034,15466,72,76,39,2,74
169742,2023-11-21 20:17:20,1284558121,15466,72,76,39,2,74
169775,2023-11-21 20:32:44,1284571574,5941,48,16,12,2,14
169775,2023-11-21 20:32:45,1284571593,5941,48,16,12,2,14
169775,2023-11-21 20:32:46,1284571611,5941,48,16,12,2,14
169775,2023-11-21 20:32:47,1284571632,5941,48,16,12,2,14
169775,2023-11-21 20:32:48,1284571642,5941,48,16,12,2,14
169775,2023-11-21 20:32:49,1284571663,5941,48,16,12,2,14
169775,2023-11-21 20:32:50,1284571675,5941,48,16,12,2,14
169775,2023-11-21 20:32:51,1284571686,5941,48,16,12,2,14
169775,2023-11-21 20:32:52,1284571708,5941,48,16,12,2,14
169775,2023-11-21 20:32:58,1284571729,5941,48,15,11,2,13
169775,2023-11-21 20:32:54,1284571753,5941,48,16,12,2,14
169775,2023-11-21 20:32:55,1284571760,5941,48,16,12,2,14
169775,2023-11-21 20:32:57,1284571796,5941,48,16,12,2,14
169775,2023-11-21 20:33:00,1284571839,5941,48,16,12,2,14
169775,2023-11-21 20:33:01,1284571857,5941,48,16,12,2,14
169775,2023-11-21 20:33:03,1284571881,5941,48,16,12,2,14
169775,2023-11-21 20:33:04,1284571911,5941,48,16,12,2,14
169775,2023-11-21 20:33:05,1284571913,5941,48,16,12,2,14
169775,2023-11-21 20:33:06,1284571936,5941,48,16,12,2,14
169775,2023-11-21 20:33:07,1284571958,5941,48,16,12,2,14
169775,2023-11-21 20:33:08,1284571974,5941,48,16,12,2,14
169775,2023-11-21 20:33:09,1284571979,5941,48,16,12,2,14
169775,2023-11-21 20:33:10,1284572008,5941,48,16,12,2,14
5812,2023-11-21 20:38:40,1284576731,50794,105,12,7,5,7
149817,2023-11-21 21:01:36,1284596424,26108,160,52,6,3,49
149817,2023-11-21 21:01:52,1284596652,26108,160,52,6,3,49
169774,2023-11-21 21:14:26,1284608172,2825,24,3,2,1,2
169789,2023-11-21 21:15:33,1284609242,2736,21,9,2,2,7
169791,2023-11-21 21:23:58,1284617042,20747,43,21,14,2,19
169789,2023-11-21 21:31:14,1284625163,2736,21,9,2,2,7
169792,2023-11-21 21:31:44,1284625796,8125,23,9,4,3,6
169792,2023-11-21 21:32:06,1284626304,8125,23,9,4,3,6
169792,2023-11-21 21:32:07,1284626308,8125,23,9,4,3,6
169792,2023-11-21 21:32:08,1284626327,8125,23,9,4,3,6
169792,2023-11-21 21:32:09,1284626342,8125,23,9,4,3,6
169793,2023-11-21 21:39:44,1284636385,0,0,16,0,0,16
169793,2023-11-21 21:39:45,1284636403,0,0,16,0,0,16
169794,2023-11-21 21:39:51,1284636521,19818,136,52,32,9,43
169796,2023-11-21 21:46:54,1284645731,36931,49,3,2,2,1
169796,2023-11-21 21:46:57,1284645801,36931,49,3,2,2,1
169796,2023-11-21 21:46:58,1284645831,36931,49,3,2,2,1
160456,2023-11-21 22:05:08,1284669531,0,79,7,3,0,7
160456,2023-11-21 22:05:10,1284669589,0,79,7,3,0,7
169807,2023-11-21 22:55:06,1284730464,37813,127,40,25,5,35
169807,2023-11-21 22:55:09,1284730509,37813,127,40,25,5,35
169807,2023-11-21 22:55:10,1284730524,37813,127,40,25,5,35
169807,2023-11-21 22:55:11,1284730548,37813,127,40,25,5,35
169807,2023-11-21 22:55:12,1284730583,37813,127,40,25,5,35
169807,2023-11-21 22:55:14,1284730624,37813,127,40,25,5,35
169807,2023-11-21 22:55:15,1284730644,37813,127,40,25,5,35
169807,2023-11-21 22:55:16,1284730646,37813,127,40,25,5,35
169807,2023-11-21 22:55:17,1284730687,37813,127,40,25,5,35
169807,2023-11-21 22:55:18,1284730697,37813,127,40,25,5,35
169807,2023-11-21 22:55:19,1284730713,37813,127,40,25,5,35
169807,2023-11-21 22:55:21,1284730760,37813,127,40,25,5,35
169807,2023-11-21 22:55:22,1284730770,37813,127,40,25,5,35
169807,2023-11-21 22:55:24,1284730821,37813,127,40,25,5,35
169807,2023-11-21 22:55:25,1284730838,37813,127,40,25,5,35
138904,2023-11-21 23:07:11,1284744923,11120,27,56,38,1,55
169814,2023-11-21 23:44:34,1284789972,17216,17,8,4,1,7
169814,2023-11-21 23:44:44,1284790166,17216,17,8,4,1,7
169814,2023-11-21 23:44:47,1284790233,17216,17,8,4,1,7
169814,2023-11-21 23:44:49,1284790266,17216,17,8,4,1,7
169814,2023-11-21 23:44:51,1284790313,17216,17,8,4,1,7
169814,2023-11-21 23:44:52,1284790342,17216,17,8,4,1,7
169814,2023-11-21 23:44:53,1284790364,17216,17,8,4,1,7
169814,2023-11-21 23:44:54,1284790386,17216,17,8,4,1,7
169814,2023-11-21 23:44:55,1284790413,17216,17,8,4,1,7
169814,2023-11-21 23:44:56,1284790434,17216,17,8,4,1,7
169814,2023-11-21 23:44:57,1284790461,17216,17,8,4,1,7
169814,2023-11-21 23:44:59,1284790491,17216,17,8,4,1,7
169814,2023-11-21 23:45:01,1284790543,17216,17,8,4,1,7
169814,2023-11-21 23:45:03,1284790591,17216,17,8,4,1,7
169814,2023-11-21 23:45:04,1284790601,17216,17,8,4,1,7
169814,2023-11-21 23:45:05,1284790641,17216,17,8,4,1,7
169814,2023-11-21 23:45:06,1284790671,17216,17,8,4,1,7
169814,2023-11-21 23:45:07,1284790679,17216,17,8,4,1,7
169814,2023-11-21 23:45:08,1284790698,17216,17,8,4,1,7
169814,2023-11-21 23:45:09,1284790731,17216,17,8,4,1,7
169814,2023-11-21 23:45:10,1284790771,17216,17,8,4,1,7
169716,2023-11-22 14:21:14,1285319697,5130,18,27,7,3,24
169723,2023-11-22 14:21:25,1285319772,0,0,31,4,0,31
169716,2023-11-22 14:21:37,1285319838,5130,18,27,7,3,24
169816,2023-11-22 14:56:45,1285336146,56688,174,47,31,6,41
169816,2023-11-22 14:56:46,1285336153,56688,174,47,31,6,41
169816,2023-11-22 14:56:47,1285336165,56688,174,47,31,6,41
169816,2023-11-22 14:56:49,1285336181,56688,174,47,31,6,41
169816,2023-11-22 14:56:51,1285336189,56688,174,47,31,6,41
169816,2023-11-22 14:56:52,1285336197,56688,174,47,31,6,41
169217,2023-11-22 15:00:29,1285337912,68924,71,73,40,5,68
169811,2023-11-22 15:11:11,1285343515,10299,171,34,27,1,33
97564,2023-11-22 15:55:39,1285373082,0,2,53,21,0,53
169870,2023-11-22 16:34:14,1285404247,10077,167,41,23,11,30
169873,2023-11-22 16:55:02,1285422171,90183,54,20,14,5,15
169882,2023-11-22 17:06:38,1285432128,3471,60,14,9,2,12
169883,2023-11-22 17:14:55,1285439568,2293,42,59,46,2,57
169884,2023-11-22 17:19:51,1285443973,916,8,6,4,1,5
169886,2023-11-22 17:23:13,1285447013,1042,7,29,17,1,28
169887,2023-11-22 17:29:15,1285452358,23014,77,34,24,6,28
169889,2023-11-22 17:32:50,1285455406,80439,189,47,20,8,39
161175,2023-11-22 17:57:58,1285477880,160528,48,89,59,3,86
161731,2023-11-22 17:59:22,1285479196,18201,94,50,30,3,47
161786,2023-11-22 17:59:55,1285479667,54140,46,72,33,1,71
161635,2023-11-22 18:00:21,1285480068,0,295,118,33,0,118
161540,2023-11-22 18:00:48,1285480471,5342,100,34,26,2,32
161540,2023-11-22 18:01:14,1285480908,5342,100,34,26,2,32
169906,2023-11-22 18:01:57,1285481513,60933,40,30,27,3,27
169906,2023-11-22 18:01:58,1285481527,60933,40,30,27,3,27
169911,2023-11-22 18:28:20,1285505351,24351,67,65,27,7,58
169912,2023-11-22 18:32:36,1285509174,0,0,16,10,0,16
169915,2023-11-22 18:52:36,1285527866,64067,35,33,25,2,31
159585,2023-11-22 19:09:56,1285544170,101115,157,61,21,13,48
159513,2023-11-22 19:10:27,1285544690,38005,78,41,10,8,33
31044,2023-11-22 19:11:05,1285545284,61356,85,27,3,5,22
160115,2023-11-22 19:11:34,1285545791,2540,11,9,6,1,8
160142,2023-11-22 19:12:02,1285546244,2002,15,9,5,1,8
169919,2023-11-22 19:12:05,1285546330,0,0,4,3,0,4
160142,2023-11-22 19:12:14,1285546464,2002,15,9,5,1,8
160143,2023-11-22 19:12:37,1285546844,8517,34,47,33,3,44
160143,2023-11-22 19:12:40,1285546895,8517,34,47,33,3,44
160121,2023-11-22 19:13:02,1285547254,16180,59,24,9,9,15
160121,2023-11-22 19:13:09,1285547378,16180,59,24,9,9,15
160133,2023-11-22 19:13:33,1285547766,25309,80,36,15,5,31
160133,2023-11-22 19:13:35,1285547800,25309,80,36,15,5,31
118606,2023-11-22 19:15:41,1285549903,879,13,65,32,2,63
150578,2023-11-22 19:16:27,1285550647,0,101,53,35,0,53
150463,2023-11-22 19:16:51,1285551015,77541,22,43,34,3,40
169920,2023-11-22 19:24:33,1285557955,8517,373,21,7,2,19
169921,2023-11-22 19:24:42,1285558091,4130,132,14,4,3,11
169923,2023-11-22 19:36:08,1285568298,19837,122,33,6,3,30
169778,2023-11-22 19:39:13,1285571001,38149,93,25,6,5,20
169778,2023-11-22 19:39:14,1285571015,38149,93,25,6,5,20
169778,2023-11-22 19:39:15,1285571023,38149,93,25,6,5,20
169778,2023-11-22 19:39:16,1285571041,38149,93,25,6,5,20
169808,2023-11-22 19:40:46,1285572392,22242,31,10,5,6,4
169808,2023-11-22 19:40:47,1285572413,22242,31,10,5,6,4
169925,2023-11-22 20:05:36,1285594764,75041,214,90,41,11,79
169925,2023-11-22 20:05:53,1285595019,75041,214,90,41,11,79
169927,2023-11-22 20:13:49,1285601934,540,145,35,0,3,32
143386,2023-11-22 20:21:04,1285608369,24193,105,17,13,6,11
126112,2023-11-22 20:32:11,1285618492,62621,44,69,36,3,66
126112,2023-11-22 20:32:13,1285618527,62621,44,69,36,3,66
126112,2023-11-22 20:32:16,1285618588,62621,44,69,36,3,66
126101,2023-11-22 20:32:31,1285618821,11042,225,54,25,4,50
126101,2023-11-22 20:32:32,1285618842,11042,225,54,25,4,50
126101,2023-11-22 20:32:33,1285618854,11042,225,54,25,4,50
126101,2023-11-22 20:32:34,1285618866,11042,225,54,25,4,50
126101,2023-11-22 20:32:36,1285618890,11042,225,54,25,4,50
126106,2023-11-22 20:32:46,1285619040,35903,13,8,6,1,7
126106,2023-11-22 20:32:47,1285619047,35903,13,8,6,1,7
126106,2023-11-22 20:32:48,1285619062,35903,13,8,6,1,7
161991,2023-11-22 20:33:03,1285619268,221765,273,84,22,3,81
161991,2023-11-22 20:33:04,1285619313,221765,273,84,22,3,81
161991,2023-11-22 20:33:07,1285619361,221765,273,84,22,3,81
161991,2023-11-22 20:33:08,1285619365,221765,273,84,22,3,81
161903,2023-11-22 20:33:16,1285619504,35903,15,12,7,1,11
161903,2023-11-22 20:33:17,1285619518,35903,15,12,7,1,11
161903,2023-11-22 20:33:18,1285619531,35903,15,12,7,1,11
161903,2023-11-22 20:33:19,1285619550,35903,15,12,7,1,11
169928,2023-11-22 20:34:12,1285620384,4946,5,2,0,1,1
169928,2023-11-22 20:34:13,1285620404,4946,5,2,0,1,1
169928,2023-11-22 20:34:14,1285620424,4946,5,2,0,1,1
169928,2023-11-22 20:34:15,1285620433,4946,5,2,0,1,1
169926,2023-11-22 20:38:29,1285624256,113166,79,11,5,8,3
169926,2023-11-22 20:38:30,1285624258,113166,79,11,5,8,3
169926,2023-11-22 20:38:31,1285624273,113166,79,11,5,8,3
169926,2023-11-22 20:38:32,1285624289,113166,79,11,5,8,3
169926,2023-11-22 20:38:33,1285624293,113166,79,11,5,8,3
169926,2023-11-22 20:38:34,1285624311,113166,79,11,5,8,3
169926,2023-11-22 20:38:36,1285624347,113166,79,11,5,8,3
169926,2023-11-22 20:38:37,1285624369,113166,79,11,5,8,3
169926,2023-11-22 20:38:40,1285624400,113166,79,11,5,8,3
169931,2023-11-22 20:46:09,1285631192,17179,42,48,25,4,44
169931,2023-11-22 20:46:10,1285631201,17179,42,48,25,4,44
169931,2023-11-22 20:46:11,1285631227,17179,42,48,25,4,44
169931,2023-11-22 20:46:13,1285631255,17179,42,48,25,4,44
169939,2023-11-22 21:27:13,1285677913,4597,26,21,8,2,19
169942,2023-11-22 21:27:24,1285678123,23996,362,82,43,11,71
169951,2023-11-22 21:47:41,1285704247,13350,29,17,5,2,15
169946,2023-11-22 21:53:55,1285711981,0,0,14,12,0,14
169952,2023-11-22 21:55:22,1285713767,26201,182,8,5,6,2
169952,2023-11-22 21:55:23,1285713778,26201,182,8,5,6,2
169952,2023-11-22 21:55:27,1285713868,26201,182,8,5,6,2
169953,2023-11-22 21:55:40,1285714104,190109,283,74,55,11,63
169954,2023-11-22 21:55:51,1285714342,2807,24,6,5,1,5
111075,2023-11-22 21:56:42,1285715341,49968,216,58,36,9,49
169960,2023-11-22 22:09:09,1285730622,51945,306,47,24,8,39
169960,2023-11-22 22:09:14,1285730719,51945,306,47,24,8,39
169963,2023-11-22 22:09:15,1285730733,1561,2,5,3,1,4
169960,2023-11-22 22:09:15,1285730739,51945,306,47,24,8,39
169960,2023-11-22 22:09:16,1285730764,51945,306,47,24,8,39
169960,2023-11-22 22:09:17,1285730793,51945,306,47,24,8,39
169960,2023-11-22 22:09:18,1285730794,51945,306,47,24,8,39
169960,2023-11-22 22:09:19,1285730810,51945,306,47,24,8,39
169960,2023-11-22 22:09:20,1285730830,51945,306,47,24,8,39
169960,2023-11-22 22:09:21,1285730851,51945,306,47,24,8,39
169960,2023-11-22 22:09:22,1285730872,51945,306,47,24,8,39
169960,2023-11-22 22:09:23,1285730901,51945,306,47,24,8,39
169960,2023-11-22 22:09:24,1285730905,51945,306,47,24,8,39
169960,2023-11-22 22:09:25,1285730926,51945,306,47,24,8,39
169960,2023-11-22 22:09:26,1285730940,51945,306,47,24,8,39
169960,2023-11-22 22:09:27,1285730971,51945,306,47,24,8,39
169960,2023-11-22 22:09:28,1285730992,51945,306,47,24,8,39
169960,2023-11-22 22:09:29,1285731008,51945,306,47,24,8,39
169960,2023-11-22 22:09:30,1285731030,51945,306,47,24,8,39
169960,2023-11-22 22:09:31,1285731054,51945,306,47,24,8,39
169960,2023-11-22 22:09:32,1285731075,51945,306,47,24,8,39
169963,2023-11-22 22:09:33,1285731087,1561,2,5,3,1,4
169963,2023-11-22 22:09:34,1285731125,1561,2,5,3,1,4
169963,2023-11-22 22:09:35,1285731145,1561,2,5,3,1,4
150338,2023-11-22 22:16:11,1285739102,34220,129,55,22,8,47
150770,2023-11-22 22:16:37,1285739620,6676,28,24,11,4,20
150414,2023-11-22 22:17:00,1285740021,35769,72,38,19,4,34
150267,2023-11-22 22:17:21,1285740493,7099,13,25,16,2,23
150417,2023-11-22 22:17:41,1285740886,4607,6,8,1,1,7
169969,2023-11-22 22:24:33,1285748834,51129,163,51,33,10,41
169969,2023-11-22 22:24:35,1285748870,51129,163,51,33,10,41
169969,2023-11-22 22:24:36,1285748905,51129,163,51,33,10,41
169969,2023-11-22 22:24:37,1285748928,51129,163,51,33,10,41
169969,2023-11-22 22:24:39,1285748968,51129,163,51,33,10,41
169971,2023-11-22 22:48:03,1285776129,5420,18,21,17,3,18
169971,2023-11-22 22:48:08,1285776204,5420,18,21,17,3,18
169918,2023-11-23 01:08:28,1285933802,0,2,11,7,0,11
169978,2023-11-23 14:28:07,1286361408,0,0,1,0,0,1
126103,2023-11-23 15:12:07,1286379116,663,2,126,25,1,125
134962,2023-11-23 15:16:26,1286381236,24002,282,42,26,5,37
134969,2023-11-23 15:17:08,1286381648,25787,162,26,12,5,21
169992,2023-11-23 15:17:42,1286381912,24136,50,55,38,5,50
135824,2023-11-23 15:17:48,1286381956,37089,224,33,18,5,28
145725,2023-11-23 15:18:28,1286382326,22957,272,48,10,7,41
145704,2023-11-23 15:19:23,1286382800,0,10,2,0,0,2
145712,2023-11-23 15:20:36,1286383421,6465,10,7,6,1,6
145921,2023-11-23 15:21:47,1286384100,29573,52,16,7,5,11
169994,2023-11-23 15:39:49,1286394523,1988,15,71,26,3,68
131066,2023-11-23 15:49:23,1286400448,864,88,31,19,1,30
130170,2023-11-23 15:50:03,1286400816,37195,62,45,33,4,41
131000,2023-11-23 15:50:57,1286401359,9252,6,4,0,1,3
130159,2023-11-23 15:51:31,1286401764,0,5,38,22,0,38
160406,2023-11-23 15:52:11,1286402101,48514,122,100,18,8,92
160406,2023-11-23 15:52:25,1286402244,48514,122,100,18,8,92
161989,2023-11-23 15:53:01,1286402579,0,0,17,7,0,17
149855,2023-11-23 16:18:22,1286419628,37580,153,45,29,3,42
149854,2023-11-23 16:21:05,1286421581,186057,169,90,36,17,73
149842,2023-11-23 16:21:28,1286421844,21799,38,40,25,1,39
149839,2023-11-23 16:21:48,1286422069,10373,23,48,30,3,45
151733,2023-11-23 16:48:44,1286442485,1392,64,32,17,2,30
170018,2023-11-23 18:08:29,1286511109,20387,214,20,12,5,15
170019,2023-11-23 18:08:34,1286511171,32384,108,18,7,4,14
92950,2023-11-23 18:15:06,1286516893,119082,37,68,25,4,64
170020,2023-11-23 18:31:47,1286531209,0,6,81,42,0,81
170021,2023-11-23 18:40:09,1286538382,31723,121,15,4,4,11
170022,2023-11-23 18:50:24,1286547075,4928,30,21,12,1,20
170027,2023-11-23 19:19:27,1286572166,6693,77,15,2,1,14
134960,2023-11-23 19:26:32,1286578249,11440,56,19,11,3,16
160913,2023-11-23 20:12:07,1286616340,31102,100,23,19,6,17
160905,2023-11-23 20:12:50,1286616875,146912,167,51,46,6,45
160911,2023-11-23 20:13:48,1286617676,34985,129,97,69,5,92
160941,2023-11-23 20:14:44,1286618410,36840,100,125,82,6,119
160910,2023-11-23 20:15:40,1286619227,0,7,36,11,0,36
170039,2023-11-23 20:15:52,1286619377,12722,80,24,14,5,19
170041,2023-11-23 20:27:00,1286628651,50707,161,22,14,10,12
170043,2023-11-23 21:49:10,1286695254,3166,44,18,5,4,14
170044,2023-11-23 21:49:37,1286695604,5092,138,134,54,10,124
170047,2023-11-23 21:49:57,1286695872,1915,6,9,6,1,8
170047,2023-11-23 21:50:03,1286695952,1915,6,9,6,1,8
170049,2023-11-23 21:50:18,1286696148,68970,54,63,27,4,59
170052,2023-11-23 21:50:21,1286696185,24630,93,63,39,3,60
170051,2023-11-23 21:50:31,1286696320,0,0,16,3,0,16
170053,2023-11-23 21:53:58,1286699034,0,0,31,4,0,31
170055,2023-11-23 21:58:14,1286702471,5130,18,27,7,3,24
170057,2023-11-23 22:01:29,1286705198,49398,96,52,19,4,48
170058,2023-11-23 22:03:46,1286706962,22978,41,19,6,2,17
170059,2023-11-23 22:08:54,1286711118,310,54,22,14,3,19
170060,2023-11-23 22:10:21,1286712235,29142,97,41,18,8,33
170061,2023-11-23 22:11:37,1286713265,4528,122,45,23,3,42
170063,2023-11-23 22:40:44,1286735880,22167,31,30,26,5,25
170064,2023-11-23 22:45:51,1286739735,0,1,3,0,0,3
170065,2023-11-23 22:47:18,1286740886,0,0,6,2,0,6
170066,2023-11-23 22:47:45,1286741221,48266,88,36,17,8,28
170067,2023-11-23 22:51:29,1286744075,0,7,42,5,0,42
170068,2023-11-23 22:53:22,1286745541,41254,100,14,6,4,10
170069,2023-11-23 22:55:30,1286747181,0,1,6,0,0,6
170070,2023-11-23 22:59:04,1286749952,1111,12,5,2,1,4
170071,2023-11-23 23:17:43,1286763640,20139,26,69,32,5,64
128281,2023-11-24 02:51:01,1286902194,22695,27,27,10,5,22
100290,2023-11-24 02:54:43,1286903775,35653,16,21,15,1,20
161519,2023-11-24 14:31:34,1287070070,110106,83,15,7,6,9
161484,2023-11-24 14:32:30,1287070346,289359,164,50,28,12,38
161467,2023-11-24 14:33:03,1287070497,32597,32,18,10,3,15
161462,2023-11-24 14:33:30,1287070666,15284,29,18,4,5,13
161445,2023-11-24 14:34:02,1287070814,189123,307,51,32,12,39
143346,2023-11-24 15:00:52,1287080247,16699,41,58,38,5,53
160899,2023-11-24 15:01:08,1287080368,67588,131,85,62,5,80
143344,2023-11-24 15:01:19,1287080448,0,9,49,29,0,49
160953,2023-11-24 15:01:31,1287080546,2436,6,24,18,1,23
170115,2023-11-24 16:42:07,1287136997,562266,372,80,54,12,68
170135,2023-11-24 16:43:16,1287137796,1903,23,215,1,3,212
170137,2023-11-24 16:52:03,1287144124,0,17,8,0,0,8
170146,2023-11-24 17:04:11,1287152420,0,1,6,1,0,6
170148,2023-11-24 17:12:10,1287158257,19117,201,53,38,4,49
170126,2023-11-24 17:16:26,1287161989,94653,195,42,13,14,28
170149,2023-11-24 17:18:52,1287164043,897,78,24,5,2,22
160997,2023-11-24 17:30:10,1287173761,24918,63,30,18,5,25
97557,2023-11-24 17:30:18,1287173897,0,2,50,32,0,50
100087,2023-11-24 17:33:25,1287176403,151879,184,115,38,9,106
100094,2023-11-24 17:34:03,1287176919,127277,108,95,54,12,83
100546,2023-11-24 17:34:50,1287177627,93648,133,65,25,5,60
100474,2023-11-24 17:35:03,1287177798,85946,55,96,42,5,91
110573,2023-11-24 17:35:37,1287178266,40802,95,89,51,8,81
110572,2023-11-24 17:35:36,1287178307,62314,82,25,5,5,20
116673,2023-11-24 17:35:56,1287178584,14712,48,38,23,4,34
170152,2023-11-24 17:38:22,1287180587,0,4,85,72,0,85
170159,2023-11-24 17:55:18,1287194858,28511,168,64,38,6,58
170157,2023-11-24 17:55:29,1287195016,33446,258,56,29,12,44
170160,2023-11-24 18:04:12,1287202377,44875,133,54,34,4,50
170162,2023-11-24 18:14:27,1287211053,10364,19,14,5,3,11
170193,2023-11-24 20:37:46,1287338503,3078,14,12,12,1,11
170201,2023-11-24 20:41:15,1287341511,54518,213,69,32,9,60
170202,2023-11-24 20:41:31,1287341724,3633,294,8,3,1,7
149962,2023-11-24 21:14:15,1287369059,161567,41,14,4,3,11
149965,2023-11-24 21:14:35,1287369343,241725,24,9,1,1,8
149964,2023-11-24 21:14:51,1287369590,14948,54,16,1,7,9
149959,2023-11-24 21:15:08,1287369845,13588,48,6,0,2,4
149958,2023-11-24 21:15:27,1287370072,1574,2,437,21,1,436
149963,2023-11-24 21:15:43,1287370292,26273,7,12,8,1,11
149960,2023-11-24 21:15:57,1287370519,0,10,5,2,0,5
170195,2023-11-24 21:30:58,1287383208,51811,36,120,21,1,119
170195,2023-11-24 21:31:03,1287383275,51811,36,120,21,1,119
170213,2023-11-24 22:23:59,1287425578,228855,294,125,30,10,115
170230,2023-11-25 00:24:03,1287511387,55404,53,75,31,3,72
170231,2023-11-25 00:24:12,1287511504,0,1,36,16,0,36
170232,2023-11-25 00:24:21,1287511605,89084,109,58,36,5,53
170233,2023-11-25 00:24:32,1287511706,0,0,5,1,0,5
170234,2023-11-25 00:24:45,1287511829,12518,28,17,10,2,15
170216,2023-11-25 14:26:26,1288454621,4361,56,137,45,1,136
170222,2023-11-25 14:26:29,1288454627,0,1,21,18,0,21
170046,2023-11-25 14:33:37,1288472188,0,0,27,10,0,27
170247,2023-11-25 14:33:58,1288473430,449,6,14,2,2,12
170248,2023-11-25 14:50:33,1288503527,46188,204,24,17,5,19
170248,2023-11-25 14:50:34,1288503538,46188,204,24,17,5,19
141411,2023-11-25 15:15:46,1288544134,6978,52,130,36,1,129
170250,2023-11-25 15:15:48,1288544143,39385,192,24,19,8,16
170253,2023-11-25 15:19:45,1288548539,9777,16,27,17,2,25
170249,2023-11-25 15:22:05,1288560078,0,8,17,3,0,17
170257,2023-11-25 15:22:16,1288560857,11609,25,20,7,2,18
170272,2023-11-25 16:39:51,1288678645,9311,14,23,14,4,19
170273,2023-11-25 17:22:28,1288716425,6337,196,92,10,3,89
170274,2023-11-25 17:28:05,1288721762,538,4,17,9,1,16
129841,2023-11-25 18:19:31,1288766870,44865,67,74,33,2,72
129838,2023-11-25 18:20:01,1288767219,0,0,21,16,0,21
129839,2023-11-25 18:20:22,1288767496,2689,36,36,21,2,34
129840,2023-11-25 18:20:49,1288767797,22210,142,26,22,2,24
129835,2023-11-25 18:21:11,1288768072,77957,345,68,43,5,63
129836,2023-11-25 18:22:25,1288768957,39511,206,91,26,8,83
129836,2023-11-25 18:22:27,1288768982,39511,206,91,26,8,83
129834,2023-11-25 18:29:11,1288773636,44915,37,51,37,2,49
170275,2023-11-25 18:29:42,1288774020,48332,55,25,11,5,20
170277,2023-11-25 19:14:46,1288806058,4379,16,16,2,1,15
170278,2023-11-25 19:15:21,1288806464,4608,46,11,10,2,9
170279,2023-11-25 19:15:29,1288806540,71281,111,33,19,5,28
170282,2023-11-25 19:15:40,1288806667,21384,89,29,13,3,26
170289,2023-11-27 14:22:39,1290006912,0,0,38,25,0,38
170290,2023-11-27 14:22:47,1290007100,28884,23,28,15,1,27
170300,2023-11-27 15:35:39,1290063220,150081,177,71,47,11,60
170325,2023-11-27 16:40:29,1290108822,0,0,12,1,0,12
149850,2023-11-27 16:43:50,1290111377,0,119,24,6,0,24
170327,2023-11-27 17:06:39,1290127759,1887,13,10,5,1,9
170337,2023-11-27 17:34:05,1290147437,5879,17,14,11,1,13
170319,2023-11-27 18:03:17,1290168746,58074,123,52,37,5,47
170326,2023-11-27 18:04:00,1290169240,34509,70,25,19,4,21
170329,2023-11-27 18:05:46,1290170538,1927,11,6,1,1,5
170330,2023-11-27 18:06:33,1290171088,105259,110,31,21,6,25
170335,2023-11-27 18:07:07,1290171493,96216,72,38,25,4,34
170352,2023-11-27 18:22:55,1290183221,21867,59,11,3,3,8
92964,2023-11-27 18:28:24,1290187354,0,5,278,27,0,278
93010,2023-11-27 18:28:50,1290187718,13044,40,43,18,2,41
169684,2023-11-27 19:11:39,1290219439,41077,7,3,1,2,1
170368,2023-11-27 19:45:06,1290242845,21629,278,217,36,3,214
170373,2023-11-27 20:02:24,1290259701,72010,125,46,17,14,32
170375,2023-11-27 20:02:50,1290260474,142341,137,49,42,6,43
170376,2023-11-27 20:09:22,1290272197,5337,8,9,6,1,8
170374,2023-11-27 20:14:11,1290280688,4597,26,21,8,2,19
170407,2023-11-27 21:48:36,1290360422,14978,56,30,25,3,27
170405,2023-11-27 21:59:14,1290367432,1585,3,2,0,2,0
170409,2023-11-27 21:59:19,1290367472,37371,98,24,13,6,18
170415,2023-11-27 22:24:52,1290384121,0,60,22,4,0,22
170415,2023-11-27 22:24:58,1290384180,0,60,22,4,0,22
170421,2023-11-27 22:44:04,1290396357,52211,253,58,7,10,48
170422,2023-11-27 22:48:00,1290398933,40899,190,26,21,5,21
170432,2023-11-27 22:50:51,1290400922,23824,139,68,28,5,63
170434,2023-11-27 22:59:12,1290406322,0,0,4,2,0,4
170435,2023-11-27 22:59:28,1290406494,43804,157,45,15,7,38
170436,2023-11-27 23:00:41,1290407169,11880,83,12,1,4,8
170439,2023-11-27 23:03:49,1290408998,13834,128,5,2,4,1
170440,2023-11-27 23:05:06,1290409794,6586,113,8,2,2,6
123540,2023-11-27 23:12:32,1290414144,7994,26,124,69,3,121
123541,2023-11-27 23:12:47,1290414316,68655,103,209,77,7,202
134932,2023-11-27 23:13:05,1290414484,16730,75,21,9,1,20
134989,2023-11-27 23:13:19,1290414635,44537,54,88,69,7,81
146003,2023-11-27 23:13:42,1290414862,15011,14,33,13,2,31
170442,2023-11-27 23:23:18,1290420648,34232,234,64,36,12,52
170298,2023-11-27 23:32:08,1290425889,8265,25,3,0,1,2
170418,2023-11-27 23:33:32,1290426729,8125,23,9,4,3,6
170451,2023-11-27 23:37:13,1290429034,65483,154,38,21,11,27
170454,2023-11-27 23:42:47,1290432396,80422,57,10,3,4,6
170458,2023-11-27 23:47:23,1290435035,46158,42,24,21,4,20
170461,2023-11-27 23:51:52,1290437718,192868,238,41,30,11,30
170462,2023-11-28 00:02:47,1290443892,46258,32,28,20,3,25
170463,2023-11-28 00:06:20,1290445828,194859,195,73,25,7,66
170465,2023-11-28 14:21:39,1290599375,0,0,3,2,0,3
170478,2023-11-28 15:03:19,1290613765,9682,55,45,33,2,43
170351,2023-11-28 15:07:58,1290615832,174249,272,99,38,11,88
170351,2023-11-28 15:08:01,1290615850,174249,272,99,38,11,88
170491,2023-11-28 15:41:03,1290633179,0,0,20,0,0,20
170489,2023-11-28 15:45:04,1290635667,95096,118,69,22,3,66
160237,2023-11-28 15:46:07,1290636290,21086,37,13,3,2,11
170495,2023-11-28 15:56:02,1290642353,41077,144,71,30,15,56
170490,2023-11-28 16:04:50,1290647888,19722,227,24,4,6,18
170492,2023-11-28 16:04:59,1290647982,26954,203,89,13,14,75
170496,2023-11-28 16:05:07,1290648088,16045,66,64,11,5,59
160330,2023-11-28 16:18:29,1290656667,27847,159,57,25,6,51
160337,2023-11-28 16:18:41,1290656809,0,13,83,67,0,83
160328,2023-11-28 16:19:01,1290657017,8587,120,113,44,2,111
160336,2023-11-28 16:19:21,1290657248,281876,163,29,15,8,21
170507,2023-11-28 16:21:59,1290659014,0,73,48,41,0,48
170408,2023-11-28 16:22:29,1290659373,20450,51,103,49,2,101
170508,2023-11-28 16:23:01,1290659685,82479,249,64,33,9,55
161001,2023-11-28 16:43:07,1290673454,2723,244,55,21,3,52
161621,2023-11-28 16:43:30,1290673716,1287,65,16,5,1,15
161523,2023-11-28 16:44:11,1290674232,2308,8,30,27,1,29
161577,2023-11-28 16:44:47,1290674617,0,77,47,26,0,47
159579,2023-11-28 16:45:08,1290674846,654,132,8,3,1,7
170510,2023-11-28 16:45:43,1290675269,5583,55,38,30,3,35
131172,2023-11-28 16:50:24,1290678455,32229,35,18,10,3,15
131094,2023-11-28 16:50:45,1290678622,11326,64,31,13,4,27
131094,2023-11-28 16:50:50,1290678642,11326,64,31,13,4,27
131094,2023-11-28 16:50:53,1290678659,11326,64,31,13,4,27
131079,2023-11-28 16:51:11,1290678905,38105,140,18,11,4,14
131079,2023-11-28 16:51:13,1290678928,38105,140,18,11,4,14
131077,2023-11-28 16:51:33,1290679166,30676,59,11,5,2,9
141036,2023-11-28 16:55:29,1290682137,0,13,31,6,0,31
141036,2023-11-28 16:55:32,1290682170,0,13,31,6,0,31
170519,2023-11-28 17:02:43,1290687604,2161,15,3,2,2,1
170527,2023-11-28 17:06:01,1290690143,38707,129,57,36,4,53
170531,2023-11-28 17:16:42,1290698321,40752,93,33,24,11,22
170487,2023-11-28 17:24:16,1290704250,47305,114,40,22,4,36
160579,2023-11-28 17:31:16,1290709889,281900,143,68,30,7,61
161042,2023-11-28 17:32:16,1290710711,5334,10,74,36,1,73
160582,2023-11-28 17:32:38,1290711031,21677,22,17,4,6,11
160583,2023-11-28 17:33:00,1290711339,10674,45,34,16,2,32
160991,2023-11-28 17:33:27,1290711721,2509,113,17,3,6,11
170534,2023-11-28 17:33:42,1290711911,34232,234,64,36,12,52
160581,2023-11-28 17:33:47,1290711978,4818,16,61,51,3,58
118869,2023-11-28 17:36:37,1290714185,86364,88,144,83,5,139
118861,2023-11-28 17:37:01,1290714552,37699,137,42,16,10,32
118865,2023-11-28 17:38:18,1290715613,122206,192,120,76,11,109
170535,2023-11-28 17:54:09,1290739184,21136,128,81,50,7,74
170544,2023-11-28 18:04:29,1290765926,33778,133,41,10,6,35
170547,2023-11-28 18:11:27,1290783655,419,132,8,1,1,7
170536,2023-11-28 18:21:53,1290810895,632,18,5,0,1,4
170551,2023-11-28 18:25:01,1290817248,14687,112,28,19,6,22
170555,2023-11-28 18:29:22,1290821108,6680,22,5,3,1,4
170557,2023-11-28 18:34:15,1290825357,15465,31,4,4,2,2
170552,2023-11-28 18:35:11,1290826107,47381,267,57,26,10,47
170561,2023-11-28 18:46:13,1290836283,11005,67,13,5,3,10
170563,2023-11-28 18:51:24,1290841099,49915,77,12,8,4,8
161000,2023-11-28 18:51:40,1290841359,664,3,29,23,2,27
170573,2023-11-28 19:16:39,1290863526,90314,65,25,19,3,22
170553,2023-11-28 19:19:03,1290865751,13688,220,56,30,5,51
170554,2023-11-28 19:19:11,1290865893,0,0,1,0,0,1
170558,2023-11-28 19:19:21,1290866011,37990,316,49,24,8,41
170569,2023-11-28 19:21:11,1290867620,118933,160,40,24,10,30
170566,2023-11-28 19:22:14,1290868528,22780,148,38,27,5,33
170587,2023-11-28 19:54:16,1290896897,5158,34,22,21,3,19
170577,2023-11-28 19:59:10,1290901218,1445,9,6,2,2,4
170578,2023-11-28 19:59:21,1290901392,34260,188,18,9,8,10
170589,2023-11-28 19:59:33,1290901580,30959,71,14,10,3,11
170579,2023-11-28 19:59:51,1290901827,123921,86,51,21,9,42
170568,2023-11-28 20:01:40,1290903358,50525,155,12,5,7,5
170588,2023-11-28 20:05:50,1290906973,0,1,40,38,0,40
170591,2023-11-28 20:21:25,1290919974,1475,10,5,2,2,3
170546,2023-11-28 20:30:30,1290927526,14622,44,48,17,2,46
170595,2023-11-28 20:35:43,1290931816,873,5,4,3,1,3
170597,2023-11-28 20:38:03,1290933675,0,6,81,42,0,81
170606,2023-11-28 21:22:53,1290970721,66398,137,78,43,14,64
170609,2023-11-28 21:59:39,1291002399,20536,101,57,38,7,50
170457,2023-11-28 22:04:05,1291005955,0,0,5,4,0,5
170447,2023-11-28 22:04:52,1291006571,26975,88,24,18,4,20
170444,2023-11-28 22:05:12,1291006844,0,0,1,0,0,1
151132,2023-11-28 22:13:15,1291013343,88153,102,80,60,7,73
151177,2023-11-28 22:13:45,1291013757,32647,294,66,37,13,53
151245,2023-11-28 22:14:10,1291014072,47680,75,73,44,3,70
170443,2023-11-28 22:15:30,1291015074,14300,69,6,3,3,3
170433,2023-11-28 22:15:59,1291015439,14459,11,16,7,2,14
170433,2023-11-28 22:16:02,1291015489,14459,11,16,7,2,14
151428,2023-11-28 22:17:28,1291016597,80397,63,64,48,4,60
135469,2023-11-28 22:17:55,1291016897,98854,144,756,69,6,750
170614,2023-11-28 22:27:48,1291024486,14690,155,13,5,5,8
170613,2023-11-28 22:29:29,1291025812,17036,63,46,28,4,42
170613,2023-11-28 22:29:30,1291025831,17036,63,46,28,4,42
170615,2023-11-28 22:43:18,1291036027,27848,28,7,2,4,3
170623,2023-11-28 22:58:19,1291046954,63401,240,94,18,25,69
170622,2023-11-28 23:06:04,1291052564,87953,142,34,16,5,29
170620,2023-11-28 23:06:45,1291053063,4157,269,32,1,3,29
170625,2023-11-28 23:33:35,1291072567,10870,151,66,19,3,63
170624,2023-11-29 14:21:13,1291543136,55033,155,61,33,8,53
170628,2023-11-29 14:37:41,1291548438,11206,168,34,1,3,31
170634,2023-11-29 14:39:06,1291548969,46680,53,110,83,3,107
170627,2023-11-29 14:42:24,1291550156,11235,57,21,14,3,18
170644,2023-11-29 14:42:31,1291550200,38238,37,15,6,2,13
170652,2023-11-29 14:42:42,1291550258,8130,23,9,2,3,6
170652,2023-11-29 14:42:45,1291550275,8130,23,9,2,3,6
170664,2023-11-29 14:47:04,1291551971,68786,50,39,32,4,35
170664,2023-11-29 14:47:06,1291551979,68786,50,39,32,4,35
170665,2023-11-29 15:07:35,1291559909,52315,78,7,3,4,3
130866,2023-11-29 15:12:37,1291562442,16643,38,20,13,2,18
130869,2023-11-29 15:13:02,1291562658,28403,30,69,64,2,67
130868,2023-11-29 15:13:22,1291562857,63321,99,128,86,9,119
130990,2023-11-29 15:14:03,1291563200,92981,116,41,21,4,37
140592,2023-11-29 15:14:25,1291563399,149,7,21,16,1,20
161239,2023-11-29 15:14:54,1291563656,3550,11,19,13,2,17
170616,2023-11-29 15:17:12,1291564889,13829,53,7,5,5,2
170617,2023-11-29 15:20:01,1291566317,49198,64,42,30,11,31
170619,2023-11-29 15:23:16,1291568021,123509,281,82,48,15,67
170619,2023-11-29 15:23:19,1291568054,123509,281,82,48,15,67
163109,2023-11-29 15:38:31,1291576548,698,8,17,5,1,16
163099,2023-11-29 15:38:51,1291576749,23736,85,165,60,3,162
163261,2023-11-29 15:39:09,1291576968,58246,108,129,39,17,112
163255,2023-11-29 15:39:53,1291577395,18909,43,86,41,2,84
163269,2023-11-29 15:40:12,1291577604,1559,41,64,35,2,62
170672,2023-11-29 15:53:44,1291585881,70412,80,42,20,6,36
170676,2023-11-29 16:10:23,1291596604,14198,24,7,3,1,6
170678,2023-11-29 16:10:32,1291596707,148242,91,32,22,4,28
3481,2023-11-29 16:14:33,1291599648,0,2,43,4,0,43
170681,2023-11-29 16:38:45,1291616704,47116,101,32,19,7,25
170681,2023-11-29 16:38:47,1291616731,47116,101,32,19,7,25
170683,2023-11-29 16:41:51,1291619036,98368,94,26,18,6,20
170687,2023-11-29 16:51:44,1291626450,0,2,17,8,0,17
170685,2023-11-29 16:51:49,1291626517,15605,27,20,11,4,16
170682,2023-11-29 16:53:54,1291628042,27898,24,12,11,1,11
170686,2023-11-29 16:54:17,1291628341,75361,131,36,17,6,30
170688,2023-11-29 16:54:21,1291628394,7736,50,71,26,4,67
170705,2023-11-29 18:40:26,1291710632,20555,36,39,25,2,37
170714,2023-11-29 18:40:34,1291710738,12133,129,28,14,5,23
170715,2023-11-29 18:40:59,1291711114,21313,123,44,25,4,40
97780,2023-11-29 18:53:12,1291721283,109326,131,45,26,7,38
170742,2023-11-29 19:21:09,1291743140,93294,299,52,32,12,40
170744,2023-11-29 19:50:58,1291767436,6586,113,8,2,2,6
151561,2023-12-06 17:27:57,1295892972,4524,76,18,10,4,14
151567,2023-12-06 17:28:24,1295893389,62312,155,91,69,7,84
151394,2023-12-06 17:28:53,1295893847,35857,100,63,49,6,57
171658,2023-12-06 17:46:04,1295909406,52,20,36,5,1,35
171661,2023-12-06 17:57:03,1295919691,8164,51,3,1,2,1
171662,2023-12-06 17:57:47,1295920409,118399,97,33,12,4,29
171664,2023-12-06 18:19:18,1295940937,30492,98,4,4,4,0
171665,2023-12-06 18:19:46,1295941272,12797,52,15,3,2,13
171668,2023-12-06 18:28:53,1295948662,0,5,33,8,0,33
171669,2023-12-06 18:44:26,1295963942,125781,235,46,17,12,34
159676,2023-12-06 18:57:15,1295976863,49388,136,59,39,6,53
161651,2023-12-06 18:57:44,1295977322,309,13,13,0,3,10
159951,2023-12-06 18:58:15,1295977805,56340,137,27,16,8,19
159870,2023-12-06 18:59:16,1295978783,11522,47,35,14,4,31
161270,2023-12-06 18:59:37,1295979108,31350,100,61,39,2,59
171656,2023-12-06 19:11:12,1295990637,54453,48,42,18,3,39
171671,2023-12-06 19:24:44,1296003280,31433,151,9,5,6,3
171672,2023-12-06 19:29:47,1296008276,38473,25,24,17,3,21
161087,2023-12-06 20:02:45,1296040285,0,0,6,3,0,6
149973,2023-12-06 20:02:47,1296040309,0,0,8,6,0,8
149935,2023-12-06 20:02:51,1296040354,2698,3,3,0,1,2
129849,2023-12-06 20:02:54,1296040409,7407,73,18,3,1,17
171675,2023-12-06 20:20:04,1296056114,0,0,3,2,0,3
171676,2023-12-06 20:21:58,1296057748,8284,36,19,9,4,15
171679,2023-12-06 20:52:55,1296085920,52204,77,24,11,4,20
105581,2023-12-06 21:56:24,1296140861,79304,29,12,9,2,10
105580,2023-12-06 21:56:50,1296141240,95006,74,22,18,6,16
171667,2023-12-06 22:00:20,1296144163,23519,63,46,28,4,42
171594,2023-12-06 22:05:31,1296148429,0,71,7,3,0,7
171705,2023-12-06 22:46:09,1296181143,9944,8,18,4,3,15
171699,2023-12-06 22:46:25,1296181381,56434,35,5,3,4,1
171697,2023-12-06 22:46:37,1296181525,71232,86,3,3,3,0
171698,2023-12-06 22:46:49,1296181672,68016,85,9,4,8,1
171696,2023-12-06 22:47:29,1296182212,64640,28,6,3,2,4
171702,2023-12-06 22:47:54,1296182502,40491,153,19,2,2,17
171716,2023-12-06 23:13:23,1296202420,812,12,6,3,2,4
171715,2023-12-06 23:14:16,1296203059,0,13,11,4,0,11
171725,2023-12-07 14:23:34,1296471492,20342,29,70,32,6,64
171720,2023-12-07 14:34:55,1296474293,22787,14,15,11,3,12
171733,2023-12-07 15:29:59,1296495982,0,0,1,0,0,1
171734,2023-12-07 15:35:07,1296498820,0,25,41,2,0,41
171718,2023-12-07 16:02:09,1296515150,2025,13,8,5,1,7
171748,2023-12-07 17:27:48,1296576182,102194,274,144,110,9,135
171749,2023-12-07 17:31:18,1296579055,130906,187,76,41,6,70
171750,2023-12-07 17:42:37,1296588236,57756,74,44,32,5,39
171751,2023-12-07 17:49:07,1296593617,29488,171,72,50,7,65
171753,2023-12-07 17:58:12,1296600959,6573,18,15,10,1,14
99357,2023-12-07 18:00:10,1296602504,16332,42,24,14,3,21
99344,2023-12-07 18:00:40,1296602915,4491,6,20,9,1,19
99358,2023-12-07 18:01:04,1296603222,0,1,32,5,0,32
99360,2023-12-07 18:01:32,1296603553,292,361,379,24,1,378
118904,2023-12-07 18:01:54,1296603864,0,35,6,0,0,6
99361,2023-12-07 18:02:16,1296604184,7866,27,14,7,3,11
99362,2023-12-07 18:02:46,1296604520,12940,11,3,3,1,2
171761,2023-12-07 18:15:43,1296614563,128372,87,74,54,5,69
171762,2023-12-07 18:23:28,1296620564,2174,110,10,2,4,6
171713,2023-12-07 18:25:38,1296621978,46864,184,24,17,4,20
150005,2023-12-07 18:26:26,1296622481,679,57,44,12,6,38
171714,2023-12-07 18:26:50,1296622747,119208,140,10,4,8,2
171765,2023-12-07 18:55:14,1296645365,43940,222,19,16,6,13
162625,2023-12-07 19:13:01,1296659613,97147,213,88,66,9,79
162589,2023-12-07 19:13:36,1296660086,8380,8,10,8,1,9
162554,2023-12-07 19:14:11,1296660563,15059,59,39,27,2,37
162619,2023-12-07 19:14:37,1296660864,85501,77,80,30,3,77
162623,2023-12-07 19:15:02,1296661223,0,0,10,7,0,10
162634,2023-12-07 19:15:26,1296661608,109568,160,46,37,4,42
162626,2023-12-07 19:16:02,1296662079,27691,30,43,34,4,39
171779,2023-12-07 19:52:44,1296691085,22542,21,8,7,2,6
171781,2023-12-07 19:53:21,1296691574,1802,7,44,18,2,42
171782,2023-12-07 19:53:38,1296691808,7574,22,16,9,3,13
171783,2023-12-07 20:07:29,1296702082,6564,71,4,2,1,3
171785,2023-12-07 20:21:24,1296710950,1180,78,29,11,1,28
171787,2023-12-07 20:23:28,1296712285,143179,86,44,37,4,40
131206,2023-12-07 20:43:33,1296733386,0,22,6,3,0,6
100108,2023-12-07 20:44:16,1296735239,1576,238,25,3,1,24
100246,2023-12-07 20:44:37,1296736126,27350,290,26,3,4,22
110337,2023-12-07 20:45:02,1296737169,1113,11,19,7,1,18
171788,2023-12-07 20:45:12,1296737606,1596,109,16,8,1,15
131192,2023-12-07 20:45:25,1296738185,8064,213,35,10,6,29
100096,2023-12-07 20:45:53,1296739378,0,5,32,25,0,32
171796,2023-12-07 21:07:52,1296797868,16133,26,19,13,1,18
171802,2023-12-07 21:26:29,1296846288,10371,30,10,4,2,8
171799,2023-12-07 21:41:52,1296885515,46938,88,7,5,5,2
171803,2023-12-07 21:52:31,1296913105,36137,27,25,0,7,18
171700,2023-12-07 22:04:46,1296944198,0,1,7,4,0,7
171800,2023-12-07 22:11:58,1296962372,101932,234,29,6,7,22
171797,2023-12-07 22:12:04,1296962720,181434,29,33,17,6,27
171777,2023-12-07 22:12:16,1296963151,169596,162,76,37,12,64
171807,2023-12-07 22:13:36,1296966509,24930,165,10,4,1,9
171806,2023-12-07 22:20:14,1296983610,175217,25,12,9,1,11
171811,2023-12-07 22:20:22,1296983969,25555,117,23,10,7,16
171804,2023-12-07 22:22:39,1296989692,34058,50,34,17,3,31
132021,2023-12-07 22:29:57,1297007302,73385,118,120,25,6,114
162648,2023-12-07 22:38:17,1297026586,0,3,38,35,0,38
162647,2023-12-07 22:38:50,1297027882,0,3,59,50,0,59
162624,2023-12-07 22:39:08,1297028563,5927,20,13,13,1,12
162646,2023-12-07 22:39:38,1297029715,0,64,34,30,0,34
162642,2023-12-07 22:40:04,1297030732,0,3,85,61,0,85
171819,2023-12-07 23:31:51,1297135022,11235,58,21,14,3,18
171832,2023-12-08 14:14:45,1297419322,40505,72,48,36,6,42
171833,2023-12-08 14:15:03,1297419494,1731,18,34,30,1,33
171818,2023-12-08 14:18:34,1297421135,1006,7,4,3,1,3
171834,2023-12-08 14:18:52,1297421229,0,0,7,2,0,7
171837,2023-12-08 14:26:43,1297424994,106,1,4,0,1,3
171836,2023-12-08 14:26:52,1297425073,0,0,3,0,0,3
171829,2023-12-08 14:27:05,1297425154,30030,50,43,24,4,39
171843,2023-12-08 15:25:31,1297458112,75661,62,21,3,7,14
171844,2023-12-08 15:37:25,1297464824,0,67,4,2,0,4
171845,2023-12-08 15:37:30,1297464881,15162,27,11,5,2,9
171846,2023-12-08 15:42:55,1297468107,11842,39,6,4,3,3
171849,2023-12-08 16:12:52,1297490482,98539,94,33,22,4,29
171848,2023-12-08 16:13:45,1297491164,88459,137,73,27,3,70
171847,2023-12-08 16:13:59,1297491338,145522,274,44,23,6,38
171850,2023-12-08 16:18:16,1297494618,86262,57,41,29,3,38
171886,2023-12-08 18:09:30,1297576822,26238,70,22,16,5,17
171891,2023-12-08 18:34:59,1297595542,21720,172,37,13,4,33
171893,2023-12-08 18:46:05,1297603813,26892,104,25,9,3,22
171894,2023-12-08 18:46:26,1297604048,0,0,20,3,0,20
171901,2023-12-08 19:21:48,1297629067,9461,153,29,2,2,27
171912,2023-12-08 20:07:42,1297661694,12930,73,35,22,4,31
171938,2023-12-08 21:09:21,1297703357,86273,295,39,13,7,32
163853,2023-12-08 21:10:55,1297704396,192327,419,78,44,15,63
163692,2023-12-08 21:11:23,1297704726,105896,111,81,50,9,72
171939,2023-12-08 21:11:47,1297704970,4361,56,137,45,1,136
171947,2023-12-08 22:18:52,1297747228,59549,105,88,61,7,81
161178,2023-12-08 22:46:03,1297763534,67542,128,58,33,7,51
161706,2023-12-08 22:46:40,1297763950,80327,34,92,26,1,91
162002,2023-12-08 22:47:15,1297764335,33170,63,49,17,7,42
162540,2023-12-08 22:48:17,1297764944,10788,13,14,8,2,12
160672,2023-12-08 22:48:33,1297765099,6392,9,11,5,3,8
130193,2023-12-08 23:33:13,1297789933,184691,149,78,44,10,68
130206,2023-12-08 23:33:33,1297790086,16621,56,42,8,3,39
130205,2023-12-08 23:33:51,1297790234,51495,86,36,15,6,30
130204,2023-12-08 23:34:14,1297790435,29537,161,35,16,7,28
130406,2023-12-08 23:34:35,1297790610,7492,142,32,14,2,30
151255,2023-12-08 23:34:53,1297790765,14960,17,3,2,1,2
171959,2023-12-09 14:24:53,1297968950,0,0,17,12,0,17
171883,2023-12-09 14:37:36,1297971368,67000,121,60,41,6,54
171885,2023-12-09 14:38:09,1297971486,8572,24,10,6,2,8
171887,2023-12-09 14:43:26,1297972483,139111,141,47,32,8,39
171966,2023-12-09 14:51:21,1297974017,11956,71,5,2,1,4
171704,2023-12-09 15:11:46,1297978654,9633,49,26,3,4,22
171695,2023-12-09 15:12:16,1297978785,40020,271,64,26,6,58
150944,2023-12-09 15:35:24,1297985840,2079,16,34,24,1,33
150921,2023-12-09 15:35:53,1297985989,862,272,42,19,3,39
150918,2023-12-09 15:37:00,1297986410,35270,44,55,32,3,52
150912,2023-12-09 15:37:22,1297986586,0,2,12,10,0,12
150905,2023-12-09 15:37:47,1297986752,47517,263,51,28,4,47
150901,2023-12-09 15:38:14,1297986945,7448,24,38,29,2,36
171967,2023-12-09 15:54:49,1297992960,7436,225,66,34,3,63
150118,2023-12-09 16:55:23,1298018022,5001,110,20,9,2,18
149778,2023-12-09 16:55:40,1298018142,521,4,27,22,1,26
149781,2023-12-09 16:56:25,1298018477,6219,8,22,17,3,19
160231,2023-12-09 16:56:44,1298018657,5444,117,9,4,1,8
171995,2023-12-09 17:34:21,1298036881,51160,189,47,23,11,36
171997,2023-12-09 18:12:11,1298057093,11235,59,21,14,3,18
171999,2023-12-11 16:22:24,1298822488,0,117,4,0,0,4
171964,2023-12-11 16:35:27,1298842569,508,31,23,8,3,20
172023,2023-12-11 16:38:54,1298848011,14348,34,63,2,2,61
137908,2023-12-11 16:41:58,1298852496,19954,101,7,3,3,4
147383,2023-12-11 16:42:17,1298852999,11102,17,6,4,2,4
137851,2023-12-11 16:43:10,1298854348,0,60,12,6,0,12
171853,2023-12-11 16:45:14,1298857296,10819,37,62,13,2,60
171882,2023-12-11 16:45:34,1298857724,27736,173,29,25,3,26
172026,2023-12-11 16:45:38,1298857816,0,34,8,2,0,8
171961,2023-12-11 16:54:43,1298871245,19415,39,10,2,2,8
172025,2023-12-11 16:56:04,1298873150,14906,166,78,52,7,71
172022,2023-12-11 17:07:15,1298891297,154475,268,49,26,14,35
172024,2023-12-11 17:07:24,1298891535,197410,77,24,8,6,18
172031,2023-12-11 17:07:40,1298891985,29248,179,27,9,5,22
172032,2023-12-11 17:12:15,1298897889,13022,86,31,6,5,26
172027,2023-12-11 17:48:43,1298927132,81368,137,53,32,10,43
172034,2023-12-11 17:49:57,1298928147,73714,34,24,10,2,22
153083,2023-12-11 18:07:20,1298942849,0,106,93,65,0,93
172036,2023-12-11 18:09:20,1298944705,150804,67,6,5,2,4
172039,2023-12-11 18:31:56,1298963966,67185,128,18,14,5,13
172041,2023-12-11 18:57:33,1298985381,3291,7,10,5,3,7
153055,2023-12-11 19:04:58,1298991738,50961,131,54,19,11,43
153066,2023-12-11 19:05:20,1298992058,351538,112,135,58,7,128
153090,2023-12-11 19:05:58,1298992551,28933,125,70,38,8,62
172042,2023-12-11 19:12:33,1298998157,2601,0,20,16,2,18
172043,2023-12-11 19:35:56,1299017795,71918,93,22,12,6,16
172047,2023-12-11 19:38:28,1299019833,0,0,12,12,0,12
172018,2023-12-11 19:39:01,1299020310,5570,76,56,32,2,54
172048,2023-12-11 19:39:17,1299020558,0,0,1,1,0,1
172045,2023-12-11 19:40:00,1299021114,29777,62,6,4,2,4
172050,2023-12-11 19:55:25,1299033504,6573,18,15,10,1,14
172054,2023-12-11 20:06:50,1299042731,125781,235,46,17,12,34
172029,2023-12-11 20:35:16,1299065268,0,0,17,12,0,17
172058,2023-12-11 20:37:26,1299067028,4820,9,3,1,1,2
172057,2023-12-11 20:40:30,1299069400,116669,285,63,36,12,51
172046,2023-12-11 20:45:41,1299073681,14091,95,19,12,6,13
132022,2023-12-11 21:02:13,1299087590,54108,67,77,29,3,74
132020,2023-12-11 21:03:54,1299089044,26397,150,57,28,11,46
132025,2023-12-11 21:04:32,1299089558,0,48,59,44,0,59
132024,2023-12-11 21:05:51,1299090504,42956,245,43,11,3,40
132106,2023-12-11 21:07:29,1299091852,15769,26,48,39,1,47
172066,2023-12-11 21:34:48,1299114676,14217,76,36,33,4,32
172063,2023-12-11 21:38:37,1299117999,2554,5,2,0,2,0
141782,2023-12-11 21:46:02,1299124232,56117,258,65,30,15,50
172069,2023-12-11 21:53:46,1299130679,7188,42,11,9,2,9
172071,2023-12-11 22:10:32,1299144357,128180,152,32,16,9,23
172090,2023-12-11 22:19:35,1299151868,10109,72,17,10,6,11
172093,2023-12-11 22:23:44,1299155243,0,0,7,2,0,7
107684,2023-12-11 22:41:43,1299169119,7733,32,21,14,4,17
107681,2023-12-11 22:43:17,1299170307,10534,54,76,51,4,72
140992,2023-12-11 22:43:47,1299170716,10527,24,9,5,4,5
107993,2023-12-11 22:43:50,1299170747,1367,63,7,5,1,6
151681,2023-12-11 22:44:24,1299171230,1209,33,13,9,1,12
109663,2023-12-11 22:45:03,1299171792,255,2,30,11,1,29
107683,2023-12-11 22:46:31,1299172832,17225,81,73,47,6,67
162480,2023-12-11 22:54:31,1299179103,12821,77,20,1,2,18
162489,2023-12-11 22:54:53,1299179362,78822,122,27,8,5,22
162487,2023-12-11 22:55:23,1299179779,82114,142,35,28,7,28
110949,2023-12-11 22:55:45,1299180051,24308,65,29,24,4,25
162696,2023-12-11 22:55:56,1299180184,62847,118,28,21,6,22
163381,2023-12-11 22:56:12,1299180371,28243,231,53,31,7,46
162488,2023-12-11 22:56:18,1299180448,45836,125,22,11,10,12
163354,2023-12-11 22:56:40,1299180709,78186,178,102,80,10,92
162490,2023-12-11 22:56:44,1299180786,26675,33,81,26,7,74
163362,2023-12-11 22:57:38,1299181497,42965,211,72,52,9,63
172079,2023-12-11 22:58:00,1299181777,30509,209,29,15,8,21
172110,2023-12-12 14:24:07,1299477081,25033,155,19,8,8,11
172107,2023-12-12 14:37:17,1299480209,49072,293,20,12,3,17
172108,2023-12-12 14:37:23,1299480230,0,0,16,7,0,16
162217,2023-12-12 15:11:21,1299489109,0,1,19,15,0,19
136448,2023-12-12 15:12:13,1299489395,24295,38,30,19,5,25
11429,2023-12-12 15:13:00,1299489625,4129,52,25,14,1,24
162222,2023-12-12 15:13:49,1299489875,0,134,65,29,0,65
172080,2023-12-12 15:21:14,1299492270,14537,52,6,4,2,4
172067,2023-12-12 15:32:36,1299496060,621,28,18,4,3,15
172113,2023-12-12 15:37:12,1299497828,0,0,10,6,0,10
172131,2023-12-12 16:19:50,1299516025,13863,28,11,2,2,9
172132,2023-12-12 16:20:18,1299516273,0,0,15,6,0,15
172141,2023-12-12 16:36:11,1299524099,29681,83,41,23,4,37
172055,2023-12-12 16:36:48,1299524344,152634,163,104,79,11,93
172056,2023-12-12 16:37:31,1299524719,38731,136,43,39,3,40
172059,2023-12-12 16:37:51,1299524894,23897,20,24,22,2,22
172060,2023-12-12 16:38:10,1299525063,748,3,13,9,1,12
172061,2023-12-12 16:38:37,1299525288,1658,42,44,35,2,42
172062,2023-12-12 16:39:05,1299525520,96337,90,43,30,9,34
172062,2023-12-12 16:39:09,1299525548,96337,90,43,30,9,34
148673,2023-12-12 16:51:25,1299531628,20641,17,7,2,3,4
172149,2023-12-12 17:11:57,1299542364,103391,183,88,65,4,84
172151,2023-12-12 17:23:46,1299548435,23999,11,3,1,2,1
172155,2023-12-12 17:41:56,1299558048,13128,75,29,18,6,23
172157,2023-12-12 17:51:47,1299563487,4361,56,137,45,1,136
172159,2023-12-12 17:58:56,1299567533,0,0,6,5,0,6
172158,2023-12-12 17:59:22,1299567815,20943,89,17,9,4,13
172163,2023-12-12 18:07:48,1299572697,6573,18,15,10,1,14
172165,2023-12-12 18:23:35,1299581942,65818,239,114,60,10,104
172164,2023-12-12 18:29:29,1299585435,26918,105,37,21,8,29
172194,2023-12-12 21:41:52,1299699310,21056,68,16,2,3,13
114817,2023-12-12 21:44:35,1299700801,0,306,51,0,0,51
96992,2023-12-12 21:45:36,1299701393,2398,49,11,4,2,9
96993,2023-12-12 21:46:03,1299701633,857,4,7,1,2,5
172211,2023-12-12 22:02:33,1299710977,10920,152,66,19,3,63
172169,2023-12-12 22:16:09,1299719063,184621,218,45,31,6,39
172246,2023-12-13 14:22:47,1299990799,13791,257,32,20,9,23
172276,2023-12-13 14:29:59,1299992924,148660,86,147,38,5,142
172263,2023-12-13 14:33:40,1299993945,19884,295,67,40,8,59
172244,2023-12-13 15:12:36,1300008230,29830,326,29,11,8,21
172241,2023-12-13 15:15:31,1300009672,14225,125,10,3,4,6
162772,2023-12-13 16:04:20,1300036710,1800,3,2,1,1,1
162774,2023-12-13 16:04:51,1300036966,13730,26,64,53,1,63
162886,2023-12-13 16:05:32,1300037392,3163,153,6,2,2,4
162863,2023-12-13 16:06:08,1300037771,6075,14,4,2,1,3
162857,2023-12-13 16:06:58,1300038275,51215,122,47,24,4,43
145971,2023-12-13 16:08:33,1300039216,10298,34,35,30,3,32
145967,2023-12-13 16:09:10,1300039603,151704,131,51,30,5,46
146117,2023-12-13 16:09:42,1300039889,11460,68,83,15,2,81
154983,2023-12-13 16:10:23,1300040362,6448,49,19,11,2,17
172284,2023-12-13 16:11:25,1300040940,40312,92,28,23,4,24
172286,2023-12-13 16:15:33,1300043615,1344,9,15,10,1,14
172285,2023-12-13 16:16:17,1300044077,67716,83,55,22,5,50
172274,2023-12-13 16:19:46,1300046445,0,6,14,11,0,14
172287,2023-12-13 16:20:05,1300046636,99754,294,20,8,10,10
172306,2023-12-13 17:16:11,1300087073,12036,192,79,20,2,77
130073,2023-12-13 17:21:02,1300090705,30239,18,304,37,5,299
159946,2023-12-13 17:21:30,1300091104,570,3,7,3,1,6
130033,2023-12-13 17:21:59,1300091475,26129,103,68,33,4,64
130030,2023-12-13 17:22:20,1300091777,27563,135,31,19,5,26
159941,2023-12-13 17:22:45,1300092081,28118,24,43,22,7,36
159949,2023-12-13 17:23:12,1300092406,22903,16,266,42,4,262
159943,2023-12-13 17:23:46,1300092773,18901,14,266,32,5,261
172310,2023-12-13 17:31:52,1300099239,1767,6,16,12,1,15
152819,2023-12-13 17:55:23,1300117316,5277,65,42,22,3,39
152620,2023-12-13 17:56:30,1300118103,388,0,33,10,1,32
152641,2023-12-13 17:56:49,1300118437,91463,269,29,11,14,15
153106,2023-12-13 17:57:16,1300118809,4571,4,2,1,1,1
172295,2023-12-13 18:00:08,1300121029,21420,10,26,13,1,25
172296,2023-12-13 18:03:08,1300123408,17389,18,31,16,1,30
172299,2023-12-13 18:05:38,1300125416,58185,321,92,55,13,79
172325,2023-12-13 18:43:56,1300156249,15318,15,2,0,2,0
8082,2023-12-13 19:21:00,1300186398,4905,37,55,16,2,53
21372,2023-12-13 19:21:23,1300186712,22823,50,111,32,3,108
130101,2023-12-13 19:37:14,1300199603,138687,112,105,45,15,90
172336,2023-12-13 20:04:56,1300222423,7701,37,118,58,2,116
172340,2023-12-13 20:29:11,1300242058,13213,49,12,8,3,9
172341,2023-12-13 20:29:26,1300242249,22657,212,21,6,10,11
172339,2023-12-13 20:33:45,1300246092,114979,299,123,47,10,113
172350,2023-12-13 20:42:08,1300253260,181434,29,33,17,6,27
102004,2023-12-13 21:59:44,1300315529,19244,55,57,26,8,49
172362,2023-12-13 22:46:58,1300349514,78233,52,67,20,10,57
172366,2023-12-13 22:50:50,1300352049,164827,166,96,31,12,84
172365,2023-12-13 22:51:16,1300352390,71855,22,41,21,3,38
172361,2023-12-13 22:51:31,1300352559,142382,90,56,42,7,49
172382,2023-12-13 23:03:56,1300360678,9244,122,68,50,2,66
172352,2023-12-13 23:09:33,1300364441,16570,211,57,36,1,56
132971,2023-12-13 23:53:20,1300392431,51103,247,98,39,10,88
132925,2023-12-13 23:54:22,1300393278,11573,113,55,13,3,52
132928,2023-12-13 23:55:03,1300393738,58360,249,84,54,4,80
142152,2023-12-13 23:55:24,1300393954,43666,16,48,14,7,41
172367,2023-12-14 14:17:41,1300655666,84323,210,46,25,12,34
114567,2023-12-14 14:44:21,1300664495,2006,21,31,10,1,30
161567,2023-12-14 14:44:45,1300664646,0,0,6,1,0,6
161590,2023-12-14 14:44:57,1300664717,69782,39,23,14,2,21
143582,2023-12-14 15:19:39,1300680390,473,3,16,8,1,15
143575,2023-12-14 15:20:10,1300680638,304653,22,42,8,3,39
143495,2023-12-14 15:20:44,1300680971,23465,124,82,31,10,72
143591,2023-12-14 15:22:18,1300681819,123590,297,67,20,18,49
143597,2023-12-14 15:23:08,1300682361,15952,24,15,3,2,13
143657,2023-12-14 15:23:38,1300682616,17775,67,52,11,5,47
164118,2023-12-14 15:24:03,1300682835,62344,163,67,11,9,58
163615,2023-12-14 15:45:13,1300695527,177912,24,78,30,2,76
172391,2023-12-14 16:54:42,1300744326,177860,367,100,13,5,95
152117,2023-12-14 16:55:19,1300744810,24613,38,112,87,4,108
172416,2023-12-14 16:55:42,1300745141,0,1,30,16,0,30
172422,2023-12-14 17:00:06,1300748721,116471,191,13,6,9,4
172426,2023-12-14 17:13:15,1300759047,4033,189,60,38,7,53
172424,2023-12-14 17:13:46,1300759462,23519,63,46,28,4,42
172420,2023-12-14 17:37:49,1300778429,84816,47,33,21,3,30
172428,2023-12-14 17:38:01,1300778612,33132,182,50,9,5,45
172429,2023-12-14 17:38:24,1300778932,51759,48,10,7,3,7
172431,2023-12-14 18:00:01,1300797074,0,0,18,2,0,18
172432,2023-12-14 18:09:47,1300805265,31642,41,5,1,4,1
172383,2023-12-14 18:20:13,1300813999,493,3,4,2,1,3
172436,2023-12-14 19:08:27,1300856395,15156,106,20,14,5,15
172438,2023-12-14 19:33:55,1300878517,231693,107,66,45,3,63
172433,2023-12-14 19:54:00,1300895638,154475,268,49,27,14,35
172441,2023-12-14 20:32:51,1300926994,90917,141,39,26,11,28
172453,2023-12-14 20:49:01,1300939129,18030,50,11,5,3,8
132929,2023-12-14 21:02:16,1300950414,30970,154,45,12,15,30
164119,2023-12-14 21:08:01,1300955107,16911,33,14,7,3,11
164453,2023-12-14 21:08:58,1300955838,915,17,56,6,2,54
164540,2023-12-14 21:09:32,1300956286,0,9,103,73,0,103
172455,2023-12-14 21:09:48,1300956546,113491,104,110,53,7,103
172468,2023-12-14 21:36:28,1300977511,42406,190,24,8,9,15
172458,2023-12-14 21:49:08,1300987340,47531,25,69,40,9,60
172470,2023-12-14 21:49:13,1300987427,131035,95,64,44,9,55
172459,2023-12-14 22:00:43,1300996117,116986,156,126,72,9,117
172471,2023-12-14 22:01:24,1300996646,26703,98,69,38,9,60
172472,2023-12-14 22:02:18,1300997345,47838,203,39,25,11,28
172481,2023-12-14 22:09:43,1301002938,0,0,2,1,0,2
172482,2023-12-14 22:11:05,1301004043,45488,234,18,10,3,15
172484,2023-12-14 22:27:12,1301016208,157449,110,30,21,6,24
172483,2023-12-14 22:35:30,1301022011,23285,162,32,21,8,24
172480,2023-12-14 23:03:35,1301040312,4900,8,67,8,1,66
172486,2023-12-15 14:38:00,1301276998,10283,154,58,39,1,57
172491,2023-12-15 14:49:20,1301281738,242427,251,55,35,10,45
172495,2023-12-15 14:53:51,1301283776,117032,66,70,12,4,66
172500,2023-12-15 14:59:37,1301286707,56586,99,25,16,3,22
172452,2023-12-15 15:02:32,1301287511,84378,97,37,29,2,35
172485,2023-12-15 15:28:44,1301299922,14700,71,26,10,4,22
172512,2023-12-15 16:08:47,1301327770,250857,124,52,37,5,47
172518,2023-12-15 16:32:08,1301347016,6714,5,7,4,1,6
172519,2023-12-15 17:16:20,1301382388,41126,19,9,5,2,7
172530,2023-12-15 17:18:38,1301384249,47531,25,69,40,9,60
172544,2023-12-15 18:39:51,1301450851,23083,46,41,18,2,39
172545,2023-12-15 19:04:40,1301471949,91522,63,30,13,6,24
172527,2023-12-15 19:05:42,1301472774,92718,56,15,3,2,13
172556,2023-12-15 19:33:55,1301496409,83451,76,25,14,6,19
172560,2023-12-15 19:34:08,1301496614,7900,48,26,11,1,25
172562,2023-12-15 19:34:18,1301496755,26065,55,23,17,4,19
172563,2023-12-15 19:34:29,1301496899,4645,4,4,0,1,3
172572,2023-12-15 19:54:56,1301513724,44141,132,25,13,6,19
172573,2023-12-15 20:40:43,1301550008,112322,142,23,15,6,17
172576,2023-12-15 20:42:34,1301551530,7836,204,25,20,1,24
116851,2023-12-15 20:51:20,1301558488,78827,116,40,17,4,36
172582,2023-12-15 21:21:39,1301582139,888,30,18,4,3,15
153564,2023-12-15 21:31:43,1301589865,11138,13,9,7,2,7
153431,2023-12-15 21:32:07,1301590197,0,0,5,2,0,5
153323,2023-12-15 21:32:26,1301590422,14246,17,9,8,2,7
153565,2023-12-15 21:32:52,1301590694,2655,4,18,5,1,17
153320,2023-12-15 21:33:12,1301590979,34229,176,110,77,8,102
172586,2023-12-15 21:46:56,1301601644,56191,165,29,19,8,21
172587,2023-12-15 21:49:35,1301603713,0,0,6,6,0,6
172288,2023-12-15 22:33:55,1301636633,22154,32,25,2,2,23
172288,2023-12-15 22:33:58,1301636680,22154,32,25,2,2,23
172611,2023-12-16 14:22:46,1301908021,2722,55,7,2,1,6
172614,2023-12-16 14:23:13,1301908221,13109,62,57,28,4,53
172612,2023-12-16 14:49:24,1301919801,10135,28,12,11,1,11
172613,2023-12-16 14:49:46,1301919957,6023,66,38,24,4,34
172619,2023-12-16 14:50:18,1301920234,4461,109,43,31,3,40
172621,2023-12-16 14:50:37,1301920403,0,7,12,8,0,12
172603,2023-12-16 15:20:16,1301937132,5800,25,81,36,3,78
172593,2023-12-16 15:24:17,1301939662,63780,139,27,14,6,21
172594,2023-12-16 15:27:48,1301941515,0,13,11,4,0,11
172595,2023-12-16 15:29:26,1301942593,86843,45,64,32,5,59
172607,2023-12-16 15:30:49,1301943542,1006,7,4,3,1,3
172589,2023-12-16 15:46:40,1301953924,0,7,51,13,0,51
172590,2023-12-16 15:47:12,1301954332,155188,156,50,35,10,40
172610,2023-12-16 17:49:12,1302043393,39973,47,9,4,2,7
140815,2023-12-16 18:26:58,1302074939,6893,17,11,6,1,10
162019,2023-12-16 18:27:44,1302075558,0,28,18,8,0,18
153038,2023-12-16 18:27:49,1302075620,0,0,12,5,0,12
161301,2023-12-16 18:28:13,1302075987,14248,79,80,33,1,79
119486,2023-12-16 18:28:25,1302076195,50946,32,17,9,4,13
162017,2023-12-16 18:28:41,1302076439,12890,17,8,2,6,2
152826,2023-12-16 18:28:47,1302076512,8208,29,17,10,1,16
162021,2023-12-16 18:28:58,1302076662,10800,42,12,4,1,11
162022,2023-12-16 18:29:18,1302076959,0,3,22,18,0,22
119521,2023-12-16 18:30:26,1302077834,95111,154,35,17,6,29
172685,2023-12-18 14:22:37,1302839442,246079,209,75,24,19,56
172706,2023-12-18 14:59:18,1302850704,15974,80,7,2,6,1
109981,2023-12-18 15:19:17,1302858516,0,0,16,6,0,16
142828,2023-12-18 15:20:10,1302858907,1435,22,25,12,2,23
110507,2023-12-18 15:20:37,1302859113,130060,80,34,15,4,30
109983,2023-12-18 15:21:05,1302859349,34457,138,23,16,7,16
172716,2023-12-18 15:31:59,1302864648,46234,48,19,8,4,15
172723,2023-12-18 15:32:18,1302864834,2863,1,19,15,1,18
152602,2023-12-18 15:37:45,1302867768,53679,98,36,19,10,26
153040,2023-12-18 15:38:10,1302867999,6533,88,15,9,3,12
152605,2023-12-18 15:38:37,1302868172,7492,146,24,8,2,22
152605,2023-12-18 15:38:45,1302868268,7492,150,36,17,2,34
152598,2023-12-18 15:38:56,1302868383,5567,17,12,8,3,9
152716,2023-12-18 15:39:31,1302868693,9333,65,17,14,1,16
172678,2023-12-18 15:54:38,1302877289,81784,77,16,8,3,13
172681,2023-12-18 15:54:39,1302877290,46543,11,25,6,2,23
172745,2023-12-18 18:48:23,1302999324,278465,415,160,45,30,130
172756,2023-12-18 19:11:05,1303016632,14760,205,16,5,3,13
172758,2023-12-18 19:27:25,1303029264,0,0,20,18,0,20
172762,2023-12-18 19:34:48,1303035084,42883,190,13,8,6,7
172732,2023-12-18 19:47:31,1303044990,0,1,80,31,0,80
144082,2023-12-18 19:48:42,1303045844,92295,113,130,59,16,114
172757,2023-12-18 19:57:07,1303052220,378,2,11,1,1,10
172761,2023-12-18 19:57:28,1303052488,0,12,12,4,0,12
172776,2023-12-18 19:57:51,1303052737,136497,217,44,24,12,32
172770,2023-12-18 20:01:11,1303055433,4270,13,8,4,1,7
172778,2023-12-18 20:01:39,1303055816,0,18,2,1,0,2
101448,2023-12-18 20:02:05,1303055870,47745,231,105,38,8,97
120732,2023-12-18 20:10:18,1303062905,25653,36,38,7,10,28
101450,2023-12-18 20:17:57,1303068923,23829,30,83,30,3,80
101453,2023-12-18 20:30:24,1303079114,1078,14,4,0,1,3
172782,2023-12-18 20:34:08,1303082098,0,0,10,2,0,10
172798,2023-12-18 20:50:46,1303095742,25681,70,15,9,4,11
172759,2023-12-18 20:56:28,1303100306,2197,12,4,0,1,3
172803,2023-12-18 21:06:04,1303107962,37387,48,38,4,2,36
172805,2023-12-18 21:15:01,1303114731,11225,78,42,35,2,40
172805,2023-12-18 21:15:17,1303114942,11225,78,42,35,2,40
172784,2023-12-18 21:45:41,1303139031,271,16,53,29,1,52
172807,2023-12-18 21:48:39,1303141348,25686,117,31,2,2,29
172807,2023-12-18 21:48:42,1303141374,25686,117,31,2,2,29
153328,2023-12-18 22:00:54,1303149915,44112,35,40,23,1,39
153014,2023-12-18 22:02:38,1303151255,0,48,47,26,0,47
153019,2023-12-18 22:03:17,1303151718,6206,33,5,1,2,3
153016,2023-12-18 22:04:09,1303152459,15204,48,32,18,2,30
153034,2023-12-18 22:04:35,1303152808,0,0,45,30,0,45
153433,2023-12-18 22:05:02,1303153135,0,0,2,0,0,2
164614,2023-12-18 22:05:45,1303153638,36527,600,106,40,6,100
164572,2023-12-18 22:06:46,1303154382,50335,209,50,31,5,45
164571,2023-12-18 22:07:49,1303155228,48379,87,29,14,8,21
164567,2023-12-18 22:08:29,1303155750,744,165,45,24,2,43
164573,2023-12-18 22:09:02,1303156173,0,0,7,4,0,7
172777,2023-12-18 22:46:35,1303183945,0,0,12,7,0,12
172816,2023-12-18 22:54:26,1303189511,60042,62,46,23,4,42
172818,2023-12-18 22:54:39,1303189662,58112,74,20,11,8,12
151837,2023-12-18 23:02:00,1303194802,58341,135,113,62,12,101
172820,2023-12-18 23:03:08,1303195588,433878,548,81,43,22,59
98569,2023-12-18 23:03:44,1303195966,0,7,31,19,0,31
99039,2023-12-18 23:04:35,1303196536,17761,201,28,23,4,24
162645,2023-12-18 23:05:09,1303196948,7449,21,7,4,2,5
172821,2023-12-18 23:05:51,1303197420,0,8,3,0,0,3
172822,2023-12-18 23:08:30,1303199301,16301,40,76,57,5,71
172833,2023-12-18 23:58:12,1303233934,23535,68,47,13,6,41
172834,2023-12-18 23:58:32,1303234147,0,1,7,3,0,7
172838,2023-12-18 23:58:51,1303234359,23519,63,46,28,4,42
172839,2023-12-18 23:59:25,1303234723,0,0,10,6,0,10
172840,2023-12-18 23:59:44,1303234885,15796,68,27,9,4,23
172873,2023-12-19 17:12:37,1303756735,31368,183,108,26,7,101
172876,2023-12-19 17:31:17,1303770418,24128,85,114,71,3,111
132444,2023-12-19 17:41:52,1303778635,0,0,35,21,0,35
172893,2023-12-19 18:52:05,1303837693,59856,263,144,87,4,140
172844,2023-12-19 19:10:40,1303854314,19993,29,7,5,2,5
172849,2023-12-19 19:11:04,1303854612,149711,219,116,12,21,95
172849,2023-12-19 19:11:05,1303854636,149711,219,116,12,21,95
172862,2023-12-19 19:11:26,1303854969,33850,149,32,17,9,23
172874,2023-12-19 19:11:45,1303855224,21980,56,23,9,4,19
172842,2023-12-19 19:23:19,1303865350,39784,94,12,6,3,9
172875,2023-12-19 19:23:43,1303865687,45895,56,85,34,9,76
172877,2023-12-19 19:23:56,1303865872,0,6,45,10,0,45
172878,2023-12-19 19:24:06,1303866024,190704,69,119,62,5,114
162679,2023-12-19 19:37:41,1303878442,0,0,5,0,0,5
141609,2023-12-19 19:38:09,1303878863,1789,13,58,35,1,57
132446,2023-12-19 19:38:28,1303879118,45401,46,83,48,3,80
132452,2023-12-19 19:38:51,1303879444,47516,264,113,44,14,99
172691,2023-12-19 19:53:52,1303892984,0,0,3,3,0,3
172895,2023-12-19 19:56:55,1303895597,17556,24,11,3,1,10
142329,2023-12-19 19:57:43,1303896372,27043,39,25,21,5,20
142898,2023-12-19 19:58:10,1303896777,1194,6,10,3,1,9
142896,2023-12-19 19:58:40,1303897200,22636,44,31,21,5,26
142894,2023-12-19 19:59:10,1303897678,39506,113,22,14,6,16
172735,2023-12-19 19:59:22,1303897838,31834,11,21,14,1,20
142945,2023-12-19 19:59:43,1303898108,1194,5,2,0,1,1
143576,2023-12-19 21:14:35,1303960855,0,29,31,1,0,31
172942,2023-12-19 21:15:30,1303961631,15156,106,20,14,5,15
172944,2023-12-19 21:33:04,1303976090,6865,13,8,8,2,6
172954,2023-12-19 21:33:29,1303976456,24632,86,13,10,4,9
172956,2023-12-19 21:39:59,1303981765,0,0,22,2,0,22
172957,2023-12-19 21:40:43,1303982298,4905,37,55,16,2,53
172945,2023-12-19 21:42:46,1303983964,60484,33,29,17,3,26
172958,2023-12-19 21:49:31,1303989436,28774,49,21,7,3,18
172962,2023-12-19 22:24:19,1304017564,13128,75,29,18,6,23
172963,2023-12-19 22:24:33,1304017718,29681,83,41,23,4,37
134172,2023-12-19 22:44:32,1304033927,4425,20,76,36,1,75
134085,2023-12-19 22:44:34,1304033950,36698,64,24,18,4,20
134086,2023-12-19 22:44:36,1304033980,301,170,90,44,1,89
134083,2023-12-19 22:44:38,1304034013,10515,38,56,44,3,53
134089,2023-12-19 22:44:41,1304034053,0,20,29,23,0,29
172965,2023-12-20 14:40:20,1304527129,54648,57,31,21,6,25
172981,2023-12-20 14:40:37,1304527224,43077,58,33,7,3,30
173010,2023-12-20 15:16:07,1304540849,101878,162,15,7,5,10
173003,2023-12-20 15:17:39,1304541547,153031,92,31,13,7,24
173003,2023-12-20 15:17:43,1304541578,153031,92,31,13,7,24
172997,2023-12-20 15:26:35,1304545902,6592,23,5,2,2,3
139876,2023-12-20 15:38:52,1304552496,13621,25,7,5,1,6
139882,2023-12-20 15:46:43,1304557154,8738,16,21,18,2,19
139880,2023-12-20 15:47:11,1304557462,123483,237,55,33,5,50
139879,2023-12-20 15:47:38,1304557722,49841,35,35,22,4,31
140334,2023-12-20 15:49:05,1304558580,0,1,20,8,0,20
172754,2023-12-20 16:12:46,1304573906,0,0,26,8,0,26
172966,2023-12-20 16:13:28,1304574386,0,7,13,9,0,13
173016,2023-12-20 16:43:00,1304596925,265,3,22,11,1,21
99026,2023-12-20 16:45:31,1304598836,0,8,50,23,0,50
173015,2023-12-20 17:43:41,1304652169,21933,60,41,28,6,35
173018,2023-12-20 17:45:28,1304653736,0,0,7,7,0,7
173030,2023-12-20 17:46:44,1304654990,0,1,9,2,0,9
173033,2023-12-20 17:48:35,1304656768,502,7,1,0,1,0
172819,2023-12-20 19:24:15,1304746987,4586,23,51,31,4,47
173059,2023-12-20 19:48:49,1304772829,38328,33,12,9,3,9
173037,2023-12-20 20:23:44,1304801919,10312,6,3,3,1,2
173075,2023-12-20 20:32:19,1304808530,43302,150,16,11,6,10
142478,2023-12-20 20:43:12,1304816888,1649,50,17,9,1,16
142480,2023-12-20 20:43:34,1304817153,2400,3,6,4,1,5
142481,2023-12-20 20:43:56,1304817442,128700,316,58,40,12,46
142471,2023-12-20 20:44:20,1304817717,3483,6,38,12,1,37
142484,2023-12-20 20:44:38,1304817948,85929,177,199,74,6,193
173074,2023-12-20 21:25:48,1304849010,46295,224,75,50,5,70
173080,2023-12-20 21:35:27,1304856606,106239,42,20,7,2,18
163489,2023-12-20 21:44:37,1304863886,21586,18,35,14,5,30
163488,2023-12-20 21:50:10,1304868500,4159,13,38,13,3,35
164175,2023-12-20 21:50:36,1304868864,9289,32,39,29,1,38
163486,2023-12-20 21:50:53,1304869080,504,2,10,3,1,9
173091,2023-12-20 22:16:23,1304888588,72465,370,34,16,13,21
173099,2023-12-20 22:24:43,1304894856,92763,63,36,17,9,27
173099,2023-12-20 22:24:45,1304894894,92763,63,36,17,9,27
123634,2023-12-20 22:57:41,1304919783,27854,137,23,16,3,20
123916,2023-12-20 22:58:10,1304920142,10668,64,40,35,3,37
123639,2023-12-20 22:58:53,1304920656,17313,86,46,25,6,40
124208,2023-12-20 22:59:15,1304920954,10158,86,32,13,4,28
123917,2023-12-20 22:59:51,1304921358,34384,81,21,12,2,19
151750,2023-12-20 23:00:37,1304922002,1154,25,36,29,1,35
173108,2023-12-21 14:38:39,1305177488,72163,155,32,18,3,29
87007,2023-12-21 15:42:13,1305204352,5739,24,34,24,1,33
87006,2023-12-21 15:42:41,1305204626,30724,91,66,54,5,61
86322,2023-12-21 15:43:38,1305205148,0,0,32,27,0,32
100394,2023-12-21 15:44:29,1305205672,20602,177,53,38,4,49
173076,2023-12-21 15:50:10,1305208936,206871,172,65,28,10,55
173131,2023-12-21 15:50:19,1305209026,81401,73,36,27,5,31
173112,2023-12-21 15:51:00,1305209433,14228,178,19,11,5,14
93156,2023-12-21 16:11:42,1305221751,20791,291,124,41,9,115
173146,2023-12-21 16:36:51,1305238282,6923,52,71,43,5,66
173147,2023-12-21 16:54:01,1305250018,0,0,19,9,0,19
173147,2023-12-21 16:54:07,1305250120,0,0,19,9,0,19
97678,2023-12-21 16:57:41,1305252800,4436,48,125,99,4,121
173149,2023-12-21 17:01:23,1305255562,9633,51,26,3,4,22
173150,2023-12-21 17:05:08,1305258207,35267,58,18,3,6,12
173153,2023-12-21 17:21:52,1305269954,23533,55,19,8,6,13
142164,2023-12-21 17:22:27,1305270365,14602,23,37,28,3,34
142213,2023-12-21 17:23:06,1305270857,53827,119,73,36,3,70
142212,2023-12-21 17:23:38,1305271229,65337,145,61,47,6,55
142085,2023-12-21 17:24:03,1305271503,41088,64,75,45,2,73
142184,2023-12-21 17:24:35,1305271932,2664,169,28,16,3,25
142186,2023-12-21 17:25:03,1305272285,13601,55,26,12,2,24
173152,2023-12-21 17:43:03,1305285978,111169,102,47,24,6,41
173148,2023-12-21 17:44:14,1305286904,22248,36,52,15,5,47
173157,2023-12-21 17:54:08,1305294267,9558,40,65,53,2,63
173158,2023-12-21 17:59:07,1305297829,734,10,75,60,2,73
173161,2023-12-21 18:06:31,1305303277,10515,11,24,16,1,23
173160,2023-12-21 18:06:49,1305303522,5662,31,59,38,1,58
173163,2023-12-21 18:19:49,1305313473,51625,245,41,16,4,37
173164,2023-12-21 18:42:10,1305330833,123,188,25,9,1,24
173162,2023-12-21 18:53:43,1305339955,1801,12,70,31,3,67
142578,2023-12-21 18:57:33,1305342755,12451,150,98,64,6,92
142864,2023-12-21 18:58:00,1305343116,3169,10,67,35,1,66
143200,2023-12-21 18:58:18,1305343414,0,0,22,12,0,22
143205,2023-12-21 18:58:43,1305343729,0,0,10,7,0,10
142550,2023-12-21 18:59:01,1305343957,16005,59,18,10,2,16
142587,2023-12-21 18:59:23,1305344269,42415,115,115,64,12,103
142546,2023-12-21 18:59:40,1305344507,17019,43,64,45,2,62
173173,2023-12-21 19:25:09,1305364292,32452,35,9,7,2,7
173175,2023-12-21 19:31:32,1305369084,9470,51,64,47,3,61
173176,2023-12-21 19:36:23,1305372684,16431,23,41,32,4,37
173177,2023-12-21 20:31:30,1305413394,43966,25,62,51,2,60
173178,2023-12-21 20:31:39,1305413518,208318,234,104,34,16,88
173179,2023-12-21 20:31:46,1305413622,6085,133,81,36,2,79
173181,2023-12-21 20:31:53,1305413701,918,8,14,10,1,13
173197,2023-12-21 20:32:02,1305413813,128713,181,90,41,5,85
173200,2023-12-21 20:38:17,1305418371,31599,320,18,12,7,11
173199,2023-12-21 20:46:37,1305424238,56448,148,53,31,7,46
173249,2023-12-21 22:14:05,1305485885,43311,861,64,7,32,32
173430,2023-12-26 16:42:05,1308005818,56790,122,85,30,7,78
173435,2023-12-26 17:17:04,1308028530,0,0,3,1,0,3
173393,2023-12-26 17:20:52,1308031158,43714,187,44,26,8,36
173398,2023-12-26 17:20:59,1308031234,0,2,44,29,0,44
173399,2023-12-26 17:21:06,1308031340,8814,86,2,1,1,1
162432,2023-12-26 18:08:10,1308064976,20122,153,70,31,6,64
162530,2023-12-26 18:08:44,1308065346,17047,46,42,30,3,39
163094,2023-12-26 18:09:07,1308065694,2406,40,15,0,2,13
173440,2023-12-26 18:16:56,1308071589,0,0,19,9,0,19
111285,2023-12-26 18:21:04,1308074733,0,7,6,5,0,6
111285,2023-12-26 18:21:07,1308074772,0,7,6,5,0,6
111165,2023-12-26 18:22:54,1308076177,0,11,7,6,0,7
111159,2023-12-26 18:24:57,1308077688,1225,206,16,6,1,15
111159,2023-12-26 18:25:01,1308077736,1225,206,16,6,1,15
121000,2023-12-26 18:25:43,1308078293,22837,159,18,8,3,15
121000,2023-12-26 18:25:45,1308078317,22837,159,18,8,3,15
134556,2023-12-26 18:27:37,1308079859,2671,113,39,12,1,38
134556,2023-12-26 18:27:40,1308079904,2671,113,39,12,1,38
143666,2023-12-26 18:30:40,1308082261,5203,40,11,8,2,9
143666,2023-12-26 18:30:43,1308082310,5203,40,11,8,2,9
153855,2023-12-26 18:31:32,1308082920,13254,24,3,2,1,2
173448,2023-12-26 18:39:13,1308088900,69853,111,45,24,6,39
173450,2023-12-26 18:39:28,1308089104,10934,24,5,3,1,4
53826,2023-12-26 19:08:23,1308112838,11629,136,22,9,3,19
173456,2023-12-26 19:12:14,1308115870,0,68,46,12,0,46
173463,2023-12-26 19:43:54,1308141727,40812,191,58,45,6,52
173477,2023-12-26 20:51:46,1308200768,65906,112,75,53,9,66
149215,2023-12-26 21:55:13,1308254794,39059,71,79,54,3,76
149189,2023-12-26 21:55:27,1308255026,9957,61,39,31,2,37
149200,2023-12-26 21:55:46,1308255301,0,2,25,21,0,25
150103,2023-12-26 21:56:06,1308255558,6254,87,25,18,1,24
149186,2023-12-26 21:56:29,1308255880,18700,57,13,5,3,10
173486,2023-12-26 21:56:48,1308256128,647389,198,38,13,6,32
163821,2023-12-26 22:01:09,1308259736,34054,99,23,13,2,21
163827,2023-12-26 22:01:37,1308260078,1368,83,16,8,1,15
163822,2023-12-26 22:02:39,1308260909,0,19,38,32,0,38
164040,2023-12-26 22:03:27,1308261640,758,8,27,25,1,26
163816,2023-12-26 22:04:14,1308262413,56821,115,41,15,6,35
163817,2023-12-26 22:04:40,1308262857,0,65,26,15,0,26
163967,2023-12-26 22:05:06,1308263187,8292,43,20,9,2,18
173487,2023-12-26 22:08:37,1308266268,13256,25,8,7,1,7
173481,2023-12-26 22:11:19,1308268461,14263,133,39,14,4,35
142759,2023-12-26 22:38:18,1308290191,33977,137,53,34,5,48
173542,2023-12-27 17:52:00,1308811377,0,47,8,2,0,8
153765,2023-12-27 17:53:13,1308812408,15225,49,14,4,4,10
173561,2023-12-27 18:39:57,1308855778,19991,7,91,47,1,90
173449,2023-12-27 19:59:24,1308927812,11629,136,22,9,3,19
173596,2023-12-27 21:11:55,1308990277,0,1,16,14,0,16
173597,2023-12-27 21:15:22,1308993362,101118,41,45,34,2,43
114566,2023-12-27 21:37:01,1309011855,8757,123,43,19,2,41
114564,2023-12-27 21:37:14,1309012079,0,7,20,9,0,20
114568,2023-12-27 21:38:03,1309012752,600,260,31,9,2,29
115084,2023-12-27 21:38:31,1309013146,846,44,22,11,2,20
136857,2023-12-27 21:39:06,1309013681,5969,24,23,16,3,20
146323,2023-12-27 21:39:43,1309014182,21839,25,15,2,1,14
173605,2023-12-27 21:49:10,1309022110,5157,40,35,28,2,33
173607,2023-12-27 21:56:27,1309027895,0,1,16,7,0,16
173604,2023-12-27 22:25:33,1309050886,81401,73,36,27,5,31
173604,2023-12-27 22:25:36,1309050918,81401,73,36,27,5,31
173603,2023-12-27 22:47:30,1309067921,0,2,26,18,0,26
173613,2023-12-27 22:47:57,1309068222,9864,29,10,4,2,8
173614,2023-12-27 22:48:15,1309068489,29533,39,32,23,3,29
173585,2023-12-27 22:48:21,1309068556,265986,191,59,37,9,50
173591,2023-12-27 22:48:30,1309068673,751,2,30,10,1,29
173593,2023-12-27 22:48:44,1309068851,0,1,13,7,0,13
173599,2023-12-27 22:48:53,1309068937,18280,161,28,1,11,17
173615,2023-12-27 22:49:31,1309069408,110997,48,4,2,2,2
173616,2023-12-27 22:49:52,1309069666,9588,43,12,2,5,7
173617,2023-12-27 22:50:18,1309070013,70844,118,46,27,5,41
173620,2023-12-27 23:24:50,1309095750,17643,103,13,6,6,7
173608,2023-12-28 00:19:06,1309134760,60484,33,29,18,3,26
173610,2023-12-28 00:19:34,1309135035,129833,133,61,43,11,50
173622,2023-12-28 00:19:57,1309135309,14760,206,16,5,3,13
173629,2023-12-28 00:20:22,1309135591,4270,13,9,5,1,8
173630,2023-12-28 00:20:46,1309135840,0,0,22,2,0,22
173631,2023-12-28 00:21:04,1309136008,0,18,3,2,0,3
173618,2023-12-28 00:21:19,1309136167,102718,94,65,49,4,61
173627,2023-12-28 00:21:34,1309136344,166311,125,73,46,7,66
173653,2023-12-28 14:47:11,1309593833,0,1,11,8,0,11
173657,2023-12-28 14:47:27,1309593914,0,0,5,3,0,5
173606,2023-12-28 14:52:54,1309595878,89799,110,51,21,4,47
173664,2023-12-28 15:19:12,1309605954,67333,208,49,19,6,43
173664,2023-12-28 15:19:14,1309605984,67333,208,49,19,6,43
173665,2023-12-28 15:20:33,1309606546,39674,85,12,3,5,7
157677,2023-12-28 15:30:18,1309611339,39398,229,137,75,8,129
157679,2023-12-28 15:30:42,1309611508,32196,117,59,42,3,56
173668,2023-12-28 15:47:00,1309619949,0,1,18,16,0,18
60157,2023-12-28 15:54:25,1309624129,77775,388,110,49,15,95
173669,2023-12-28 15:54:29,1309624177,18609,203,22,11,8,14
173670,2023-12-28 16:00:14,1309627654,71458,156,37,28,4,33
173671,2023-12-28 16:07:57,1309632255,12399,24,6,3,1,5
173674,2023-12-28 16:15:36,1309636940,65455,287,35,3,7,28
173679,2023-12-28 16:47:28,1309658066,38421,5,19,13,2,17
173675,2023-12-28 16:47:59,1309658995,43065,483,98,57,6,92
173677,2023-12-28 16:48:02,1309659116,6976,12,28,19,2,26
173680,2023-12-28 16:48:09,1309659364,29117,54,27,14,5,22
173683,2023-12-28 17:33:06,1309703323,2224,19,45,30,3,42
173684,2023-12-28 17:33:19,1309703536,1735,23,37,25,1,36
173685,2023-12-28 17:33:31,1309703680,1937,12,14,12,1,13
173686,2023-12-28 17:33:40,1309703820,71800,91,45,21,7,38
173687,2023-12-28 17:33:57,1309704111,13652,47,32,18,3,29
173688,2023-12-28 17:34:07,1309704263,0,3,12,9,0,12
173703,2023-12-28 18:14:09,1309744327,13104,9,19,8,2,17
173703,2023-12-28 18:14:14,1309744402,13104,9,19,8,2,17
173704,2023-12-28 18:14:25,1309744593,0,5,13,9,0,13
173706,2023-12-28 18:14:35,1309744746,230486,60,22,5,4,18
145672,2023-12-28 18:19:51,1309750945,0,0,1,0,0,1
173708,2023-12-28 18:36:04,1309774543,0,2,44,29,0,44
173713,2023-12-28 18:45:17,1309787545,12108,204,57,46,3,54
173712,2023-12-28 18:48:30,1309790657,33856,126,41,11,4,37
91342,2023-12-28 18:50:31,1309792257,938,15,27,13,1,26
91038,2023-12-28 18:51:02,1309792674,67562,174,84,48,7,77
90941,2023-12-28 18:51:23,1309792948,39501,83,63,17,3,60
90880,2023-12-28 18:53:55,1309794888,24439,334,173,68,7,166
91098,2023-12-28 18:54:53,1309795669,5157,7,71,9,1,70
90746,2023-12-28 18:59:52,1309799548,15543,190,24,3,7,17
90933,2023-12-28 19:00:08,1309799737,4909,11,46,12,1,45
173736,2023-12-28 19:17:45,1309813447,15247,9,10,8,2,8
173734,2023-12-28 19:18:20,1309813896,15712,35,23,15,2,21
173733,2023-12-28 19:19:27,1309814689,33871,44,24,17,1,23
173732,2023-12-28 19:20:08,1309815251,0,70,3,2,0,3
173731,2023-12-28 19:20:29,1309815534,2100,27,17,6,1,16
173729,2023-12-28 19:21:02,1309815933,60528,71,72,21,4,68
173720,2023-12-28 19:21:31,1309816358,1230,11,4,3,1,3
173716,2023-12-28 19:21:59,1309816675,924,41,59,27,1,58
85147,2023-12-28 19:29:01,1309822076,2820,9,21,6,1,20
173735,2023-12-28 19:33:43,1309825771,0,4,8,5,0,8
173737,2023-12-28 19:34:57,1309826688,0,15,148,100,0,148
173741,2023-12-28 19:43:34,1309833134,17330,104,60,31,2,58
173745,2023-12-28 19:57:00,1309843454,35918,355,222,46,8,214
173749,2023-12-28 20:27:54,1309867042,26117,141,121,78,10,111
155073,2023-12-28 20:57:58,1309889554,911,4,52,33,1,51
143524,2023-12-28 20:58:23,1309889879,1531,13,74,67,2,72
143510,2023-12-28 21:12:23,1309900904,5401,58,9,5,4,5
173751,2023-12-28 21:36:19,1309919452,5320,7,36,31,1,35
173751,2023-12-28 21:36:21,1309919463,5320,7,36,31,1,35
173763,2023-12-28 21:36:41,1309919742,24632,86,13,10,4,9
164213,2023-12-28 21:38:17,1309920979,3132,33,27,14,1,26
164701,2023-12-28 21:38:39,1309921202,16400,36,12,5,3,9
164202,2023-12-28 21:38:57,1309921415,6337,6,25,15,3,22
143567,2023-12-28 21:45:01,1309925868,32519,84,50,43,4,46
173766,2023-12-28 21:53:50,1309932432,18883,167,5,4,3,2
173777,2023-12-28 22:18:55,1309950079,18652,130,12,7,4,8
159114,2023-12-28 22:54:39,1309974963,107204,122,12,7,4,8
159724,2023-12-28 22:55:03,1309975200,94020,13,11,7,3,8
159368,2023-12-28 22:55:21,1309975380,60566,41,40,31,3,37
159113,2023-12-28 22:55:40,1309975615,130414,95,19,12,5,14
159370,2023-12-28 22:55:57,1309975791,133767,77,33,23,5,28
142223,2023-12-28 22:59:10,1309977964,2995,25,14,4,2,12
142221,2023-12-28 22:59:29,1309978153,0,54,89,32,0,89
142313,2023-12-28 22:59:50,1309978460,1570,34,12,6,2,10
141647,2023-12-28 23:00:09,1309978681,55415,299,41,25,8,33
141638,2023-12-28 23:00:31,1309978927,10373,49,44,32,3,41
122994,2023-12-29 00:10:12,1310025575,43256,54,52,12,9,43
134575,2023-12-29 00:10:32,1310025814,14523,122,45,17,5,40
122904,2023-12-29 00:10:46,1310025936,13778,21,51,39,2,49
122987,2023-12-29 00:11:02,1310026077,67299,141,72,10,7,65
145297,2023-12-29 00:11:20,1310026258,110344,128,115,37,24,91
122910,2023-12-29 00:12:48,1310027179,1493,1,3,1,1,2
155005,2023-12-29 00:13:05,1310027377,0,0,7,5,0,7
122990,2023-12-29 00:13:26,1310027611,0,7,10,8,0,10
122988,2023-12-29 00:13:53,1310027908,700,6,7,1,1,6
122909,2023-12-29 00:16:07,1310029184,1481,62,26,3,2,24
173667,2023-12-29 00:18:37,1310030870,77775,388,110,49,15,95
163133,2023-12-29 00:48:36,1310048378,13287,141,11,1,3,8
163132,2023-12-29 00:48:55,1310048575,16798,61,4,1,2,2
163438,2023-12-29 00:49:14,1310048788,0,0,26,10,0,26
163450,2023-12-29 00:49:41,1310049068,5333,7,4,2,1,3
163907,2023-12-29 00:50:09,1310049316,25193,128,58,21,7,51
165157,2023-12-29 14:22:31,1310229979,11991,41,33,19,4,29
165240,2023-12-29 14:23:00,1310230062,39387,31,52,33,5,47
165247,2023-12-29 14:23:33,1310230208,100,2,8,5,1,7
165171,2023-12-29 14:23:55,1310230278,4093,161,40,24,4,36
165333,2023-12-29 14:24:14,1310230356,42490,58,26,18,5,21
165169,2023-12-29 14:24:57,1310230508,9731,78,36,22,6,30
165046,2023-12-29 15:27:14,1310251805,8120,16,29,6,1,28
165149,2023-12-29 15:27:45,1310252017,15360,65,19,13,4,15
165370,2023-12-29 15:28:15,1310252244,1497,8,14,8,1,13
163071,2023-12-29 15:28:55,1310252501,18115,80,23,14,4,19
165047,2023-12-29 15:29:27,1310252767,12968,29,14,5,2,12
173852,2023-12-29 16:02:59,1310269751,743,9,7,1,1,6
173855,2023-12-29 16:20:08,1310279602,24827,30,22,16,2,20
173858,2023-12-29 16:30:23,1310285889,0,0,6,6,0,6
127303,2023-12-29 18:01:02,1310345750,86544,344,61,40,10,51
163880,2023-12-29 18:53:48,1310383058,19448,71,42,28,12,30
163998,2023-12-29 18:54:07,1310383273,23016,77,14,8,6,8
163998,2023-12-29 18:54:09,1310383306,23016,77,14,8,6,8
163906,2023-12-29 18:54:25,1310383482,2164,8,2,0,1,1
164159,2023-12-29 18:54:40,1310383661,6130,54,13,7,5,8
163925,2023-12-29 18:56:14,1310384884,4950,32,3,1,1,2
173951,2023-12-29 21:22:12,1310489182,92117,71,65,16,3,62
97279,2023-12-29 23:06:48,1310557591,9370,67,334,92,3,331
97279,2023-12-29 23:06:57,1310557677,9370,67,334,92,3,331
174007,2023-12-29 23:09:38,1310559393,21980,56,23,9,4,19
174006,2023-12-29 23:12:57,1310561557,85217,97,43,36,5,38
174008,2023-12-29 23:13:04,1310561633,8844,12,7,7,1,6
119778,2023-12-29 23:31:48,1310577257,27492,33,78,57,5,73
152232,2023-12-29 23:31:52,1310577359,467,2,29,24,1,28
174026,2023-12-29 23:59:15,1310614865,4639,336,29,14,1,28
174009,2023-12-30 00:04:05,1310619907,119566,149,56,26,8,48
173469,2023-12-30 14:26:58,1310803931,5584,18,3,1,2,1
174157,2024-01-02 17:10:11,1311964375,349,25,39,6,2,37
133691,2024-01-02 17:38:38,1311985087,19150,20,32,26,3,29
133712,2024-01-02 17:39:19,1311985638,5594,12,41,19,2,39
133683,2024-01-02 17:39:46,1311985926,41879,91,57,45,2,55
133690,2024-01-02 17:40:11,1311986337,600,9,26,17,1,25
133711,2024-01-02 17:40:49,1311986792,0,3,51,34,0,51
133723,2024-01-02 17:41:16,1311987139,1944,2,28,20,1,27
133717,2024-01-02 17:41:37,1311987422,6221,41,58,38,2,56
133685,2024-01-02 17:42:01,1311987675,0,1,30,25,0,30
133719,2024-01-02 17:42:23,1311988053,19129,154,37,32,3,34
133693,2024-01-02 17:53:50,1311997080,0,0,1,0,0,1
174166,2024-01-02 18:09:07,1312009096,5320,7,36,31,1,35
174162,2024-01-02 18:09:44,1312009561,0,2,44,29,0,44
174163,2024-01-02 18:10:17,1312010019,43714,187,44,26,8,36
174164,2024-01-02 18:10:52,1312010502,8814,87,2,1,1,1
174165,2024-01-02 18:11:29,1312011004,123137,52,56,28,3,53
154104,2024-01-02 18:33:43,1312028965,94229,235,29,13,6,23
154101,2024-01-02 18:33:49,1312029038,25097,55,72,40,3,69
154098,2024-01-02 18:34:32,1312029626,14575,57,48,17,3,45
154102,2024-01-02 18:34:51,1312029898,137387,305,51,33,3,48
174213,2024-01-02 20:50:39,1312144676,0,1,36,33,0,36
174214,2024-01-02 20:51:03,1312145027,14263,133,39,14,4,35
174208,2024-01-02 21:14:13,1312164012,13070,142,26,18,6,20
174152,2024-01-02 21:27:17,1312174963,19121,29,42,15,3,39
174218,2024-01-02 21:49:48,1312196285,25316,46,60,36,6,54
174235,2024-01-03 14:50:55,1312572285,3401,58,22,12,3,19
174253,2024-01-03 15:23:52,1312587849,0,1,5,1,0,5
174255,2024-01-03 15:28:45,1312590666,1107,15,96,33,2,94
35175,2024-01-03 18:03:14,1312702245,8722,47,75,3,2,73
174307,2024-01-03 18:20:57,1312716068,950,1,7,5,1,6
174329,2024-01-03 18:58:40,1312755420,10580,23,15,13,2,13
174297,2024-01-03 19:07:07,1312767499,119566,149,56,26,8,48
174302,2024-01-03 19:15:54,1312777776,4639,336,27,13,1,26
174308,2024-01-03 19:18:35,1312780864,114161,482,41,24,11,30
174317,2024-01-03 19:20:40,1312783354,116705,403,64,39,11,53
174364,2024-01-03 21:49:07,1312913506,32268,60,38,22,3,35
174368,2024-01-03 22:25:34,1312941620,1024,268,87,52,3,84
174369,2024-01-03 22:32:31,1312946739,0,4,43,37,0,43
174373,2024-01-03 22:47:36,1312958958,0,18,58,36,0,58
75457,2024-01-04 14:40:11,1313281345,345394,129,152,96,8,144
75457,2024-01-04 14:40:17,1313281387,345394,129,152,96,8,144
174387,2024-01-04 15:16:11,1313295664,486,4,15,12,1,14
174370,2024-01-04 16:05:09,1313321321,81665,150,51,31,10,41
174374,2024-01-04 16:08:48,1313323402,101241,207,45,21,13,32
174066,2024-01-04 16:11:51,1313325183,23985,56,5,3,3,2
174375,2024-01-04 16:24:00,1313332546,40383,98,7,2,4,3
174411,2024-01-04 16:24:54,1313333114,14259,36,27,16,2,25
174377,2024-01-04 16:35:57,1313340053,0,0,1,0,0,1
174378,2024-01-04 16:45:44,1313346493,76520,58,29,7,4,25
174412,2024-01-04 16:46:40,1313347082,0,170,20,7,0,20
174435,2024-01-04 18:13:05,1313410600,27763,147,34,14,6,28
174436,2024-01-04 18:13:12,1313410700,84303,106,53,37,5,48
174402,2024-01-04 18:18:08,1313414865,25936,94,36,23,3,33
174330,2024-01-04 19:44:49,1313488128,43463,25,48,43,1,47
174334,2024-01-04 19:59:02,1313500082,0,52,39,35,0,39
124474,2024-01-04 20:05:11,1313504950,1505,18,42,31,1,41
124388,2024-01-04 20:06:46,1313506230,150967,94,65,45,8,57
174462,2024-01-04 20:23:45,1313519928,17111,74,30,24,3,27
174331,2024-01-04 20:23:57,1313520074,32286,75,57,45,1,56
166031,2024-01-04 20:44:11,1313536288,23536,48,84,16,3,81
166060,2024-01-04 20:45:12,1313537073,2722,9,34,26,1,33
122645,2024-01-04 20:45:57,1313537638,4012,278,102,65,1,101
123395,2024-01-04 20:50:13,1313541051,22919,36,83,52,2,81
174466,2024-01-04 21:30:35,1313572393,42008,277,64,26,7,57
133713,2024-01-04 22:36:25,1313621235,0,0,2,0,0,2
133715,2024-01-04 22:38:13,1313622497,0,8,25,18,0,25
164800,2024-01-05 14:22:01,1313872397,37726,48,30,20,6,24
164632,2024-01-05 14:22:24,1313872504,28577,126,36,20,5,31
164635,2024-01-05 14:22:49,1313872617,168613,145,35,26,6,29
164648,2024-01-05 14:23:15,1313872737,0,0,6,3,0,6
164619,2024-01-05 14:23:39,1313872859,58294,50,12,8,3,9
142542,2024-01-05 14:29:53,1313874489,0,0,3,2,0,3
142817,2024-01-05 14:30:29,1313874636,20514,165,105,65,2,103
142891,2024-01-05 14:30:54,1313874731,11905,16,40,22,3,37
142539,2024-01-05 14:31:18,1313874836,16409,62,57,42,3,54
154485,2024-01-05 14:31:49,1313874970,33601,283,93,44,8,85
154932,2024-01-05 14:38:16,1313877041,0,2,10,6,0,10
154927,2024-01-05 14:38:47,1313877198,5427,18,3,0,1,2
155488,2024-01-05 14:41:22,1313878104,993,24,7,5,1,6
174498,2024-01-05 15:05:56,1313887727,85433,84,111,94,4,107
174499,2024-01-05 15:23:12,1313895737,11664,83,42,9,4,38
154837,2024-01-05 15:25:46,1313896922,105,167,89,58,1,88
154824,2024-01-05 15:26:17,1313897143,0,1,6,0,0,6
154821,2024-01-05 15:26:51,1313897446,16572,217,93,54,3,90
154812,2024-01-05 15:27:18,1313897718,12028,147,21,11,3,18
165141,2024-01-05 15:27:42,1313897932,18816,91,81,60,5,76
174450,2024-01-05 15:55:20,1313913122,30976,108,68,34,6,62
174451,2024-01-05 15:58:34,1313914830,52537,241,74,34,6,68
174447,2024-01-05 17:03:15,1313958158,306,137,9,6,1,8
174468,2024-01-05 17:06:23,1313960410,24856,105,9,7,2,7
106868,2024-01-05 18:05:29,1314005190,13443,72,16,6,5,11
165427,2024-01-05 20:37:20,1314130011,7022,9,27,24,2,25
165372,2024-01-05 20:38:06,1314130663,186423,123,58,35,3,55
165555,2024-01-05 20:39:17,1314131609,0,0,6,1,0,6
165366,2024-01-05 20:39:38,1314131876,164012,197,96,28,9,87
174557,2024-01-05 21:01:01,1314149603,78190,163,98,33,14,84
144369,2024-01-05 21:02:19,1314150652,4099,54,53,18,2,51
135628,2024-01-05 21:03:34,1314151676,29821,191,200,88,6,194
135626,2024-01-05 21:03:55,1314151910,3788,42,43,26,2,41
135629,2024-01-05 21:04:30,1314152411,0,1,88,28,0,88
135632,2024-01-05 21:04:58,1314152777,5935,70,75,52,2,73
143696,2024-01-05 21:05:33,1314153254,0,93,64,35,0,64
101292,2024-01-05 21:15:31,1314161439,29495,97,61,43,2,59
144368,2024-01-05 21:15:45,1314161620,4233,64,88,42,2,86
100481,2024-01-05 21:15:55,1314161794,2475,20,74,55,1,73
100514,2024-01-05 21:16:13,1314162064,87365,137,100,43,4,96
100487,2024-01-05 21:16:35,1314162377,8190,105,31,18,3,28
100483,2024-01-05 21:16:54,1314162639,120709,89,60,40,5,55
144366,2024-01-05 21:18:33,1314164005,28194,355,99,47,7,92
144370,2024-01-05 21:30:02,1314173659,85021,169,81,44,7,74
174337,2024-01-05 22:23:50,1314216789,10715,13,55,26,1,54
174561,2024-01-05 22:57:35,1314259097,0,12,4,4,0,4
174553,2024-01-06 14:40:09,1314847302,13322,175,7,4,2,5
174524,2024-01-06 15:27:49,1314860652,4361,56,137,47,1,136
154075,2024-01-06 16:27:03,1314883807,4665,29,20,6,2,18
154084,2024-01-06 16:27:32,1314884018,106580,93,77,16,6,71
165669,2024-01-08 15:38:24,1315642332,0,0,2,0,0,2
165673,2024-01-08 15:39:19,1315642839,181840,104,34,21,7,27
165665,2024-01-08 15:40:03,1315643223,0,0,5,2,0,5
163825,2024-01-08 15:40:49,1315643683,0,19,6,2,0,6
163826,2024-01-08 15:41:43,1315644221,10824,85,11,4,4,7
164980,2024-01-08 15:42:30,1315644665,5531,58,6,2,4,2
164317,2024-01-08 15:43:14,1315645112,10328,68,11,5,6,5
174586,2024-01-08 16:04:59,1315657511,94333,325,149,50,10,139
174590,2024-01-08 16:18:31,1315666282,11355,11,33,22,4,29
174592,2024-01-08 16:23:35,1315669490,0,2,21,2,0,21
120188,2024-01-08 17:08:45,1315701379,110640,230,35,16,7,28
120190,2024-01-08 17:09:08,1315701716,0,0,4,2,0,4
120187,2024-01-08 17:09:29,1315701968,3570,16,13,8,2,11
120186,2024-01-08 17:09:48,1315702210,0,0,3,1,0,3
120189,2024-01-08 17:10:08,1315702506,0,0,12,10,0,12
134434,2024-01-08 17:13:52,1315705367,41710,25,86,76,3,83
134693,2024-01-08 17:14:11,1315705649,0,15,54,26,0,54
134673,2024-01-08 17:14:34,1315705971,11948,111,60,13,2,58
145195,2024-01-08 17:14:55,1315706223,33970,21,39,31,1,38
134432,2024-01-08 17:15:12,1315706508,0,0,50,41,0,50
165339,2024-01-08 17:15:30,1315706742,1888,19,49,16,2,47
174616,2024-01-08 18:51:26,1315786002,449,1,21,16,1,20
174646,2024-01-08 22:31:29,1315958268,469989,145,29,22,6,23
164197,2024-01-09 14:50:31,1316224532,5464,93,17,7,4,13
164072,2024-01-09 14:50:32,1316224544,19847,47,20,4,5,15
164414,2024-01-09 14:50:35,1316224565,5106,52,50,15,3,47
164071,2024-01-09 14:50:39,1316224586,3192,50,22,7,4,18
164411,2024-01-09 14:50:43,1316224615,0,0,4,1,0,4
174654,2024-01-09 14:51:01,1316224719,306,137,9,6,1,8
49352,2024-01-09 14:51:53,1316225059,4193,6,51,13,1,50
154383,2024-01-09 16:42:00,1316289994,0,0,1,0,0,1
153097,2024-01-09 16:42:01,1316290011,20801,24,47,15,1,46
143333,2024-01-09 16:42:07,1316290036,14220,118,34,14,1,33
132077,2024-01-09 16:42:06,1316290076,75147,81,50,40,6,44
132076,2024-01-09 16:42:08,1316290117,1820,58,41,16,1,40
132075,2024-01-09 16:42:13,1316290143,51953,25,51,26,2,49
174681,2024-01-09 16:47:47,1316294209,41858,81,25,15,3,22
174697,2024-01-09 17:56:09,1316346139,60170,187,109,69,4,105
174700,2024-01-09 18:11:53,1316358725,480,25,28,21,1,27
174703,2024-01-09 18:27:11,1316370836,110178,79,47,28,5,42
174701,2024-01-09 19:19:16,1316413455,306,137,9,6,1,8
174710,2024-01-09 19:40:46,1316430934,70938,59,8,5,3,5
174711,2024-01-09 19:45:47,1316434843,8374,10,17,1,1,16
174574,2024-01-09 20:26:21,1316466516,38292,177,29,8,10,19
163778,2024-01-09 21:15:32,1316504190,109374,393,131,58,6,125
163874,2024-01-09 21:15:53,1316504436,36025,122,59,28,13,46
163765,2024-01-09 21:16:12,1316504684,72665,30,80,19,4,76
163871,2024-01-09 21:16:33,1316504923,59360,10,24,15,2,22
163891,2024-01-09 21:16:59,1316505319,39588,15,20,10,3,17
162353,2024-01-09 21:17:39,1316505876,4133,16,43,27,1,42
162399,2024-01-09 21:18:00,1316506143,1812,45,77,54,1,76
174714,2024-01-09 21:20:41,1316508139,47295,254,99,37,9,90
174727,2024-01-09 21:42:05,1316524348,134575,196,72,51,12,60
174422,2024-01-09 22:30:55,1316560003,81818,96,40,29,7,33
174736,2024-01-09 22:40:35,1316566713,11749,75,21,13,7,14
174598,2024-01-09 22:42:34,1316568002,556994,178,35,5,14,21
174599,2024-01-09 22:42:44,1316568119,5326,11,3,3,1,2
174740,2024-01-09 23:00:43,1316580696,31801,29,35,21,5,30
174742,2024-01-09 23:00:57,1316580866,25568,219,35,12,4,31
154669,2024-01-10 14:39:10,1316882490,187,24,15,6,1,14
154795,2024-01-10 14:39:32,1316882630,6299,164,32,7,2,30
154794,2024-01-10 14:40:06,1316882844,27456,136,18,8,8,10
155116,2024-01-10 14:40:32,1316883012,2751,28,80,55,2,78
165332,2024-01-10 14:40:54,1316883146,7029,51,26,10,2,24
135020,2024-01-10 14:44:29,1316884454,0,1,23,16,0,23
135039,2024-01-10 14:44:52,1316884573,6082,65,145,67,3,142
145180,2024-01-10 14:45:14,1316884725,167210,124,159,31,10,149
154960,2024-01-10 14:45:39,1316884911,128878,70,70,30,4,66
154363,2024-01-10 14:45:58,1316885020,5655,85,8,5,1,7
174755,2024-01-10 15:12:15,1316897909,21361,103,17,7,7,10
174759,2024-01-10 16:00:30,1316930776,2424,82,24,7,2,22
174762,2024-01-10 16:00:47,1316930961,11554,26,10,2,3,7
174784,2024-01-10 17:09:45,1316987234,0,0,3,1,0,3
174786,2024-01-10 17:19:04,1316995233,4014,22,22,6,2,20
174787,2024-01-10 17:19:26,1316995528,9205,11,12,7,1,11
174767,2024-01-10 17:27:59,1317002971,69350,185,89,52,6,83
174788,2024-01-10 17:28:20,1317003260,151877,26,58,34,1,57
174783,2024-01-10 17:29:12,1317004018,4526,148,21,13,2,19
174789,2024-01-10 17:37:23,1317011268,12436,62,78,46,2,76
174802,2024-01-10 17:52:45,1317024650,5817,25,27,18,1,26
174803,2024-01-10 18:03:26,1317043980,47900,124,55,34,5,50
156076,2024-01-10 18:04:45,1317047396,0,0,1,0,0,1
153341,2024-01-10 18:05:14,1317048647,55394,155,69,42,10,59
155621,2024-01-10 18:05:40,1317049771,10296,299,102,70,5,97
155668,2024-01-10 18:06:08,1317051007,47,51,14,7,1,13
155619,2024-01-10 18:06:40,1317052284,35657,201,80,63,6,74
174807,2024-01-10 18:27:46,1317106447,0,12,6,3,0,6
174806,2024-01-10 18:30:43,1317107845,15262,44,55,36,3,52
174798,2024-01-10 19:34:36,1317238610,40383,98,7,2,4,3
174837,2024-01-10 19:55:42,1317302786,49194,111,56,31,10,46
174154,2024-01-10 20:06:45,1317343323,0,55,6,2,0,6
174805,2024-01-10 20:18:49,1317372670,306,137,9,6,1,8
135055,2024-01-10 23:09:26,1317498585,43412,50,73,25,5,68
166384,2024-01-11 14:22:09,1317781603,4806,83,8,6,1,7
145792,2024-01-11 14:23:14,1317781901,0,25,19,8,0,19
135826,2024-01-11 14:24:25,1317782223,0,0,4,2,0,4
135545,2024-01-11 14:25:27,1317782537,2902,14,29,18,1,28
135599,2024-01-11 14:26:14,1317782774,0,53,16,4,0,16
174869,2024-01-11 15:23:55,1317808296,6959,7,35,13,1,34
174871,2024-01-11 15:35:28,1317815175,78026,348,40,22,15,25
174474,2024-01-11 16:27:23,1317850448,78033,173,42,27,6,36
174889,2024-01-11 16:48:26,1317865728,22196,38,18,8,4,14
174894,2024-01-11 17:10:54,1317882991,16189,81,88,61,5,83
145479,2024-01-11 17:20:20,1317890548,20666,36,37,24,4,33
174895,2024-01-11 17:25:55,1317895124,223303,99,52,32,5,47
174908,2024-01-11 18:13:38,1317934100,5932,2,7,1,1,6
174907,2024-01-11 18:14:14,1317934581,88469,121,57,19,10,47
174906,2024-01-11 20:09:55,1318034470,21159,112,92,38,7,85
174912,2024-01-11 20:10:13,1318034689,0,0,11,11,0,11
174922,2024-01-11 20:10:18,1318034802,26847,15,27,16,2,25
174927,2024-01-11 20:10:28,1318034926,1022,5,8,2,2,6
174928,2024-01-11 20:10:37,1318035048,53715,111,22,15,7,15
174911,2024-01-11 20:13:25,1318037255,86846,67,19,13,3,16
122948,2024-01-11 21:00:51,1318074352,52355,233,34,7,12,22
174982,2024-01-12 14:24:49,1318449578,105435,81,46,7,4,42
174954,2024-01-12 14:40:32,1318453740,20466,148,24,12,4,20
174981,2024-01-12 14:41:59,1318454244,15134,152,26,18,5,21
154042,2024-01-12 14:46:18,1318455787,9657,37,59,21,3,56
154045,2024-01-12 14:46:52,1318455962,8565,13,39,7,4,35
154197,2024-01-12 14:47:21,1318456163,11840,24,3,2,1,2
154040,2024-01-12 14:49:03,1318456842,8528,35,18,10,2,16
174987,2024-01-12 14:50:45,1318457531,85697,87,16,10,9,7
174988,2024-01-12 14:58:44,1318460377,171671,107,41,14,17,24
174986,2024-01-12 15:13:26,1318466779,0,0,4,3,0,4
174931,2024-01-12 16:05:42,1318496581,96509,265,102,11,16,86
142683,2024-01-12 16:56:12,1318536321,12866,121,19,10,2,17
143347,2024-01-12 16:56:54,1318536820,3714,23,49,33,2,47
111622,2024-01-12 16:57:39,1318537415,122094,67,73,51,5,68
111617,2024-01-12 16:58:08,1318537817,18048,28,56,49,2,54
174796,2024-01-12 17:11:48,1318548780,76215,142,47,16,13,34
119243,2024-01-12 17:16:55,1318552899,38919,71,27,11,6,21
164227,2024-01-12 17:17:28,1318553446,0,0,13,9,0,13
164230,2024-01-12 17:17:51,1318553748,39928,32,25,16,2,23
119216,2024-01-12 17:18:33,1318554336,1700,3,3,0,1,2
120239,2024-01-12 17:26:11,1318560716,10901,104,20,8,5,15
175019,2024-01-12 19:03:27,1318640785,50529,117,68,39,13,55
175021,2024-01-12 19:09:22,1318645569,94448,153,131,4,8,123
175022,2024-01-12 19:38:01,1318669083,1475,12,4,2,1,3
175026,2024-01-12 20:24:22,1318706349,46083,114,20,5,4,16
175027,2024-01-12 20:26:58,1318708397,30905,24,17,11,1,16
175023,2024-01-12 20:55:39,1318731012,34308,162,16,9,3,13
175024,2024-01-12 20:55:46,1318731078,70698,62,68,6,19,49
175024,2024-01-12 20:55:49,1318731115,70698,62,68,6,19,49
175041,2024-01-12 21:10:08,1318742192,700843,213,121,99,11,110
174820,2024-01-12 21:12:54,1318744203,1095,9,84,42,2,82
175040,2024-01-12 21:16:53,1318747143,32558,154,48,13,9,39
175050,2024-01-12 21:24:47,1318753146,9304,3,7,3,1,6
175062,2024-01-13 14:29:53,1319105359,31036,142,28,13,8,20
139502,2024-01-13 16:58:59,1319168570,75603,187,81,21,16,65
139355,2024-01-13 16:59:04,1319168621,14673,117,50,18,7,43
139504,2024-01-13 16:59:10,1319168674,14150,36,61,43,2,59
175071,2024-01-13 17:16:46,1319178639,247,95,32,18,1,31
175091,2024-01-15 14:12:45,1320094434,0,0,24,15,0,24
175092,2024-01-15 14:14:40,1320094961,23287,13,21,8,2,19
175093,2024-01-15 14:16:49,1320095700,4200,139,16,8,1,15
175069,2024-01-15 14:16:56,1320095731,29919,93,20,8,4,16
175095,2024-01-15 14:26:47,1320099141,0,207,85,41,0,85
175096,2024-01-15 14:28:10,1320099600,6624,75,51,21,1,50
175097,2024-01-15 14:29:39,1320100103,5922,24,34,13,1,33
157441,2024-01-15 14:42:07,1320104977,17968,58,7,1,2,5
143348,2024-01-15 14:42:37,1320105222,1680,3,13,7,1,12
154056,2024-01-15 14:45:53,1320106642,68298,233,69,44,5,64
175094,2024-01-15 15:28:34,1320129059,3475,216,26,12,2,24
175068,2024-01-15 15:33:11,1320132226,61443,216,80,11,21,59
175123,2024-01-15 17:11:27,1320209512,13198,63,58,19,4,54
175131,2024-01-15 18:04:40,1320258339,193559,115,54,38,9,45
175137,2024-01-15 19:04:37,1320314925,65898,66,18,10,4,14
175140,2024-01-15 19:14:25,1320324213,290118,141,43,28,10,33
175141,2024-01-15 19:20:03,1320329674,12956,84,11,4,1,10
175142,2024-01-15 19:30:27,1320339591,0,65,21,5,0,21
175135,2024-01-15 19:50:49,1320358078,2676,18,10,9,1,9
175134,2024-01-15 19:50:57,1320358182,2845,23,48,18,1,47
175136,2024-01-15 19:51:11,1320358413,41554,77,95,25,7,88
175133,2024-01-15 19:51:46,1320358971,5335,16,13,5,2,11
175132,2024-01-15 19:52:05,1320359222,135605,136,35,19,4,31
175158,2024-01-15 21:17:15,1320428825,59319,71,72,35,5,67
175174,2024-01-15 22:33:41,1320489974,1450,27,15,9,1,14
175179,2024-01-15 22:52:07,1320503835,123039,203,38,23,8,30
175180,2024-01-15 22:58:12,1320508267,157279,318,103,41,22,81
175207,2024-01-16 15:32:33,1320814335,297731,117,45,33,7,38
175206,2024-01-16 15:33:00,1320814633,1942,7,9,5,1,8
118863,2024-01-16 15:55:40,1320830242,217085,107,143,54,7,136
175220,2024-01-16 16:35:01,1320860257,57087,329,57,24,8,49
175159,2024-01-16 16:47:11,1320869944,25068,56,50,25,5,45
175168,2024-01-16 16:47:18,1320870033,37870,281,103,67,6,97
175175,2024-01-16 16:47:38,1320870333,9808,67,9,2,5,4
175175,2024-01-16 16:53:03,1320874695,9808,67,9,2,5,4
175245,2024-01-16 18:13:51,1320944338,342430,284,116,51,10,106
175245,2024-01-16 18:13:53,1320944367,342430,284,116,51,10,106
175239,2024-01-16 18:25:18,1320954453,103232,210,83,16,7,76
175246,2024-01-16 18:33:18,1320961347,3863,12,31,0,1,30
96488,2024-01-16 19:05:33,1320989492,93398,97,76,50,7,69
96484,2024-01-16 19:05:51,1320989740,114100,85,89,53,10,79
96501,2024-01-16 19:06:17,1320990119,7642,193,40,19,7,33
96574,2024-01-16 19:06:41,1320990452,12905,118,38,17,6,32
96435,2024-01-16 19:07:08,1320990831,4999,6,15,14,1,14
96519,2024-01-16 19:07:33,1320991142,13891,32,21,14,2,19
154897,2024-01-16 19:24:02,1321004995,4292,369,42,17,2,40
146004,2024-01-16 19:24:04,1321005026,26613,234,67,45,4,63
145828,2024-01-16 19:24:07,1321005073,11585,144,24,10,1,23
145829,2024-01-16 19:24:09,1321005109,26991,17,9,3,4,5
145831,2024-01-16 19:24:14,1321005174,0,0,5,3,0,5
145827,2024-01-16 19:24:23,1321005289,14694,34,43,33,2,41
175269,2024-01-16 19:42:22,1321020770,36704,158,14,6,6,8
175218,2024-01-16 20:14:41,1321047782,8870,58,27,6,5,22
175211,2024-01-16 20:14:57,1321048344,26741,14,24,3,1,23
175212,2024-01-16 20:15:01,1321048492,10994,21,22,9,2,20
18377,2024-01-16 20:17:00,1321053251,34972,28,66,36,1,65
175273,2024-01-16 20:17:59,1321055527,157088,206,45,27,12,33
175272,2024-01-16 20:19:01,1321058176,146817,97,35,16,5,30
175276,2024-01-16 21:37:02,1321174202,41333,9,28,10,2,26
175262,2024-01-16 21:48:12,1321183215,158576,113,60,47,7,53
175279,2024-01-16 21:52:00,1321186361,86966,175,113,77,6,107
175279,2024-01-16 21:52:04,1321186433,86966,175,113,77,6,107
175281,2024-01-16 21:52:36,1321186839,118532,131,88,64,8,80
175282,2024-01-16 21:53:30,1321187536,55672,186,15,12,9,6
175283,2024-01-16 21:54:49,1321188649,64006,89,29,17,4,25
175284,2024-01-16 21:55:31,1321189207,79650,377,140,77,10,130
147872,2024-01-16 22:47:10,1321228631,95442,150,95,44,8,87
147870,2024-01-16 22:47:30,1321228931,10940,43,92,57,2,90
147791,2024-01-16 22:47:51,1321229203,74799,161,73,38,8,65
175166,2024-01-16 23:39:37,1321268976,10418,93,12,7,2,10
175293,2024-01-17 14:39:07,1321661273,0,17,11,5,0,11
175302,2024-01-17 15:13:38,1321676564,71114,190,59,42,10,49
175304,2024-01-17 15:41:35,1321693398,47971,193,86,62,4,82
175306,2024-01-17 15:45:30,1321696092,41055,151,60,29,4,56
175311,2024-01-17 16:14:59,1321717098,67692,273,107,58,13,94
175319,2024-01-17 16:40:08,1321737302,212963,261,62,26,18,44
175322,2024-01-17 16:58:32,1321752585,267044,65,23,17,4,19
175309,2024-01-17 17:11:14,1321763170,0,4,48,13,0,48
175280,2024-01-17 17:18:51,1321769617,21058,57,26,13,6,20
175258,2024-01-17 17:18:52,1321769628,40854,201,31,2,11,20
164784,2024-01-17 17:28:38,1321778240,30801,73,69,52,6,63
164784,2024-01-17 17:28:42,1321778318,30801,73,69,52,6,63
164507,2024-01-17 17:29:24,1321778942,21384,181,45,21,8,37
164508,2024-01-17 17:29:54,1321779381,3275,65,109,81,1,108
164508,2024-01-17 17:29:58,1321779438,3275,65,109,81,1,108
165093,2024-01-17 17:30:16,1321779731,11314,47,73,35,2,71
175325,2024-01-17 17:39:53,1321788140,85133,88,37,23,7,30
175342,2024-01-17 18:23:48,1321826719,6130,340,66,30,3,63
166330,2024-01-17 18:30:43,1321832869,20798,78,49,12,5,44
175321,2024-01-17 18:33:20,1321835272,6579,15,16,7,2,14
175334,2024-01-17 18:58:35,1321857539,24045,43,34,21,3,31
175356,2024-01-17 19:06:34,1321864646,50653,161,49,29,9,40
29193,2024-01-17 19:27:11,1321882813,7933,11,45,22,3,42
175363,2024-01-17 20:34:20,1321938782,22801,219,52,38,4,48
142428,2024-01-17 20:56:38,1321956472,0,0,32,19,0,32
175365,2024-01-17 21:57:13,1322004198,52738,277,56,13,12,44
175357,2024-01-17 21:57:13,1322004213,122769,289,27,11,6,21
175381,2024-01-17 21:57:23,1322004322,20561,59,52,24,3,49
113415,2024-01-17 22:01:00,1322006970,8996,22,10,7,3,7
175382,2024-01-17 22:09:28,1322013279,214596,214,75,35,13,62
175383,2024-01-17 22:09:44,1322013474,82808,107,44,28,8,36
175384,2024-01-17 22:09:58,1322013620,72840,143,54,29,13,41
175385,2024-01-17 22:10:48,1322014246,226990,101,73,47,9,64
175388,2024-01-17 22:10:58,1322014377,98538,111,40,23,10,30
164517,2024-01-17 22:12:40,1322015689,0,0,10,8,0,10
175391,2024-01-17 22:23:02,1322023279,55377,76,17,9,6,11
175389,2024-01-17 22:28:47,1322027293,51510,198,14,9,8,6
106145,2024-01-17 23:15:11,1322060170,0,46,361,20,0,361
104629,2024-01-17 23:15:45,1322060525,624,8,6,2,1,5
106146,2024-01-17 23:16:11,1322060801,6769,20,37,13,2,35
106146,2024-01-17 23:16:14,1322060819,6769,20,37,13,2,35
106143,2024-01-17 23:16:32,1322061022,0,1,31,17,0,31
106143,2024-01-17 23:16:34,1322061075,0,1,31,17,0,31
115253,2024-01-17 23:17:00,1322061338,32662,0,24,10,1,23
115252,2024-01-17 23:17:18,1322061559,40496,148,21,3,3,18
115252,2024-01-17 23:17:20,1322061575,40496,148,21,3,3,18
106147,2024-01-17 23:18:14,1322062240,27595,43,109,49,1,108
175386,2024-01-18 15:32:32,1322370903,0,17,11,5,0,11
115282,2024-01-18 15:54:36,1322384807,31087,67,33,15,2,31
105089,2024-01-18 16:04:56,1322391718,61880,52,22,3,3,19
175425,2024-01-18 16:15:00,1322398975,40042,15,17,8,1,16
121951,2024-01-18 16:40:05,1322417544,25903,112,66,52,2,64
121953,2024-01-18 16:41:17,1322418525,29978,207,39,24,4,35
154896,2024-01-18 16:41:32,1322418736,5367,198,32,23,2,30
121956,2024-01-18 16:41:41,1322418860,1259,13,49,32,1,48
132649,2024-01-18 16:41:48,1322418935,36265,675,128,39,6,122
175435,2024-01-18 16:48:09,1322423863,80286,71,16,12,6,10
175434,2024-01-18 17:02:28,1322435000,0,21,8,2,0,8
175433,2024-01-18 17:03:41,1322435977,0,0,2,0,0,2
175439,2024-01-18 17:04:27,1322436577,8718,23,13,6,1,12
175447,2024-01-18 17:09:19,1322440418,1236,3,3,1,1,2
175449,2024-01-18 17:16:53,1322446539,39675,75,6,3,5,1
175451,2024-01-18 17:21:27,1322450364,1418,6,8,3,1,7
175453,2024-01-18 17:26:05,1322454002,79479,90,47,27,6,41
175432,2024-01-18 17:48:20,1322472923,0,6,22,15,0,22
175459,2024-01-18 17:52:58,1322476597,0,13,5,1,0,5
175457,2024-01-18 17:55:05,1322478422,139182,173,57,33,10,47
175448,2024-01-18 17:56:01,1322479284,51985,82,5,2,5,0
175450,2024-01-18 17:58:07,1322480972,334035,135,108,53,12,96
175452,2024-01-18 17:58:35,1322481360,12953,141,13,4,5,8
175456,2024-01-18 17:58:54,1322481588,17202,59,6,3,2,4
175458,2024-01-18 17:59:10,1322481842,43869,30,18,10,4,14
175460,2024-01-18 17:59:33,1322482176,13509,146,15,7,3,12
175463,2024-01-18 18:23:36,1322502976,0,0,17,11,0,17
175463,2024-01-18 18:23:40,1322503034,0,0,17,11,0,17
175466,2024-01-18 18:31:35,1322509923,36146,185,51,32,7,44
175438,2024-01-18 18:56:27,1322530844,34972,28,66,36,1,65
175438,2024-01-18 18:56:31,1322530895,34972,28,66,36,1,65
175468,2024-01-18 20:01:31,1322584738,29730,71,51,41,4,47
175462,2024-01-18 20:26:18,1322604259,153655,164,118,88,10,108
175467,2024-01-18 20:26:45,1322604588,22327,38,25,21,2,23
175472,2024-01-18 20:50:12,1322623485,19820,320,106,68,16,90
175481,2024-01-18 20:55:36,1322627598,6638,74,9,1,2,7
175482,2024-01-18 21:03:21,1322633708,12147,195,27,19,2,25
175484,2024-01-18 21:12:51,1322641188,33211,37,24,9,4,20
175483,2024-01-18 22:04:20,1322681124,31998,48,25,16,3,22
175485,2024-01-18 22:04:49,1322681480,23947,93,62,26,3,59
175487,2024-01-18 22:05:25,1322681967,0,13,35,27,0,35
175491,2024-01-18 22:06:03,1322682404,708401,190,53,27,10,43
155484,2024-01-19 00:29:06,1322776700,14416,54,41,19,3,38
155519,2024-01-19 00:29:48,1322777051,65768,58,61,20,4,57
155495,2024-01-19 00:32:19,1322778431,23223,101,91,35,6,85
155513,2024-01-19 00:35:27,1322780141,26319,59,79,30,7,72
175541,2024-01-19 14:30:32,1322996261,47014,163,78,33,5,73
175542,2024-01-19 14:53:55,1323005424,14822,31,293,21,1,292
175542,2024-01-19 14:54:01,1323005457,14822,31,293,21,1,292
175552,2024-01-19 16:08:51,1323048823,8250,27,32,26,2,30
175525,2024-01-19 16:10:31,1323050036,71025,110,11,2,5,6
167741,2024-01-19 16:23:49,1323059530,1239,24,3,0,2,1
175534,2024-01-19 16:27:34,1323062107,46256,65,56,25,4,52
175563,2024-01-19 17:06:04,1323090378,128292,234,54,37,10,44
175567,2024-01-19 17:11:45,1323094626,56317,278,79,35,22,57
175564,2024-01-19 17:17:02,1323098664,210147,328,44,28,11,33
175570,2024-01-19 17:22:45,1323103131,30118,90,3,1,2,1
175566,2024-01-19 17:24:26,1323104426,135582,131,23,13,6,17
155889,2024-01-19 17:28:45,1323107703,30736,456,76,16,8,68
175568,2024-01-19 17:29:14,1323108157,60770,42,42,22,5,37
155867,2024-01-19 17:29:37,1323108440,3160,18,8,5,1,7
156418,2024-01-19 17:33:36,1323111575,20526,181,31,20,4,27
175571,2024-01-19 17:34:31,1323112282,14963,8,53,34,2,51
156422,2024-01-19 17:34:50,1323112523,17590,100,28,14,4,24
156419,2024-01-19 17:35:51,1323113324,12392,157,37,16,3,34
101151,2024-01-19 17:37:05,1323114343,104814,190,163,117,6,157
110678,2024-01-19 17:37:27,1323114600,100012,489,125,64,13,112
101149,2024-01-19 17:37:48,1323114876,56283,126,76,59,6,70
175532,2024-01-19 17:37:48,1323114880,0,140,41,19,0,41
175579,2024-01-19 17:43:24,1323119406,28225,28,41,25,1,40
175588,2024-01-19 18:05:41,1323137266,3072,104,38,31,2,36
175596,2024-01-19 18:27:36,1323155076,0,40,59,10,0,59
166261,2024-01-19 18:38:53,1323164237,61416,102,79,7,6,73
166260,2024-01-19 18:39:19,1323164576,0,0,6,5,0,6
166262,2024-01-19 18:39:45,1323164897,662,57,31,13,2,29
166263,2024-01-19 18:40:27,1323165455,44092,113,43,21,4,39
166264,2024-01-19 18:40:46,1323165685,0,1,4,0,0,4
166741,2024-01-19 18:41:11,1323166023,19421,49,37,30,4,33
175607,2024-01-19 19:23:40,1323200048,17874,8,41,30,1,40
175610,2024-01-19 19:50:03,1323221342,159517,78,45,25,5,40
175605,2024-01-19 20:12:33,1323238982,0,0,10,8,0,10
175608,2024-01-19 20:12:42,1323239101,0,0,5,0,0,5
175609,2024-01-19 20:12:47,1323239166,185466,89,52,10,5,47
175617,2024-01-19 21:11:45,1323283611,3805,22,17,9,1,16
175616,2024-01-19 21:45:18,1323308383,69693,137,27,12,5,22
175630,2024-01-19 21:46:07,1323309001,10002,118,11,4,3,8
156882,2024-01-19 22:00:57,1323319542,67760,111,26,19,3,23
156159,2024-01-19 22:01:24,1323319892,236394,157,39,22,12,27
165029,2024-01-19 22:01:46,1323320130,35531,42,13,9,4,9
164767,2024-01-19 22:02:05,1323320366,0,0,1,0,0,1
175631,2024-01-19 22:28:32,1323344132,1408,15,1,1,1,0
175635,2024-01-19 23:16:33,1323411847,0,7,52,13,0,52
175634,2024-01-19 23:17:26,1323412388,0,13,12,4,0,12
175633,2024-01-19 23:18:15,1323412875,10037,108,52,24,2,50
175632,2024-01-19 23:19:04,1323413354,138747,128,47,32,9,38
175646,2024-01-20 15:07:17,1323651893,232606,146,101,71,10,91
175653,2024-01-20 15:31:05,1323660049,252557,186,81,53,8,73
175654,2024-01-20 15:32:37,1323660607,13085,122,27,20,4,23
175655,2024-01-20 15:41:11,1323663862,0,0,1,1,0,1
175672,2024-01-20 17:03:37,1323702947,40931,128,69,24,5,64
175672,2024-01-20 17:03:41,1323702981,40931,128,69,24,5,64
175673,2024-01-20 17:03:57,1323703126,51744,70,47,31,4,43
175674,2024-01-20 17:04:15,1323703303,20033,9,51,27,2,49
175675,2024-01-20 17:04:34,1323703459,45360,66,39,16,7,32
175676,2024-01-20 17:04:50,1323703625,37729,67,39,8,4,35
154905,2024-01-20 17:19:51,1323711778,62,6,37,31,1,36
124957,2024-01-20 17:20:18,1323712031,0,24,63,49,0,63
154906,2024-01-20 17:20:45,1323712247,5198,71,61,46,4,57
154900,2024-01-20 17:21:09,1323712478,0,44,30,21,0,30
154899,2024-01-20 17:21:30,1323712668,0,11,26,23,0,26
175677,2024-01-20 17:25:50,1323715073,0,0,16,13,0,16
175678,2024-01-20 17:26:08,1323715256,0,0,1,0,0,1
175679,2024-01-20 17:26:24,1323715413,0,0,7,6,0,7
175680,2024-01-20 17:26:41,1323715558,55150,37,10,3,4,6
175681,2024-01-20 17:50:12,1323729032,63876,88,18,7,7,11
175682,2024-01-20 17:50:35,1323729252,114588,507,57,22,12,45
175683,2024-01-20 17:50:52,1323729412,17789,16,89,40,3,86
175684,2024-01-20 17:51:28,1323729768,0,1,22,18,0,22
175685,2024-01-20 17:53:38,1323731067,15054,23,13,6,1,12
175523,2024-01-20 19:13:54,1323779540,0,6,21,19,0,21
175719,2024-01-22 15:01:49,1324489973,400,12,28,21,1,27
165237,2024-01-22 15:03:19,1324490637,99119,116,31,19,6,25
165152,2024-01-22 15:03:21,1324490649,2775,12,23,2,1,22
165150,2024-01-22 15:03:24,1324490667,41664,87,29,17,6,23
165452,2024-01-22 15:03:26,1324490688,86131,151,44,24,9,35
165511,2024-01-22 15:03:29,1324490705,68159,95,39,27,8,31
165225,2024-01-22 15:03:35,1324490757,69024,31,42,23,3,39
140991,2024-01-22 15:32:50,1324505566,14881,64,44,27,3,41
157439,2024-01-22 15:33:20,1324505876,12376,37,21,13,2,19
175721,2024-01-22 15:33:30,1324506000,6755,158,64,41,1,63
166925,2024-01-22 15:34:25,1324506541,25247,124,32,9,5,27
125069,2024-01-22 15:35:54,1324507400,14220,89,33,15,5,28
175737,2024-01-22 16:19:01,1324535059,86956,44,66,33,5,61
175735,2024-01-22 16:20:21,1324535985,53088,59,43,32,4,39
175733,2024-01-22 16:20:50,1324536293,63780,141,28,14,6,22
133888,2024-01-22 16:51:25,1324558867,200503,126,58,45,8,50
133885,2024-01-22 16:52:02,1324559330,27569,37,32,19,3,29
133887,2024-01-22 16:52:27,1324559674,11609,13,12,6,2,10
143697,2024-01-22 16:52:58,1324560056,241050,171,77,26,11,66
143554,2024-01-22 16:53:23,1324560388,46360,273,99,60,11,88
134186,2024-01-22 16:53:58,1324560790,4392,14,75,34,2,73
175738,2024-01-22 16:54:16,1324561063,83126,86,40,15,9,31
175734,2024-01-22 17:01:16,1324566301,76246,275,60,43,10,50
175736,2024-01-22 17:01:41,1324566642,38729,68,42,9,5,37
175740,2024-01-22 17:13:13,1324575340,30627,160,47,39,4,43
160181,2024-01-22 18:54:30,1324660926,0,37,8,2,0,8
159673,2024-01-22 18:54:58,1324661289,10999,11,20,1,7,13
159674,2024-01-22 18:55:14,1324661528,52150,73,78,23,5,73
159675,2024-01-22 18:55:30,1324661777,10908,50,19,2,2,17
159720,2024-01-22 18:55:47,1324662034,43241,70,62,21,5,57
156108,2024-01-22 20:28:58,1324820411,15083,51,30,9,2,28
155755,2024-01-22 20:28:59,1324820423,58204,10,12,8,1,11
155763,2024-01-22 20:29:01,1324820445,64675,86,33,15,4,29
155762,2024-01-22 20:29:03,1324820472,2260,17,7,5,1,6
156111,2024-01-22 20:29:06,1324820496,119057,265,48,34,8,40
156736,2024-01-22 20:29:10,1324820511,2084,128,46,21,1,45
166163,2024-01-22 20:29:11,1324820529,83644,241,21,2,7,14
166165,2024-01-22 20:29:14,1324820546,80219,30,23,10,8,15
155394,2024-01-22 20:36:30,1324827860,51046,82,47,26,5,42
155390,2024-01-22 20:36:35,1324828092,12513,48,38,27,6,32
155389,2024-01-22 20:36:38,1324828341,975,14,34,11,1,33
155487,2024-01-22 20:36:41,1324828572,6663,15,15,10,2,13
166532,2024-01-22 20:36:44,1324828765,10555,6,7,3,1,6
155433,2024-01-22 20:37:01,1324829814,2842,21,9,7,1,8
114905,2024-01-22 20:40:26,1324842633,3525,18,47,27,4,43
132161,2024-01-22 20:40:51,1324844325,187131,126,59,40,4,55
132153,2024-01-22 20:41:16,1324845769,186429,22,30,22,6,24
175741,2024-01-22 21:57:29,1325017879,139483,60,92,39,3,89
175781,2024-01-22 22:01:15,1325025751,7595,39,16,12,3,13
175782,2024-01-22 22:02:01,1325027714,3780,17,30,24,1,29
175784,2024-01-22 22:02:31,1325028938,59631,292,89,47,11,78
97213,2024-01-22 22:24:41,1325073325,19632,87,107,26,1,106
97219,2024-01-22 22:25:07,1325073759,137996,148,58,16,8,50
97264,2024-01-22 22:25:32,1325075000,28675,53,65,30,7,58
134308,2024-01-22 22:25:53,1325075942,4488,201,35,10,3,32
97209,2024-01-22 22:26:12,1325076645,60839,78,77,20,3,74
175786,2024-01-22 22:28:34,1325083264,0,0,2,0,0,2
175699,2024-01-22 22:30:23,1325088613,6696,8,10,9,1,9
175713,2024-01-22 22:30:30,1325088991,25798,59,55,54,3,52
175788,2024-01-22 22:31:52,1325094004,46969,35,33,21,3,30
175790,2024-01-22 22:33:36,1325100185,0,20,9,2,0,9
144098,2024-01-22 23:22:19,1325177475,35574,61,14,6,3,11
175813,2024-01-23 14:22:16,1325399212,18058,115,123,22,10,113
175814,2024-01-23 14:48:01,1325483460,17440,45,17,11,2,15
175801,2024-01-23 15:21:05,1325574642,125558,86,41,33,3,38
175818,2024-01-23 15:23:53,1325584825,0,6,22,15,0,22
175802,2024-01-23 15:24:37,1325587277,9903,21,1,0,1,0
175806,2024-01-23 15:32:53,1325617882,0,1,19,13,0,19
175809,2024-01-23 15:36:14,1325621387,8003,11,7,4,2,5
175810,2024-01-23 15:38:19,1325624914,61010,64,29,10,4,25
175828,2024-01-23 15:52:46,1325677931,899,9,13,2,1,12
175829,2024-01-23 16:08:42,1325694334,18910,62,23,13,4,19
163971,2024-01-23 16:20:18,1325706421,0,1,9,4,0,9
163968,2024-01-23 16:20:46,1325707657,10761,20,11,8,4,7
163689,2024-01-23 16:21:07,1325708713,0,0,3,0,0,3
163777,2024-01-23 16:21:30,1325709828,0,9,32,18,0,32
175803,2024-01-23 16:42:34,1325759428,19911,193,21,8,3,18
175830,2024-01-23 16:52:17,1325794599,8083,94,10,4,3,7
175833,2024-01-23 17:00:36,1325826631,24883,269,31,13,7,24
175851,2024-01-23 17:31:36,1325887178,13464,80,34,13,1,33
175843,2024-01-23 17:34:28,1325892207,73746,303,56,26,7,49
175852,2024-01-23 17:36:48,1325896931,349,1,7,0,1,6
175855,2024-01-23 17:47:24,1325920418,6511,177,34,11,4,30
175856,2024-01-23 17:55:12,1325949482,72555,132,62,42,4,58
175869,2024-01-23 18:48:36,1325995683,69334,85,25,12,6,19
126145,2024-01-23 19:01:21,1326004071,16048,71,62,28,3,59
126151,2024-01-23 19:01:49,1326004534,133010,102,71,38,4,67
175886,2024-01-23 19:19:25,1326012359,5198,44,11,7,4,7
175894,2024-01-23 19:33:20,1326017299,3308,12,34,27,2,32
144665,2024-01-23 19:51:32,1326023436,19527,25,28,23,4,24
175868,2024-01-23 20:03:21,1326027296,80977,223,100,66,7,93
175870,2024-01-23 20:05:28,1326028032,127712,263,57,28,16,41
175895,2024-01-23 20:08:05,1326028924,93487,311,64,48,20,44
175896,2024-01-23 20:13:15,1326030598,58959,395,37,15,10,27
175897,2024-01-23 20:34:48,1326037497,29566,58,25,16,4,21
175898,2024-01-23 21:16:28,1326066365,2124,123,16,7,3,13
175866,2024-01-23 21:27:02,1326074403,53373,18,8,4,3,5
175906,2024-01-23 21:48:02,1326088926,46006,75,18,3,6,12
175899,2024-01-23 21:49:49,1326090103,32558,155,49,13,9,40
175907,2024-01-23 21:52:12,1326091802,123855,203,57,37,6,51
175909,2024-01-23 22:28:19,1326116516,19010,196,52,17,8,44
175911,2024-01-23 22:42:54,1326126087,46969,35,33,21,3,30
109632,2024-01-24 15:01:34,1326421267,280,3,67,36,1,66
175932,2024-01-24 15:08:13,1326424552,0,7,48,43,0,48
175935,2024-01-24 16:02:53,1326458715,76791,95,13,2,7,6
175936,2024-01-24 16:05:39,1326460590,7106,32,16,5,1,15
162666,2024-01-24 16:15:42,1326468033,111444,228,115,89,14,101
41954,2024-01-24 16:17:47,1326469583,0,65,72,57,0,72
175946,2024-01-24 16:43:08,1326547464,934410,283,89,51,16,73
175944,2024-01-24 17:01:23,1326576995,86118,133,20,12,7,13
175971,2024-01-24 18:06:29,1326787052,19110,104,18,12,5,13
175987,2024-01-24 18:47:40,1326856436,37770,166,30,18,7,23
175989,2024-01-24 18:47:58,1326856641,2420,6,98,8,1,97
175937,2024-01-24 18:50:44,1326859029,0,65,72,57,0,72
175991,2024-01-24 18:52:54,1326860809,0,4,39,27,0,39
175994,2024-01-24 18:58:27,1326865781,18324,19,8,6,4,4
175990,2024-01-24 19:06:09,1326872775,14365,8,17,13,3,14
175993,2024-01-24 19:07:54,1326874357,3150,4,10,2,2,8
176001,2024-01-24 19:12:24,1326878930,12617,47,66,42,3,63
176007,2024-01-24 19:57:01,1326946425,6407,131,44,24,4,40
176009,2024-01-24 19:58:11,1326947618,335947,259,101,45,11,90
176011,2024-01-24 20:08:48,1326960400,8391,19,31,4,1,30
166201,2024-01-24 21:44:58,1327050169,26024,88,24,7,5,19
166200,2024-01-24 21:45:21,1327050455,38399,63,47,23,6,41
166202,2024-01-24 21:45:52,1327050831,23064,66,34,16,4,30
166203,2024-01-24 21:46:09,1327051051,1482,16,26,16,1,25
166207,2024-01-24 21:46:22,1327051203,1762,8,33,7,1,32
156738,2024-01-24 21:51:23,1327055123,49154,205,81,40,12,69
156603,2024-01-24 21:51:35,1327055270,0,0,13,3,0,13
156117,2024-01-24 21:52:05,1327055642,0,1,13,6,0,13
156616,2024-01-24 21:52:37,1327056006,0,1,24,3,0,24
156731,2024-01-24 21:52:58,1327056250,0,24,48,27,0,48
176025,2024-01-24 21:54:03,1327057253,8884,59,27,6,5,22
120469,2024-01-24 21:59:30,1327061503,100305,69,11,8,3,8
120470,2024-01-24 22:00:08,1327061985,256426,40,10,2,4,6
120410,2024-01-24 22:00:25,1327062191,101215,87,29,17,3,26
176029,2024-01-24 22:25:25,1327080405,66075,146,58,38,10,48
176003,2024-01-24 23:06:08,1327110089,86628,75,11,5,5,6
175910,2024-01-24 23:24:42,1327123942,4073,5,3,1,1,2
176044,2024-01-25 14:44:53,1327352121,49288,105,104,54,6,98
176039,2024-01-25 15:14:23,1327364939,422,21,5,0,2,3
176054,2024-01-25 15:42:16,1327380230,42364,221,37,8,3,34
176055,2024-01-25 15:43:18,1327380857,31952,152,26,7,1,25
176056,2024-01-25 15:43:21,1327380881,57742,147,46,37,6,40
176057,2024-01-25 15:49:21,1327384607,26864,61,6,5,4,2
176027,2024-01-25 16:02:54,1327393618,12528,206,53,36,1,52
166626,2024-01-25 16:30:49,1327413509,759,13,32,23,2,30
166158,2024-01-25 16:31:23,1327413935,19991,47,64,18,5,59
166308,2024-01-25 16:31:46,1327414208,67557,340,63,35,18,45
166309,2024-01-25 16:32:09,1327414490,56931,146,60,22,7,53
166327,2024-01-25 16:32:30,1327414692,115551,267,79,29,26,53
157611,2024-01-25 16:40:51,1327420797,78308,145,69,33,2,67
157362,2024-01-25 16:41:18,1327421151,7070,69,13,7,3,10
157609,2024-01-25 16:41:43,1327421511,77540,79,99,53,5,94
157612,2024-01-25 16:42:05,1327421822,68521,93,22,8,5,17
157363,2024-01-25 16:42:37,1327422226,60630,61,54,47,4,50
157613,2024-01-25 16:43:02,1327422502,115634,167,59,40,5,54
176063,2024-01-25 17:07:27,1327441240,17509,111,28,12,9,19
176064,2024-01-25 17:23:02,1327453747,0,0,1,1,0,1
176070,2024-01-25 17:45:41,1327471706,13839,32,53,17,2,51
144021,2024-01-25 17:54:38,1327478871,192072,76,27,20,5,22
151817,2024-01-25 17:58:33,1327481979,6014,219,17,6,3,14
176069,2024-01-25 17:58:59,1327482292,156277,311,559,48,16,543
156365,2024-01-25 17:59:22,1327482679,3455,27,36,17,2,34
156460,2024-01-25 17:59:59,1327483135,4195,30,38,24,2,36
166130,2024-01-25 18:00:28,1327483554,1090,4,9,2,1,8
176073,2024-01-25 18:10:00,1327491185,6579,86,47,1,1,46
176072,2024-01-25 18:20:34,1327500492,578989,150,21,15,10,11
95704,2024-01-25 18:26:02,1327504977,28572,84,62,23,5,57
176080,2024-01-25 18:32:00,1327509857,18762,35,9,6,3,6
176088,2024-01-25 18:40:28,1327516907,910,12,10,4,1,9
176092,2024-01-25 19:38:49,1327561214,5080,45,26,14,3,23
107986,2024-01-25 19:52:30,1327573051,221280,308,103,53,17,86
116265,2024-01-25 19:52:56,1327573428,83972,76,20,11,4,16
147198,2024-01-25 19:53:15,1327573707,59718,30,11,8,6,5
147001,2024-01-25 19:54:25,1327574667,11471,33,15,7,3,12
107998,2024-01-25 19:55:02,1327575164,48518,186,72,41,4,68
107998,2024-01-25 19:55:05,1327575199,48518,186,72,41,4,68
176095,2024-01-25 20:22:00,1327597315,95176,227,31,18,4,27
176097,2024-01-25 21:21:48,1327642650,89471,109,20,11,6,14
176098,2024-01-25 21:53:14,1327665946,74852,282,36,17,8,28
147991,2024-01-25 22:16:40,1327682876,19739,44,40,29,4,36
97650,2024-01-25 22:19:25,1327684843,25038,43,44,21,3,41
107979,2024-01-25 22:19:58,1327685181,23717,68,96,15,8,88
153516,2024-01-25 23:19:26,1327726024,55766,90,138,77,6,132
153544,2024-01-25 23:19:44,1327726230,121820,162,127,53,15,112
153545,2024-01-25 23:20:01,1327726398,13122,130,434,102,8,426
153584,2024-01-25 23:20:49,1327726971,32140,46,127,57,3,124
176144,2024-01-26 16:13:55,1328148010,59525,263,32,17,9,23
176152,2024-01-26 16:43:49,1328169566,39712,72,18,10,7,11
176155,2024-01-26 17:06:59,1328186428,36352,40,40,23,1,39
176158,2024-01-26 17:39:58,1328212108,0,144,17,8,0,17
176159,2024-01-26 17:46:07,1328217049,0,53,9,3,0,9
176168,2024-01-26 18:10:03,1328236134,15305,98,13,2,3,10
176177,2024-01-26 18:16:38,1328241584,96559,10,5,4,1,4
176166,2024-01-26 18:21:05,1328245236,6478,9,38,14,1,37
176157,2024-01-26 18:31:05,1328253075,65310,14,25,8,3,22
176180,2024-01-26 18:39:55,1328260155,26417,38,3,0,3,0
176182,2024-01-26 19:03:56,1328279305,4024,20,8,3,4,4
129403,2024-01-26 19:07:03,1328281816,9418,301,106,26,1,105
176187,2024-01-26 19:35:48,1328304618,2824,86,123,46,2,121
176188,2024-01-26 19:45:32,1328312330,61682,55,43,21,5,38
176197,2024-01-26 20:16:15,1328336354,17637,57,83,42,4,79
176198,2024-01-26 20:24:40,1328342967,28225,28,41,25,1,40
176210,2024-01-26 22:17:16,1328427302,10281,97,6,4,2,4
176215,2024-01-26 23:00:21,1328483455,24495,87,55,29,5,50
176216,2024-01-26 23:00:49,1328484330,0,0,4,1,0,4
176230,2024-01-27 15:21:34,1328731677,151497,83,93,35,5,88
121959,2024-01-27 15:30:26,1328734681,26287,50,47,36,3,44
167587,2024-01-27 18:45:47,1328829514,963,14,56,13,4,52
167726,2024-01-27 18:46:13,1328829776,24392,39,10,7,5,5
167586,2024-01-27 18:47:06,1328830327,3229,8,3,0,1,2
167583,2024-01-27 18:47:27,1328830496,622,3,6,1,1,5
176244,2024-01-29 14:32:29,1329561054,1754,11,3,2,1,2
176255,2024-01-29 15:15:52,1329578239,41072,98,141,65,6,135
161080,2024-01-29 15:17:32,1329579042,21550,214,180,97,5,175
161050,2024-01-29 15:17:53,1329579229,263878,209,223,115,5,218
161049,2024-01-29 15:18:14,1329579414,2232,107,152,90,2,150
161051,2024-01-29 15:18:33,1329579564,88428,92,136,78,5,131
161060,2024-01-29 15:18:55,1329579758,145117,64,29,17,4,25
176258,2024-01-29 15:38:21,1329590759,203920,250,81,51,18,63
176249,2024-01-29 15:44:35,1329594565,19025,35,23,12,6,17
176259,2024-01-29 15:51:19,1329598851,7740,42,75,48,1,74
164759,2024-01-29 15:53:58,1329600509,450,4,8,6,1,7
164524,2024-01-29 15:55:14,1329601339,12896,32,11,3,3,8
164795,2024-01-29 15:55:36,1329601599,39613,197,39,19,8,31
164375,2024-01-29 15:55:56,1329601815,12504,43,69,45,5,64
164376,2024-01-29 15:56:13,1329602045,1081,14,18,7,2,16
176261,2024-01-29 16:25:12,1329622505,29230,74,17,9,4,13
114752,2024-01-29 16:28:38,1329625062,1958,54,48,14,3,45
114745,2024-01-29 16:29:09,1329625431,2035,44,28,14,2,26
137404,2024-01-29 16:35:55,1329630459,7475,12,14,9,1,13
147260,2024-01-29 16:36:18,1329630782,0,1,23,22,0,23
155265,2024-01-29 16:36:49,1329631163,45843,117,34,14,4,30
176265,2024-01-29 16:37:16,1329631523,5214,20,18,15,1,17
176269,2024-01-29 17:53:47,1329698508,128509,132,42,9,10,32
176267,2024-01-29 18:52:41,1329749809,0,0,2,0,0,2
176270,2024-01-29 19:01:42,1329757848,9856,98,28,4,6,22
176318,2024-01-29 19:03:03,1329759005,23285,103,66,46,3,63
176271,2024-01-29 19:17:47,1329772058,1031,77,24,21,1,23
176320,2024-01-29 19:26:50,1329780017,16429,155,45,30,5,40
176324,2024-01-29 19:49:22,1329800272,0,0,3,2,0,3
176326,2024-01-29 20:00:40,1329810727,0,0,8,7,0,8
121898,2024-01-29 20:44:21,1329849527,154901,204,106,60,5,101
122171,2024-01-29 20:44:54,1329849994,6625,66,42,18,2,40
121900,2024-01-29 20:45:17,1329850344,0,4,72,40,0,72
121896,2024-01-29 20:45:36,1329850590,19548,7,117,70,1,116
156364,2024-01-29 20:46:05,1329851035,302,97,24,15,1,23
156387,2024-01-29 20:46:33,1329851434,0,0,5,1,0,5
176346,2024-01-29 21:37:32,1329896118,0,0,18,15,0,18
176344,2024-01-29 21:38:11,1329896703,29820,24,40,32,2,38
176348,2024-01-29 21:42:13,1329900406,10053,17,48,40,3,45
176349,2024-01-29 21:46:57,1329904590,4693,82,53,34,5,48
176335,2024-01-29 21:48:14,1329905761,0,0,2,1,0,2
176334,2024-01-29 21:48:28,1329905947,39562,99,70,24,10,60
176338,2024-01-29 21:48:36,1329906092,35672,143,19,8,3,16
176345,2024-01-29 21:48:48,1329906265,2445,12,5,1,3,2
176351,2024-01-29 21:48:53,1329906350,1495,13,12,6,1,11
176352,2024-01-29 21:49:18,1329906695,4544,39,60,35,1,59
176347,2024-01-29 21:49:22,1329906753,37681,123,25,5,3,22
176353,2024-01-29 21:55:24,1329912008,0,0,30,23,0,30
176356,2024-01-29 22:02:04,1329917797,0,21,168,51,0,168
161028,2024-01-29 22:12:10,1329926427,17795,35,58,48,2,56
176357,2024-01-29 22:12:51,1329927009,25598,21,36,16,3,33
176362,2024-01-29 22:24:38,1329936831,27901,231,29,11,4,25
158126,2024-01-29 22:32:48,1329944245,6951,19,33,25,2,31
157986,2024-01-29 22:33:15,1329944828,35770,197,17,4,11,6
158131,2024-01-29 22:33:39,1329945302,8947,11,8,4,1,7
157946,2024-01-29 22:34:20,1329946163,0,14,10,6,0,10
168086,2024-01-29 22:34:43,1329946613,3226,98,6,1,4,2
176374,2024-01-29 23:12:43,1329988103,24947,76,52,30,3,49
176375,2024-01-29 23:23:58,1329999165,11260,350,82,39,4,78
176364,2024-01-30 14:14:19,1330354852,3583,177,51,37,3,48
176387,2024-01-30 14:20:52,1330358619,10198,7,12,11,1,11
176373,2024-01-30 14:22:56,1330359833,38004,18,27,7,3,24
176377,2024-01-30 14:26:56,1330362211,0,0,11,3,0,11
100124,2024-01-30 14:37:28,1330368733,160270,140,71,42,13,58
131313,2024-01-30 14:37:30,1330368763,19438,19,16,6,9,7
176388,2024-01-30 14:49:29,1330376888,9132,79,20,4,6,14
176390,2024-01-30 15:03:11,1330386883,39712,72,18,10,7,11
176390,2024-01-30 15:03:14,1330386919,39712,72,18,10,7,11
176391,2024-01-30 15:06:04,1330388994,7461,25,23,8,2,21
176394,2024-01-30 15:23:16,1330398891,0,2,105,26,0,105
176396,2024-01-30 15:38:07,1330414182,17001,108,91,67,4,87
176397,2024-01-30 15:38:47,1330414723,12088,139,11,10,4,7
149237,2024-01-30 16:06:00,1330434777,0,0,50,37,0,50
176399,2024-01-30 16:06:01,1330434804,1309,4,10,4,2,8
149237,2024-01-30 16:06:03,1330434835,0,0,50,37,0,50
149252,2024-01-30 16:06:33,1330435297,4861,37,17,11,2,15
149253,2024-01-30 16:07:04,1330435811,19413,114,72,41,3,69
149236,2024-01-30 16:07:35,1330436259,18803,23,52,34,3,49
159607,2024-01-30 16:08:42,1330437404,0,0,32,19,0,32
176400,2024-01-30 16:11:37,1330440284,21074,87,25,9,5,20
176401,2024-01-30 16:15:52,1330444448,11467,214,66,34,7,59
176383,2024-01-30 16:18:29,1330447073,2553,28,29,19,2,27
176403,2024-01-30 16:21:03,1330449569,38748,35,30,14,8,22
176404,2024-01-30 16:27:47,1330456258,14706,64,39,11,6,33
176411,2024-01-30 16:35:16,1330463857,2095,2,6,3,1,5
176413,2024-01-30 16:45:54,1330474652,0,4,18,14,0,18
176431,2024-01-30 17:31:45,1330523998,2840,15,2,1,1,1
176434,2024-01-30 17:42:59,1330534063,108681,75,20,16,5,15
149557,2024-01-30 17:43:18,1330534327,14221,24,11,6,3,8
106672,2024-01-30 17:56:45,1330545376,166927,200,137,74,11,126
116671,2024-01-30 17:56:49,1330545426,30473,224,81,50,10,71
116671,2024-01-30 17:56:50,1330545453,30473,224,81,50,10,71
128184,2024-01-30 17:57:30,1330546013,5687,27,112,76,2,110
147785,2024-01-30 18:01:29,1330549488,49704,120,35,15,10,25
176436,2024-01-30 18:04:58,1330552407,17115,28,18,13,2,16
101065,2024-01-30 18:07:37,1330554545,29969,129,67,57,4,63
100273,2024-01-30 18:08:34,1330555321,271043,361,89,64,8,81
101050,2024-01-30 18:08:52,1330555591,42521,140,90,72,8,82
107161,2024-01-30 18:54:40,1330604770,4904,47,31,26,2,29
176443,2024-01-30 18:57:26,1330608101,74089,131,14,11,6,8
176446,2024-01-30 19:12:19,1330625109,334,34,94,68,1,93
176450,2024-01-30 19:44:13,1330661469,7070,19,24,15,2,22
122810,2024-01-30 19:49:27,1330667493,41670,141,71,58,8,63
159151,2024-01-30 19:50:38,1330668783,2960,13,31,17,1,30
148436,2024-01-30 19:51:33,1330669790,1444,65,37,8,2,35
176454,2024-01-30 20:02:16,1330682013,23816,116,5,3,3,2
105326,2024-01-30 20:05:28,1330685479,25727,40,43,23,2,41
105429,2024-01-30 20:05:56,1330686030,15764,50,12,3,2,10
166103,2024-01-30 20:49:30,1330729065,134386,189,122,77,12,110
166176,2024-01-30 20:50:21,1330730430,61218,80,63,42,5,58
166490,2024-01-30 20:51:24,1330732174,2914,11,46,5,1,45
176455,2024-01-30 21:03:55,1330751634,210967,178,29,14,8,21
176456,2024-01-30 21:04:08,1330752040,62903,46,36,12,2,34
176460,2024-01-30 21:05:04,1330753521,258,1,33,16,1,32
176464,2024-01-30 21:05:19,1330753952,213191,273,23,16,8,15
176479,2024-01-30 21:05:22,1330754052,0,0,2,2,0,2
176469,2024-01-30 21:05:33,1330754371,3038,14,12,3,1,11
176470,2024-01-30 21:05:42,1330754621,17199,68,24,14,4,20
176471,2024-01-30 21:12:32,1330765257,44462,60,27,12,5,22
176480,2024-01-30 21:19:16,1330775532,583349,32,19,4,3,16
176468,2024-01-30 21:21:56,1330779818,762,19,1,1,1,0
176481,2024-01-30 21:37:19,1330803801,8196,37,37,27,3,34
176482,2024-01-30 21:43:18,1330810342,0,1,19,15,0,19
176485,2024-01-30 22:38:05,1330863985,1401,1,5,2,1,4
176495,2024-01-30 22:40:07,1330866128,36863,167,53,33,8,45
176451,2024-01-30 22:41:03,1330867153,4052,11,3,1,1,2
176452,2024-01-30 22:41:12,1330867317,7034,26,24,15,2,22
176484,2024-01-31 15:05:14,1331260348,44554,165,22,9,4,18
176503,2024-01-31 15:22:31,1331268673,20895,230,53,26,6,47
157587,2024-01-31 15:37:40,1331277094,0,0,4,1,0,4
157261,2024-01-31 15:38:13,1331277387,5400,5,20,14,1,19
157527,2024-01-31 15:38:40,1331277634,12603,79,84,61,4,80
157132,2024-01-31 15:39:15,1331277928,20020,139,19,8,4,15
157586,2024-01-31 15:39:37,1331278144,96667,78,51,38,6,45
176523,2024-01-31 15:40:32,1331278692,75838,104,54,20,3,51
157509,2024-01-31 15:41:35,1331279272,292950,180,90,33,8,82
176538,2024-01-31 15:46:52,1331282414,0,10,35,30,0,35
176544,2024-01-31 16:19:45,1331303206,20118,487,51,19,9,42
176543,2024-01-31 16:21:54,1331304688,60328,75,20,10,5,15
176545,2024-01-31 16:22:08,1331304860,55577,67,9,3,3,6
159065,2024-01-31 16:33:23,1331312474,22190,49,36,29,5,31
158920,2024-01-31 16:33:42,1331312659,3109,20,11,8,2,9
159066,2024-01-31 16:34:03,1331312859,110503,104,51,39,7,44
159152,2024-01-31 16:34:25,1331313133,7730,24,10,7,1,9
159820,2024-01-31 16:34:49,1331313434,145626,200,26,13,4,22
176561,2024-01-31 17:29:14,1331353781,19892,48,32,13,8,24
176579,2024-01-31 18:12:20,1331393457,47046,107,37,23,7,30
158705,2024-01-31 18:20:13,1331401095,16961,32,21,12,4,17
176580,2024-01-31 20:05:10,1331493535,63378,116,51,24,7,44
176582,2024-01-31 20:05:17,1331493636,117142,103,32,28,9,23
176598,2024-01-31 20:05:24,1331493746,11772,104,5,3,2,3
176599,2024-01-31 20:05:33,1331493857,129118,176,15,10,8,7
176652,2024-01-31 22:22:04,1331609455,140499,221,32,19,9,23
176546,2024-01-31 22:32:09,1331617425,68070,103,12,7,6,6
176546,2024-01-31 22:54:05,1331634576,68070,103,12,7,6,6
176640,2024-01-31 22:56:54,1331636631,1377,4,10,9,1,9
176643,2024-01-31 22:59:30,1331638545,1980,4,4,1,1,3
176546,2024-01-31 23:42:40,1331737512,68070,103,12,7,6,6
176644,2024-01-31 23:45:19,1331744368,8418,29,62,29,2,60
176647,2024-01-31 23:47:17,1331749446,65741,53,25,21,4,21
176648,2024-01-31 23:53:16,1331764923,5259,35,89,53,2,87
176546,2024-01-31 23:57:33,1331774094,68070,103,12,7,6,6
176546,2024-01-31 23:59:57,1331776074,68070,103,12,7,6,6
176650,2024-02-01 00:36:58,1331819602,53153,134,57,34,7,50
166447,2024-02-01 15:38:59,1332242873,80669,134,74,45,8,66
166508,2024-02-01 15:39:22,1332243109,1110,15,48,20,1,47
176686,2024-02-01 15:48:35,1332252018,122766,143,122,81,6,116
176687,2024-02-01 15:57:34,1332261332,44916,179,94,24,17,77
104462,2024-02-01 16:20:45,1332286038,14998,46,43,34,2,41
176689,2024-02-01 16:29:50,1332296097,31915,61,27,14,6,21
176688,2024-02-01 16:29:53,1332296153,8371,18,28,19,3,25
123144,2024-02-01 17:49:46,1332376579,11400,64,48,34,3,45
143799,2024-02-01 17:50:16,1332376944,17210,102,18,6,6,12
176709,2024-02-01 17:58:43,1332383161,21351,373,85,42,7,78
176711,2024-02-01 18:25:36,1332404172,38361,274,71,39,11,60
167289,2024-02-01 18:59:38,1332430329,0,6,36,29,0,36
157675,2024-02-01 19:00:25,1332430932,3000,105,64,38,3,61
157662,2024-02-01 19:01:17,1332431548,0,35,60,43,0,60
157676,2024-02-01 19:02:08,1332432282,36469,85,14,8,5,9
157680,2024-02-01 19:02:52,1332432822,61603,130,60,28,7,53
157661,2024-02-01 19:03:44,1332433496,32089,190,72,46,5,67
157681,2024-02-01 19:05:09,1332434596,34135,173,52,35,5,47
157659,2024-02-01 19:06:04,1332435339,11162,99,59,43,2,57
157728,2024-02-01 19:06:52,1332435922,2938,143,164,65,4,160
157912,2024-02-01 19:07:46,1332436610,41592,68,71,45,2,69
176131,2024-02-01 20:23:35,1332494689,65979,45,33,29,2,31
145993,2024-02-01 20:37:38,1332504651,170815,84,51,43,6,45
122172,2024-02-01 20:38:27,1332505240,131249,105,134,89,10,124
122184,2024-02-01 20:38:52,1332505576,136034,144,141,84,15,126
158090,2024-02-01 20:39:18,1332505863,10439,13,37,29,3,34
158292,2024-02-01 20:39:47,1332506215,458,1,37,10,1,36
158625,2024-02-01 20:40:16,1332506576,175165,140,75,47,12,63
176720,2024-02-01 21:19:49,1332535550,0,0,1,0,0,1
176731,2024-02-01 23:05:06,1332607047,9945,3,5,0,1,4
176740,2024-02-02 14:57:22,1332848145,28951,84,54,37,6,48
176743,2024-02-02 15:24:56,1332859018,91789,138,60,36,6,54
176744,2024-02-02 15:24:57,1332859029,67330,144,45,24,7,38
176738,2024-02-02 16:18:33,1332886488,55625,66,38,30,5,33
176757,2024-02-02 18:28:27,1332973397,32131,23,45,38,2,43
176761,2024-02-02 19:10:16,1333003752,3093,25,31,25,2,29
176769,2024-02-02 19:20:51,1333011151,67352,187,55,17,11,44
149218,2024-02-02 19:37:07,1333022627,62381,90,52,24,6,46
149163,2024-02-02 19:37:41,1333022992,90828,131,61,33,10,51
149212,2024-02-02 19:38:13,1333023357,15055,103,26,12,2,24
176783,2024-02-02 20:48:58,1333071545,154448,431,64,45,7,57
176784,2024-02-02 20:52:55,1333074258,271698,34,58,39,3,55
176779,2024-02-02 21:05:06,1333082296,2063,22,52,20,2,50
169305,2024-02-02 21:08:24,1333084793,0,0,1,0,0,1
169305,2024-02-02 21:08:53,1333085293,0,0,1,0,0,1
169305,2024-02-02 21:14:57,1333091757,0,0,1,0,0,1
176780,2024-02-02 21:17:59,1333095005,6807,24,2,0,1,1
169305,2024-02-02 21:37:40,1333116452,0,0,1,0,0,1
176787,2024-02-02 21:48:30,1333131915,4969,17,101,70,1,100
176786,2024-02-02 22:34:05,1333188123,6357,21,14,8,2,12
176794,2024-02-02 22:43:03,1333193131,0,1,12,2,0,12
169305,2024-02-02 22:51:41,1333198101,0,0,1,0,0,1
149334,2024-02-02 22:53:54,1333199340,9876,171,77,22,9,68
169305,2024-02-02 22:53:55,1333199356,0,0,1,0,0,1
169305,2024-02-02 23:02:32,1333204380,0,0,1,0,0,1
169305,2024-02-02 23:05:32,1333205867,0,0,1,0,0,1
169305,2024-02-02 23:08:09,1333207196,0,0,1,0,0,1
176789,2024-02-03 00:08:58,1333237974,32567,100,121,78,6,115
169305,2024-02-03 04:42:25,1333351848,0,0,1,0,0,1
169305,2024-02-03 04:46:29,1333353407,0,0,1,0,0,1
169305,2024-02-03 04:51:54,1333355613,0,0,1,0,0,1
169305,2024-02-03 05:02:00,1333359302,0,0,1,0,0,1
169305,2024-02-03 05:22:18,1333365573,0,0,1,0,0,1
169305,2024-02-03 06:07:22,1333378653,0,0,1,0,0,1
169305,2024-02-03 06:09:23,1333379285,0,0,1,0,0,1
169305,2024-02-03 06:10:47,1333379751,0,0,1,0,0,1
169305,2024-02-03 06:28:23,1333384800,0,0,1,0,0,1
176789,2024-02-03 15:52:05,1333521651,32567,100,121,78,6,115
176795,2024-02-03 15:52:07,1333521674,142542,498,100,58,10,90
138908,2024-02-03 16:42:22,1333547846,39211,93,66,26,5,61
138908,2024-02-03 16:42:50,1333548106,39211,93,66,26,5,61
138908,2024-02-03 16:43:14,1333548352,39211,93,66,26,5,61
138908,2024-02-03 16:43:40,1333548621,39211,93,66,26,5,61
138912,2024-02-03 16:44:26,1333549031,10566,39,33,12,3,30
138912,2024-02-03 16:45:29,1333549621,10566,39,33,12,3,30
138910,2024-02-03 16:45:52,1333549830,2913,30,4,2,1,3
167882,2024-02-03 16:47:28,1333550708,16455,92,31,20,3,28
176806,2024-02-03 16:53:13,1333553854,281,3,8,1,1,7
75456,2024-02-03 17:19:55,1333569401,0,62,34,11,0,34
176807,2024-02-03 17:52:10,1333589699,65741,53,25,21,4,21
176807,2024-02-03 17:52:46,1333590101,65741,53,25,21,4,21
176809,2024-02-03 18:15:38,1333604701,5259,35,89,53,2,87
149288,2024-02-03 18:21:11,1333608300,8162,85,30,21,2,28
149358,2024-02-03 18:21:41,1333608583,32262,67,65,21,7,58
138907,2024-02-03 18:26:21,1333611623,19816,34,30,22,4,26
138911,2024-02-03 18:26:47,1333611906,14709,85,76,33,3,73
138911,2024-02-03 18:27:08,1333612141,14709,85,76,33,3,73
148781,2024-02-03 18:27:47,1333612525,27229,40,32,19,2,30
159297,2024-02-03 18:28:09,1333612742,215402,262,55,23,12,43
176810,2024-02-03 19:01:21,1333634890,8348,32,12,9,1,11
176800,2024-02-06 14:42:24,1334804889,9693,67,4,3,4,0
176800,2024-02-06 14:42:50,1334805012,9693,67,4,3,4,0
176800,2024-02-06 14:42:53,1334805029,9693,67,4,3,4,0
176800,2024-02-06 14:42:54,1334805038,9693,67,4,3,4,0
176800,2024-02-06 14:42:55,1334805047,9693,67,4,3,4,0
176800,2024-02-06 14:43:58,1334805411,9693,67,4,3,4,0
176800,2024-02-06 14:44:30,1334805589,9693,67,4,3,4,0
176800,2024-02-06 14:44:34,1334805616,9693,67,4,3,4,0
176800,2024-02-06 14:44:35,1334805619,9693,67,4,3,4,0
176847,2024-02-06 15:00:58,1334811632,35561,99,40,15,5,35
176847,2024-02-06 15:01:57,1334812045,35561,99,40,15,5,35
176847,2024-02-06 15:02:09,1334812137,35561,99,40,15,5,35
176848,2024-02-06 15:33:50,1334827372,95606,89,57,30,4,53
176848,2024-02-06 15:34:45,1334827854,95606,89,57,30,4,53
176848,2024-02-06 15:35:19,1334828188,95606,89,57,30,4,53
176862,2024-02-06 16:18:22,1334855239,9092,19,7,5,1,6
176862,2024-02-06 16:19:15,1334855873,9092,19,7,5,1,6
158789,2024-02-06 17:29:38,1334909106,6813,70,15,5,4,11
158787,2024-02-06 17:31:06,1334910290,22431,196,47,26,4,43
158785,2024-02-06 17:31:40,1334910778,17162,92,52,23,5,47
158782,2024-02-06 17:33:13,1334912048,9594,29,45,16,3,42
159000,2024-02-06 17:33:49,1334912554,39696,52,32,19,2,30
158784,2024-02-06 17:37:08,1334915230,74372,153,181,25,5,176
158882,2024-02-06 17:41:56,1334919178,60647,179,51,28,5,46
176864,2024-02-06 17:42:39,1334919786,265165,171,62,42,11,51
176865,2024-02-06 17:42:47,1334919901,7962,43,6,0,2,4
176864,2024-02-06 17:42:58,1334920019,265165,171,62,42,11,51
176865,2024-02-06 17:42:59,1334920049,7962,43,6,0,2,4
168088,2024-02-06 17:44:01,1334920849,25248,83,82,22,6,76
176865,2024-02-06 17:44:28,1334921230,7962,43,6,0,2,4
176864,2024-02-06 17:44:41,1334921418,265165,171,62,42,11,51
119122,2024-02-06 17:54:26,1334929545,89932,47,17,7,7,10
157407,2024-02-06 17:56:33,1334931414,74633,181,32,18,6,26
168089,2024-02-06 17:58:10,1334932867,21145,60,35,22,4,31
157371,2024-02-06 17:58:29,1334933117,43613,68,25,11,8,17
176881,2024-02-06 18:01:00,1334935289,119275,101,82,62,4,78
176879,2024-02-06 18:02:36,1334936549,6448,17,14,10,3,11
176882,2024-02-06 18:03:14,1334937087,62551,81,59,35,8,51
176867,2024-02-06 18:03:29,1334937274,4867,1,2,2,1,1
176867,2024-02-06 18:04:47,1334938359,4867,1,2,2,1,1
176882,2024-02-06 18:04:51,1334938401,62551,81,59,35,8,51
176867,2024-02-06 18:04:54,1334938460,4867,1,2,2,1,1
176867,2024-02-06 18:04:57,1334938496,4867,1,2,2,1,1
176867,2024-02-06 18:05:16,1334938777,4867,1,2,2,1,1
176878,2024-02-06 18:06:17,1334939566,10609,81,46,19,4,42
176876,2024-02-06 18:06:51,1334940038,0,2,12,10,0,12
176876,2024-02-06 18:07:43,1334940798,0,2,12,10,0,12
176877,2024-02-06 18:08:57,1334941853,90505,188,57,18,10,47
176877,2024-02-06 18:09:22,1334942193,90505,188,57,18,10,47
176877,2024-02-06 18:10:08,1334942849,90505,188,57,18,10,47
176894,2024-02-06 18:39:18,1334967075,33086,38,24,16,5,19
176893,2024-02-06 18:41:08,1334968665,8921,88,31,23,3,28
176893,2024-02-06 18:41:20,1334968842,8921,88,31,23,3,28
176893,2024-02-06 18:42:29,1334969850,8921,88,31,23,3,28
176893,2024-02-06 18:42:32,1334969903,8921,88,31,23,3,28
176897,2024-02-06 19:06:47,1334989677,113589,153,90,63,10,80
176897,2024-02-06 19:06:54,1334989762,113589,153,90,63,10,80
176897,2024-02-06 19:07:38,1334990362,113589,153,90,63,10,80
176897,2024-02-06 19:08:06,1334990692,113589,153,90,63,10,80
176898,2024-02-06 19:28:27,1335007190,60625,172,94,60,8,86
176898,2024-02-06 19:28:39,1335007362,60625,172,94,60,8,86
176898,2024-02-06 19:28:47,1335007458,60625,172,94,60,8,86
176909,2024-02-06 19:59:19,1335032199,28735,58,48,39,4,44
176909,2024-02-06 20:00:14,1335032895,28735,58,48,39,4,44
176911,2024-02-06 20:09:36,1335040497,82982,201,153,115,11,142
176911,2024-02-06 20:10:55,1335041600,82982,201,153,115,11,142
85209,2024-02-06 20:58:13,1335097454,77546,77,21,3,3,18
85209,2024-02-06 20:59:19,1335099667,77546,77,21,3,3,18
176918,2024-02-06 21:08:57,1335118853,10,2,1,0,1,0
176920,2024-02-06 21:28:00,1335159180,19924,16,1,0,1,0
176920,2024-02-06 21:28:22,1335159931,19924,16,1,0,1,0
176921,2024-02-06 21:33:58,1335165353,1030,3,8,5,1,7
158128,2024-02-06 21:43:22,1335172568,740,26,21,13,1,20
157602,2024-02-06 21:43:25,1335172599,14142,88,11,6,3,8
157719,2024-02-06 21:43:28,1335172638,24149,62,69,35,4,65
158022,2024-02-06 21:43:31,1335172683,0,12,22,19,0,22
167337,2024-02-06 21:43:34,1335172722,15691,44,25,18,5,20
176923,2024-02-06 21:44:57,1335173649,106757,255,29,13,9,20
157598,2024-02-06 21:45:02,1335173762,7011,297,38,19,3,35
157598,2024-02-06 21:45:32,1335174147,7011,297,38,19,3,35
176925,2024-02-06 21:52:50,1335179761,1148,17,48,28,1,47
176931,2024-02-06 22:27:03,1335206195,24059,66,38,26,6,32
176935,2024-02-06 22:48:38,1335222770,5613,27,11,8,2,9
176937,2024-02-06 22:51:31,1335225016,41599,271,38,12,6,32
176938,2024-02-06 22:58:37,1335230283,13860,187,53,45,6,47
162089,2024-02-09 18:03:11,1336879286,49666,101,55,31,10,45
162220,2024-02-09 18:04:16,1336880082,5220,42,63,46,3,60
162317,2024-02-09 18:05:01,1336880639,3065,27,21,12,2,19
162317,2024-02-09 18:05:40,1336881130,3065,27,21,12,2,19
162317,2024-02-09 18:06:19,1336881634,3065,27,21,12,2,19
148600,2024-02-09 18:16:46,1336889739,73316,73,37,16,6,31
177199,2024-02-09 18:22:38,1336894206,11200,10,5,2,2,3
144427,2024-02-09 18:22:49,1336894313,13981,279,115,51,7,108
144427,2024-02-09 18:23:04,1336894507,13981,279,115,51,7,108
177219,2024-02-09 18:44:48,1336911605,926,7,2,1,1,1
177218,2024-02-09 18:47:18,1336913517,177037,146,50,36,9,41
177218,2024-02-09 18:47:36,1336913738,177037,146,50,36,9,41
177218,2024-02-09 18:48:39,1336914566,177037,146,50,36,9,41
177218,2024-02-09 18:49:09,1336914978,177037,146,50,36,9,41
177217,2024-02-09 18:56:09,1336920282,63631,15,25,8,3,22
166645,2024-02-09 18:58:41,1336922101,59460,75,81,19,7,74
166549,2024-02-09 19:00:56,1336923778,96695,168,43,19,5,38
166613,2024-02-09 19:02:44,1336925028,1748,2,13,6,1,12
166984,2024-02-09 19:07:30,1336928708,6408,63,46,31,2,44
166551,2024-02-09 19:09:13,1336930126,0,66,7,3,0,7
177222,2024-02-09 19:22:41,1336940624,82283,37,9,3,4,5
112473,2024-02-09 19:26:24,1336943478,37881,310,82,50,6,76
177176,2024-02-09 19:31:28,1336947176,63014,158,21,7,7,14
177223,2024-02-09 19:54:10,1336964204,4303,9,19,15,1,18
177226,2024-02-09 19:55:01,1336964829,17447,25,29,18,3,26
177226,2024-02-09 19:55:11,1336964973,17447,25,29,18,3,26
177226,2024-02-09 19:55:45,1336965438,17447,25,29,18,3,26
177226,2024-02-09 19:56:21,1336965881,17447,25,29,18,3,26
177225,2024-02-09 19:57:27,1336966680,41369,100,33,19,7,26
177226,2024-02-09 19:57:31,1336966740,17447,25,29,18,3,26
177227,2024-02-09 20:03:51,1336971466,27754,141,22,5,5,17
177225,2024-02-09 20:07:05,1336973862,41369,100,33,19,7,26
177234,2024-02-09 20:27:41,1336988970,38644,189,65,33,13,52
177242,2024-02-09 20:56:30,1337009729,1539,35,4,2,1,3
177244,2024-02-09 21:11:13,1337020096,12041,26,37,31,3,34
177244,2024-02-09 21:11:36,1337020356,12041,26,37,31,3,34
177246,2024-02-09 21:29:10,1337032888,55248,28,8,1,2,6
177246,2024-02-09 21:30:09,1337033571,55248,28,8,1,2,6
177246,2024-02-09 21:30:27,1337033778,55248,28,8,1,2,6
177246,2024-02-09 21:30:37,1337033881,55248,28,8,1,2,6
177253,2024-02-09 21:53:34,1337049948,5550,59,2,1,1,1
177255,2024-02-09 22:14:35,1337064573,18648,108,33,24,4,29
177229,2024-02-09 22:41:09,1337081685,23232,75,74,44,4,70
177230,2024-02-09 22:41:21,1337081809,9634,205,45,21,1,44
177231,2024-02-09 22:41:24,1337081858,8010,22,95,71,2,93
177232,2024-02-09 22:41:40,1337082031,6487,39,75,48,2,73
177233,2024-02-09 22:41:49,1337082139,8019,347,57,29,5,52
124746,2024-02-10 00:53:27,1337159346,15782,176,179,51,9,170
147029,2024-02-10 00:53:29,1337159367,1412,23,30,18,2,28
101066,2024-02-10 00:53:31,1337159384,3495,16,90,40,1,89
177256,2024-02-10 14:36:59,1337368892,69825,35,22,13,5,17
177036,2024-02-10 14:42:09,1337370267,1278,7,8,0,1,7
177043,2024-02-10 14:42:23,1337370335,1124,9,28,5,1,27
177036,2024-02-10 14:42:59,1337370499,1278,7,8,0,1,7
177043,2024-02-10 14:43:54,1337370748,1124,9,28,5,1,27
177043,2024-02-10 14:45:01,1337371064,1124,9,28,5,1,27
177292,2024-02-10 15:27:46,1337384435,24632,87,13,11,4,9
177293,2024-02-10 16:05:42,1337400218,31474,50,22,9,4,18
177294,2024-02-10 16:05:49,1337400271,119171,76,36,28,5,31
177299,2024-02-10 17:54:27,1337459126,9801,49,29,21,1,28
101697,2024-02-10 18:32:04,1337482317,13701,50,24,16,3,21
101711,2024-02-10 18:32:47,1337482733,30920,63,49,32,5,44
101697,2024-02-10 18:32:50,1337482756,13701,50,24,16,3,21
144958,2024-02-10 18:33:13,1337482986,7181,73,68,32,2,66
177301,2024-02-10 18:33:47,1337483341,23427,185,23,7,3,20
177304,2024-02-10 18:34:25,1337483734,12982,7,24,16,4,20
177306,2024-02-10 18:34:34,1337483816,5555,14,10,7,1,9
177307,2024-02-10 18:34:44,1337483900,33635,14,20,11,3,17
177308,2024-02-10 18:34:50,1337483949,4333,8,7,2,2,5
101711,2024-02-10 19:21:44,1337513666,30920,63,49,32,5,44
101711,2024-02-10 19:21:58,1337513806,30920,63,49,32,5,44
177319,2024-02-12 14:22:03,1338259010,114346,144,32,14,9,23
177319,2024-02-12 14:22:23,1338259076,114346,144,32,14,9,23
177319,2024-02-12 14:23:05,1338259232,114346,144,32,14,9,23
177322,2024-02-12 14:41:18,1338264122,38981,88,48,15,6,42
177317,2024-02-12 15:03:54,1338271505,120933,311,42,23,14,28
177328,2024-02-12 15:44:48,1338290884,0,0,29,17,0,29
177331,2024-02-12 16:01:44,1338300465,20955,104,25,17,5,20
177334,2024-02-12 16:16:54,1338309874,43457,306,30,6,10,20
177336,2024-02-12 16:19:41,1338311737,46008,599,140,11,17,123
177332,2024-02-12 16:22:24,1338313613,88168,74,47,18,3,44
177333,2024-02-12 16:23:43,1338314502,8289,100,26,5,7,19
177335,2024-02-12 16:31:43,1338320017,18387,90,23,19,4,19
177335,2024-02-12 16:32:02,1338320228,18387,90,23,19,4,19
177337,2024-02-12 16:32:18,1338320413,27783,153,30,21,6,24
177338,2024-02-12 16:34:12,1338321654,8003,24,16,5,1,15
177339,2024-02-12 16:38:54,1338324970,2055,41,50,6,1,49
177342,2024-02-12 17:03:12,1338341862,7181,73,68,32,2,66
177343,2024-02-12 17:04:53,1338343127,89579,172,67,53,13,54
177344,2024-02-12 17:04:57,1338343192,23735,64,6,4,4,2
177345,2024-02-12 17:05:11,1338343367,30920,63,49,32,5,44
177346,2024-02-12 17:05:21,1338343479,13701,50,24,16,3,21
177343,2024-02-12 17:06:32,1338344327,89579,172,67,53,13,54
177344,2024-02-12 17:06:38,1338344432,23735,64,6,4,4,2
177344,2024-02-12 17:07:15,1338344873,23735,64,6,4,4,2
177347,2024-02-12 17:07:26,1338344981,135896,189,77,36,8,69
177348,2024-02-12 17:31:24,1338363624,12609,61,23,19,2,21
177348,2024-02-12 17:31:36,1338363777,12609,61,23,19,2,21
177349,2024-02-12 17:31:53,1338363982,41299,160,76,27,7,69
177350,2024-02-12 17:32:02,1338364110,68526,96,97,71,56,41
159500,2024-02-12 18:10:55,1338395793,73213,272,73,44,9,64
159509,2024-02-12 18:11:21,1338396160,95837,30,103,60,4,99
159549,2024-02-12 18:12:03,1338396702,44985,34,115,75,4,111
159502,2024-02-12 18:14:21,1338398583,4,6,18,10,1,17
159510,2024-02-12 18:14:41,1338398865,27859,51,23,15,3,20
159507,2024-02-12 18:17:06,1338400951,12517,46,32,12,4,28
159499,2024-02-12 18:17:30,1338401258,47508,40,82,54,4,78
159501,2024-02-12 18:44:07,1338423053,49255,156,37,13,6,31
159558,2024-02-12 18:44:56,1338423741,30238,107,14,9,2,12
159557,2024-02-12 18:47:52,1338426032,9496,25,38,24,3,35
159505,2024-02-12 18:51:10,1338428838,0,1,19,11,0,19
177384,2024-02-12 19:16:01,1338449293,28436,163,222,39,3,219
177384,2024-02-12 19:16:51,1338449955,28436,163,222,39,3,219
177371,2024-02-12 19:21:31,1338453750,5072,2,10,1,1,9
177385,2024-02-12 19:22:11,1338454233,61361,126,17,10,6,11
177393,2024-02-12 19:22:18,1338454358,22266,19,28,11,2,26
177392,2024-02-12 19:32:49,1338462710,144671,409,37,19,10,27
177392,2024-02-12 19:33:01,1338462852,144671,409,37,19,10,27
177392,2024-02-12 19:33:32,1338463274,144671,409,37,19,10,27
177392,2024-02-12 19:33:51,1338463523,144671,409,37,19,10,27
177392,2024-02-12 19:34:06,1338463749,144671,409,37,19,10,27
177392,2024-02-12 19:34:34,1338464151,144671,409,37,19,10,27
177392,2024-02-12 19:34:42,1338464251,144671,409,37,19,10,27
175090,2024-02-12 19:47:05,1338474545,134204,226,73,22,13,60
175090,2024-02-12 19:47:38,1338474989,134204,226,73,22,13,60
177399,2024-02-12 19:55:52,1338481867,8584,87,16,11,3,13
177377,2024-02-12 20:13:07,1338495719,0,0,3,0,0,3
177378,2024-02-12 20:13:13,1338495806,63,6,12,9,1,11
177379,2024-02-12 20:13:23,1338495936,33577,114,22,11,3,19
177380,2024-02-12 20:13:34,1338496072,849,44,44,19,2,42
177381,2024-02-12 20:13:41,1338496156,0,27,29,23,0,29
177407,2024-02-12 20:13:53,1338496324,59338,55,16,12,3,13
177382,2024-02-12 20:15:11,1338497298,0,28,67,46,0,67
177387,2024-02-12 20:15:41,1338497734,1971,21,53,27,3,50
177388,2024-02-12 20:16:13,1338498111,305,6,15,8,1,14
177389,2024-02-12 20:16:28,1338498299,0,65,45,1,0,45
177390,2024-02-12 20:16:41,1338498472,154161,116,50,24,6,44
177391,2024-02-12 20:16:56,1338498629,66160,190,61,8,8,53
177378,2024-02-12 20:17:57,1338499398,63,6,12,9,1,11
177379,2024-02-12 20:18:02,1338499486,33577,114,22,11,3,19
177388,2024-02-12 20:18:43,1338500066,305,6,15,8,1,14
177391,2024-02-12 20:19:41,1338500802,66160,190,61,8,8,53
177390,2024-02-12 20:21:14,1338501999,154161,116,50,24,6,44
177406,2024-02-12 20:30:15,1338509375,4802,6,13,9,1,12
177406,2024-02-12 20:30:34,1338509618,4802,6,13,9,1,12
177380,2024-02-12 21:44:45,1338567071,849,44,44,19,2,42
177424,2024-02-12 22:22:41,1338595884,0,0,5,4,0,5
177425,2024-02-12 22:22:48,1338595940,50560,80,73,20,17,56
177426,2024-02-12 22:22:53,1338596014,6375,110,40,9,5,35
177427,2024-02-12 22:23:02,1338596061,192340,255,128,71,10,118
177428,2024-02-12 22:24:56,1338597545,52344,208,57,38,6,51
177425,2024-02-12 22:31:03,1338601861,50560,80,73,20,17,56
177427,2024-02-12 22:31:16,1338602013,192340,255,128,71,10,118
177422,2024-02-12 22:49:13,1338615045,37503,59,28,19,3,25
177436,2024-02-12 23:13:25,1338632645,45685,12,8,3,1,7
177437,2024-02-13 13:57:03,1339128262,1678,21,20,2,2,18
177435,2024-02-13 15:26:18,1339157425,13359,22,14,9,3,11
177438,2024-02-13 15:27:22,1339157948,1371,7,3,3,1,2
177450,2024-02-13 15:27:38,1339158075,59503,305,59,20,18,41
177450,2024-02-13 15:28:37,1339158521,59503,305,59,20,18,41
177438,2024-02-13 15:28:54,1339158646,1371,7,3,3,1,2
177431,2024-02-13 16:05:43,1339179556,218222,189,37,30,8,29
177431,2024-02-13 16:06:06,1339179786,218222,189,37,30,8,29
177489,2024-02-13 17:30:05,1339241018,33919,169,36,17,5,31
177489,2024-02-13 17:30:46,1339241581,33919,169,36,17,5,31
177484,2024-02-13 18:24:16,1339285368,34985,135,100,71,5,95
177485,2024-02-13 18:24:26,1339285512,50419,98,25,19,7,18
177486,2024-02-13 18:24:37,1339285673,258438,253,113,78,17,96
177487,2024-02-13 18:24:45,1339285806,27476,50,33,31,2,31
177488,2024-02-13 18:26:19,1339287019,0,7,21,11,0,21
177493,2024-02-13 18:54:51,1339309990,3075,26,25,5,2,23
177520,2024-02-13 19:25:04,1339333863,3071,51,11,5,1,10
177494,2024-02-13 19:43:21,1339347960,7583,91,28,17,6,22
177494,2024-02-13 19:43:57,1339348434,7583,91,28,17,6,22
177526,2024-02-13 19:46:14,1339350275,0,0,13,10,0,13
177527,2024-02-13 19:46:19,1339350338,0,110,7,4,0,7
177528,2024-02-13 19:46:24,1339350421,20661,86,19,10,4,15
177529,2024-02-13 19:46:31,1339350501,40507,22,49,21,1,48
177530,2024-02-13 19:46:40,1339350618,16576,294,37,16,4,33
177531,2024-02-13 19:47:10,1339350972,7997,30,118,73,5,113
177526,2024-02-13 20:10:37,1339368707,0,0,13,10,0,13
177529,2024-02-13 20:10:52,1339368888,40507,22,49,21,1,48
177509,2024-02-13 20:21:26,1339376662,78044,136,14,6,3,11
177510,2024-02-13 20:21:31,1339376716,138749,246,70,17,8,62
177511,2024-02-13 20:21:38,1339376808,105314,328,34,10,7,27
177512,2024-02-13 20:21:45,1339376901,5600,78,5,2,1,4
177513,2024-02-13 20:21:52,1339376973,0,26,5,1,0,5
177509,2024-02-13 20:23:05,1339377888,78044,136,14,6,3,11
177511,2024-02-13 20:23:30,1339378193,105314,328,34,10,7,27
177538,2024-02-13 20:48:08,1339396134,9559,28,11,7,5,6
177540,2024-02-13 20:51:43,1339398663,0,0,7,7,0,7
177543,2024-02-13 20:52:13,1339399038,1173,71,18,5,3,15
177540,2024-02-13 20:52:37,1339399288,0,0,7,7,0,7
177540,2024-02-13 20:52:45,1339399378,0,0,7,7,0,7
177543,2024-02-13 20:57:42,1339403058,1173,71,18,5,3,15
177543,2024-02-13 20:58:21,1339403510,1173,71,18,5,3,15
177543,2024-02-13 20:58:52,1339403909,1173,71,18,5,3,15
177545,2024-02-13 21:22:58,1339421353,0,0,13,7,0,13
177521,2024-02-13 22:32:31,1339472742,77164,96,53,44,6,47
177524,2024-02-13 22:32:42,1339472888,129926,251,68,47,10,58
177522,2024-02-13 22:36:23,1339475427,10661,5,35,30,1,34
177521,2024-02-13 22:36:26,1339475453,77164,96,53,44,6,47
177557,2024-02-13 23:21:09,1339505584,18623,54,10,4,3,7
177557,2024-02-13 23:22:25,1339506470,18623,54,10,4,3,7
177559,2024-02-13 23:35:42,1339515245,52818,184,17,10,8,9
149164,2024-02-13 23:59:40,1339530915,31137,78,40,17,2,38
149164,2024-02-14 00:00:03,1339531155,31137,78,40,17,2,38
149164,2024-02-14 00:00:31,1339531453,31137,78,40,17,2,38
177564,2024-02-14 15:02:58,1339746311,2993,13,33,8,2,31
167537,2024-02-14 15:38:02,1339762115,90421,257,66,32,9,57
167537,2024-02-14 15:38:20,1339762286,90421,257,66,32,9,57
167530,2024-02-14 15:50:09,1339768520,45822,51,98,40,4,94
167528,2024-02-14 15:52:52,1339769899,0,0,16,2,0,16
167538,2024-02-14 15:53:10,1339770090,4880,0,21,6,1,20
177566,2024-02-14 16:02:03,1339775098,150131,93,70,35,2,68
177571,2024-02-14 16:24:25,1339788892,4183,159,28,18,1,27
177571,2024-02-14 16:25:04,1339789317,4183,159,28,18,1,27
177567,2024-02-14 16:27:26,1339790905,33398,16,19,12,1,18
177567,2024-02-14 16:27:52,1339791126,33398,16,19,12,1,18
177601,2024-02-14 16:43:30,1339801058,8993,111,14,11,2,12
177599,2024-02-14 17:06:02,1339816511,194,22,58,36,1,57
177603,2024-02-14 17:48:41,1339846635,1869,10,8,5,1,7
177604,2024-02-14 17:48:51,1339846759,130523,33,46,30,2,44
177605,2024-02-14 17:49:04,1339846903,0,0,20,18,0,20
177606,2024-02-14 17:49:18,1339847057,10613,5,50,29,1,49
177607,2024-02-14 17:49:27,1339847165,15341,90,35,26,12,23
177625,2024-02-14 18:37:11,1339881911,7471,8,24,13,2,22
149165,2024-02-14 18:44:33,1339887396,4944,7,6,2,2,4
149182,2024-02-14 18:44:49,1339887611,11858,117,30,19,3,27
149362,2024-02-14 18:45:08,1339887894,1251,26,12,2,1,11
149363,2024-02-14 18:45:28,1339888139,24473,76,58,38,7,51
177626,2024-02-14 18:45:41,1339888310,0,0,1,0,0,1
149182,2024-02-14 18:45:53,1339888479,11858,117,30,19,3,27
149182,2024-02-14 18:46:38,1339889024,11858,117,30,19,3,27
149362,2024-02-14 18:47:23,1339889646,1251,26,12,2,1,11
177626,2024-02-14 18:47:34,1339889802,0,0,1,0,0,1
177630,2024-02-14 18:59:03,1339898212,29356,173,28,12,11,17
177643,2024-02-14 19:32:25,1339922873,0,6,20,9,0,20
177643,2024-02-14 19:32:49,1339923189,0,6,20,9,0,20
127181,2024-02-14 19:38:53,1339927478,29621,99,33,15,4,29
177646,2024-02-14 19:52:31,1339937568,1904,7,43,21,2,41
177664,2024-02-14 21:18:13,1339998402,40580,101,62,17,5,57
177666,2024-02-14 21:50:31,1340020282,0,2,17,14,0,17
177666,2024-02-14 21:50:49,1340020503,0,2,17,14,0,17
177667,2024-02-14 22:29:22,1340045515,14025,24,5,4,1,4
177675,2024-02-14 23:26:45,1340081323,78592,125,40,33,7,33
97100,2024-02-15 15:14:39,1340313854,14500,129,53,21,2,51
86639,2024-02-15 16:27:20,1340357324,9178,139,127,78,2,125
177693,2024-02-15 16:29:00,1340358433,69536,28,18,9,3,15
115652,2024-02-15 16:31:29,1340360185,14439,68,177,96,2,175
115652,2024-02-15 16:32:27,1340360804,14439,68,177,96,2,175
86630,2024-02-15 16:34:30,1340362369,0,8,29,25,0,29
177686,2024-02-15 16:34:48,1340362599,85243,84,41,24,2,39
86630,2024-02-15 16:34:56,1340362683,0,8,29,25,0,29
177686,2024-02-15 16:35:11,1340362859,85243,84,41,24,2,39
177687,2024-02-15 16:35:24,1340363017,0,14,26,12,0,26
147778,2024-02-15 16:35:45,1340363272,11426,317,48,18,6,42
177688,2024-02-15 16:35:46,1340363284,0,2,45,26,0,45
177689,2024-02-15 16:36:02,1340363447,41050,106,103,33,7,96
177690,2024-02-15 16:36:43,1340363911,5019,82,1088,27,2,1086
86630,2024-02-15 16:36:50,1340364042,0,8,29,25,0,29
177690,2024-02-15 16:37:03,1340364065,5019,82,1088,27,2,1086
177691,2024-02-15 16:37:02,1340364179,58279,26,23,12,1,22
177691,2024-02-15 16:37:28,1340364490,58279,26,23,12,1,22
177686,2024-02-15 16:38:14,1340365005,85243,84,41,24,2,39
177687,2024-02-15 16:38:44,1340365361,0,14,26,12,0,26
177686,2024-02-15 16:39:05,1340365651,85243,84,41,24,2,39
147778,2024-02-15 16:39:32,1340365985,11426,317,48,18,6,42
177688,2024-02-15 16:40:46,1340366858,0,2,45,26,0,45
177689,2024-02-15 16:40:52,1340366926,41050,106,103,33,7,96
177690,2024-02-15 16:41:04,1340366987,5019,82,1088,27,2,1086
177692,2024-02-15 16:41:12,1340367155,23666,35,63,41,3,60
147778,2024-02-15 16:50:37,1340373675,11426,317,48,18,6,42
86630,2024-02-15 16:54:29,1340376473,0,8,29,25,0,29
86630,2024-02-15 16:54:55,1340376758,0,8,29,25,0,29
157421,2024-02-15 16:56:20,1340377821,6073,49,48,32,4,44
157421,2024-02-15 16:57:08,1340378369,6073,49,48,32,4,44
157421,2024-02-15 16:57:32,1340378662,6073,49,48,32,4,44
157421,2024-02-15 16:58:01,1340378952,6073,49,48,32,4,44
157421,2024-02-15 16:59:40,1340380200,6073,49,48,32,4,44
177701,2024-02-15 17:36:15,1340406910,106024,254,36,24,7,29
177705,2024-02-15 17:57:51,1340423711,71616,72,45,23,4,41
177708,2024-02-15 18:00:43,1340425930,22146,148,43,20,6,37
157412,2024-02-15 18:20:26,1340441715,8151,196,50,23,2,48
177716,2024-02-15 18:21:23,1340442485,5897,48,27,10,3,24
177718,2024-02-15 18:26:30,1340446630,90068,109,28,13,7,21
97102,2024-02-15 18:36:37,1340454769,0,0,4,3,0,4
97102,2024-02-15 18:36:53,1340454946,0,0,4,3,0,4
177707,2024-02-15 18:37:34,1340455512,0,5,62,41,0,62
177719,2024-02-15 18:39:25,1340456939,13606,49,16,10,3,13
97102,2024-02-15 18:40:39,1340457907,0,0,4,3,0,4
177723,2024-02-15 19:04:25,1340476634,16388,105,13,5,3,10
164971,2024-02-15 19:45:14,1340508131,20281,25,72,49,3,69
150322,2024-02-15 19:53:18,1340514304,13145,177,45,14,4,41
150323,2024-02-15 19:53:40,1340514639,270419,211,98,70,11,87
150324,2024-02-15 19:55:31,1340516041,13103,402,59,15,8,51
177722,2024-02-15 20:32:59,1340544597,28183,96,37,27,4,33
177736,2024-02-15 20:51:39,1340558426,302979,148,72,45,12,60
150328,2024-02-15 21:06:04,1340568722,192051,127,35,26,5,30
150330,2024-02-15 21:06:35,1340569090,21773,31,57,33,4,53
177745,2024-02-15 21:11:32,1340572655,94960,148,31,18,11,20
177738,2024-02-15 21:17:06,1340576615,33966,77,77,45,7,70
177738,2024-02-15 21:17:35,1340576971,33966,77,77,45,7,70
177737,2024-02-15 21:19:27,1340578377,45965,87,52,37,6,46
177737,2024-02-15 21:20:04,1340578838,45965,87,52,37,6,46
177726,2024-02-15 21:23:54,1340581510,4917,36,15,10,4,11
177725,2024-02-15 21:28:49,1340585100,4536,15,3,2,1,2
177750,2024-02-15 21:38:14,1340591815,82655,169,58,20,5,53
177748,2024-02-15 21:54:23,1340603291,484,1,1,0,1,0
177754,2024-02-15 21:59:37,1340607053,4376,228,11,3,6,5
177755,2024-02-15 22:01:26,1340608276,64581,62,6,4,4,2
177756,2024-02-15 22:28:23,1340626285,45913,86,27,23,4,23
177759,2024-02-15 23:37:49,1340671874,19421,56,20,11,5,15
177758,2024-02-16 15:02:17,1340935401,10081,38,33,28,5,28
177764,2024-02-16 15:04:34,1340936246,1727,5,10,8,1,9
170638,2024-02-16 15:16:27,1340941573,84204,136,93,48,12,81
177788,2024-02-16 16:01:47,1340967355,31895,186,45,11,4,41
177800,2024-02-16 16:03:56,1340968717,130171,86,42,36,4,38
177789,2024-02-16 16:05:13,1340969502,12463,240,15,5,5,10
177779,2024-02-16 16:13:48,1340975285,12403,14,45,31,3,42
177780,2024-02-16 16:13:57,1340975397,21265,306,51,23,10,41
177781,2024-02-16 16:14:07,1340975527,35864,81,71,46,4,67
177782,2024-02-16 16:14:30,1340975786,25464,156,40,25,8,32
177783,2024-02-16 16:15:46,1340976669,4280,19,71,42,3,68
177803,2024-02-16 16:15:47,1340976676,69616,162,62,31,7,55
177779,2024-02-16 16:18:07,1340978239,12403,14,45,31,3,42
177798,2024-02-16 16:20:46,1340980211,83081,55,72,36,8,64
177796,2024-02-16 16:22:45,1340981711,132627,230,108,47,22,86
177795,2024-02-16 16:23:07,1340981976,4956,2,8,4,2,6
169137,2024-02-16 16:50:28,1341003105,201,14,47,16,1,46
169137,2024-02-16 16:51:23,1341003788,201,14,47,16,1,46
177809,2024-02-16 16:59:32,1341009999,0,0,9,2,0,9
177579,2024-02-16 17:01:18,1341011329,30013,1,34,14,1,33
177818,2024-02-16 17:35:02,1341038551,18732,65,42,20,7,35
177819,2024-02-16 17:59:16,1341058933,45913,86,27,23,4,23
177824,2024-02-16 18:01:16,1341060585,17274,374,86,41,1,85
177811,2024-02-16 18:10:14,1341067918,136703,112,14,2,6,8
76453,2024-02-16 18:44:03,1341095972,0,33,80,34,0,80
76453,2024-02-16 18:44:06,1341096031,0,33,80,34,0,80
177762,2024-02-16 18:50:24,1341101233,30639,101,80,29,8,72
177834,2024-02-16 19:08:25,1341116165,80956,34,35,12,6,29
147489,2024-02-16 19:16:26,1341122910,31776,212,32,10,11,21
147489,2024-02-16 19:17:18,1341123624,31776,212,32,10,11,21
147487,2024-02-16 19:17:39,1341123899,14420,93,88,63,4,84
147487,2024-02-16 19:17:42,1341123944,14420,93,88,63,4,84
147487,2024-02-16 19:19:37,1341125504,14420,93,88,63,4,84
159792,2024-02-16 19:20:21,1341126108,296296,128,68,13,11,57
159792,2024-02-16 19:20:31,1341126228,296296,128,68,13,11,57
159838,2024-02-16 19:20:52,1341126505,78555,179,59,39,9,50
159838,2024-02-16 19:21:06,1341126723,78555,179,59,39,9,50
147492,2024-02-16 19:21:52,1341127294,12642,87,20,15,5,15
147492,2024-02-16 19:22:00,1341127413,12642,87,20,15,5,15
159797,2024-02-16 19:22:46,1341128027,139717,224,101,63,13,88
159797,2024-02-16 19:22:55,1341128143,139717,224,101,63,13,88
159797,2024-02-16 19:23:51,1341128873,139717,224,101,63,13,88
147492,2024-02-16 19:24:11,1341129143,12642,87,20,15,5,15
159838,2024-02-16 19:25:00,1341129818,78555,179,59,39,9,50
159792,2024-02-16 19:25:25,1341130183,296296,128,68,13,11,57
159797,2024-02-16 19:26:03,1341130669,139717,224,101,63,13,88
159797,2024-02-16 19:26:57,1341131409,139717,224,101,63,13,88
177847,2024-02-16 19:39:32,1341141558,86745,71,60,31,6,54
177828,2024-02-16 19:47:40,1341148061,9756,58,21,8,3,18
177850,2024-02-16 19:49:01,1341149074,830,9,59,26,1,58
177849,2024-02-16 20:06:06,1341162745,16841,110,34,5,5,29
167660,2024-02-16 20:28:39,1341180942,63902,202,38,27,3,35
167618,2024-02-16 20:29:00,1341181195,6161,310,67,27,3,64
167621,2024-02-16 20:29:19,1341181472,37873,51,48,30,2,46
167602,2024-02-16 20:30:11,1341182180,1220,72,65,40,3,62
167615,2024-02-16 20:38:47,1341188762,50109,233,71,23,1,70
164679,2024-02-16 20:50:34,1341197668,25719,8,13,1,2,11
164679,2024-02-16 20:50:40,1341197749,25719,8,13,1,2,11
151802,2024-02-16 20:51:03,1341198006,8082,25,46,14,2,44
151802,2024-02-16 20:51:07,1341198066,8082,25,46,14,2,44
141700,2024-02-16 20:51:25,1341198272,48508,54,94,21,7,87
141700,2024-02-16 20:51:54,1341198607,48508,54,94,21,7,87
97091,2024-02-16 20:52:37,1341199197,42393,52,36,22,5,31
97091,2024-02-16 20:59:28,1341204149,42393,52,36,22,5,31
152110,2024-02-16 21:06:44,1341209365,29961,13,11,9,3,8
142676,2024-02-16 21:42:34,1341235338,25464,156,40,25,8,32
177867,2024-02-16 21:49:35,1341240431,26965,47,9,5,3,6
138470,2024-02-16 22:16:21,1341259518,32619,83,129,21,6,123
148350,2024-02-16 22:45:49,1341280338,41846,192,96,45,9,87
97098,2024-02-16 22:56:33,1341287456,3397,26,20,6,1,19
97098,2024-02-16 22:56:46,1341287620,3397,26,20,6,1,19
177875,2024-02-16 23:13:33,1341298378,18702,21,60,18,3,57
177876,2024-02-16 23:13:39,1341298445,0,55,9,2,0,9
177887,2024-02-16 23:13:44,1341298506,51320,56,17,5,5,12
177885,2024-02-16 23:13:47,1341298536,65624,120,58,34,11,47
177888,2024-02-16 23:21:12,1341303186,64180,24,15,10,2,13
177892,2024-02-17 15:01:26,1341543846,40259,76,38,22,6,32
177902,2024-02-17 15:03:45,1341544384,14733,46,4,1,1,3
169138,2024-02-17 15:37:39,1341554976,8835,45,31,19,2,29
102786,2024-02-17 15:40:47,1341556097,21471,199,71,35,6,65
102882,2024-02-17 15:43:25,1341557141,18717,68,52,36,4,48
102882,2024-02-17 15:44:32,1341557567,18717,68,52,36,4,48
177913,2024-02-17 15:48:11,1341558929,39452,58,62,38,8,54
102776,2024-02-17 15:48:30,1341559042,0,5,27,8,0,27
177913,2024-02-17 15:48:50,1341559166,39452,58,62,38,8,54
102775,2024-02-17 15:54:24,1341561246,503,27,89,58,1,88
177922,2024-02-17 16:22:05,1341572701,135438,120,59,25,8,51
177923,2024-02-17 16:35:35,1341578980,0,69,6,2,0,6
177573,2024-02-17 17:52:05,1341648330,34981,18,57,26,5,52
177574,2024-02-17 17:52:06,1341648411,11743,76,6,3,2,4
177575,2024-02-17 17:52:09,1341648558,0,44,12,6,0,12
177576,2024-02-17 17:52:12,1341648687,37066,277,53,17,5,48
177577,2024-02-17 17:52:14,1341648818,30013,2,22,6,1,21
177578,2024-02-17 17:53:46,1341650731,35669,14,73,41,3,70
177925,2024-02-17 18:05:36,1341671929,143904,404,63,45,6,57
177937,2024-02-19 14:25:21,1342700895,17785,71,39,14,4,35
177939,2024-02-19 14:57:22,1342710294,0,2,13,10,0,13
150428,2024-02-19 15:38:29,1342728962,21635,147,61,11,7,54
150428,2024-02-19 15:39:46,1342729667,21635,147,61,11,7,54
150427,2024-02-19 15:41:42,1342730804,8283,239,65,23,6,59
177953,2024-02-19 15:42:04,1342731006,116183,68,49,29,13,36
177951,2024-02-19 15:42:34,1342731262,44651,146,59,26,8,51
177802,2024-02-19 15:43:00,1342731517,139776,273,54,21,13,41
150440,2024-02-19 15:44:22,1342732281,28057,77,42,19,2,40
177938,2024-02-19 15:47:04,1342733840,1458,21,2,1,1,1
177938,2024-02-19 15:47:31,1342734100,1458,21,2,1,1,1
150566,2024-02-19 15:52:44,1342737270,12022,27,32,17,2,30
150511,2024-02-19 15:55:56,1342739096,214995,92,136,43,13,123
169101,2024-02-19 15:59:57,1342741427,0,3,75,20,0,75
169099,2024-02-19 16:20:11,1342753839,7304,3,14,4,3,11
177831,2024-02-19 17:05:08,1342786775,0,33,80,34,0,80
177831,2024-02-19 17:05:13,1342786859,0,33,80,34,0,80
177972,2024-02-19 17:45:31,1342828192,29484,63,11,3,3,8
177940,2024-02-19 17:55:47,1342851252,697697,105,95,71,7,88
177981,2024-02-19 18:05:36,1342867965,0,0,5,1,0,5
177982,2024-02-19 18:05:40,1342868086,26166,40,22,14,2,20
177984,2024-02-19 18:05:45,1342868162,41878,77,127,79,3,124
177985,2024-02-19 18:05:48,1342868227,120260,212,143,76,8,135
177985,2024-02-19 18:07:05,1342870260,120260,212,143,76,8,135
177981,2024-02-19 18:08:06,1342871817,0,0,5,1,0,5
177982,2024-02-19 18:08:13,1342871992,26166,40,22,14,2,20
177984,2024-02-19 18:08:24,1342872264,41878,77,127,79,3,124
177985,2024-02-19 18:08:32,1342872427,120260,212,143,76,8,135
177985,2024-02-19 18:10:51,1342876024,120260,212,143,76,8,135
178001,2024-02-19 19:56:37,1342979074,45444,56,13,10,7,6
177991,2024-02-19 20:08:02,1342988390,0,7,36,13,0,36
178003,2024-02-19 20:20:22,1342998016,0,2,4,1,0,4
178005,2024-02-19 20:58:48,1343028405,2566,3,24,8,1,23
178006,2024-02-19 21:01:18,1343030382,76336,86,55,15,4,51
178007,2024-02-19 21:12:52,1343039543,14470,37,26,16,4,22
178008,2024-02-19 21:21:32,1343046331,46864,235,37,25,7,30
178011,2024-02-19 21:43:38,1343063957,121236,429,72,38,21,51
178011,2024-02-19 21:43:58,1343064229,121236,429,72,38,21,51
178021,2024-02-19 21:44:22,1343064592,28973,109,53,37,7,46
178014,2024-02-19 22:01:25,1343078140,45170,125,64,44,8,56
178015,2024-02-19 22:01:32,1343078171,16266,190,19,10,4,15
178016,2024-02-19 22:01:30,1343078201,135172,293,50,31,8,42
178017,2024-02-19 22:01:34,1343078254,51348,207,27,15,6,21
178018,2024-02-19 22:01:40,1343078352,30010,77,36,29,4,32
178019,2024-02-19 22:03:05,1343079476,121680,317,68,54,9,59
178020,2024-02-19 22:20:52,1343093004,11983,66,51,38,5,46
178010,2024-02-19 22:43:05,1343109361,35445,20,65,3,2,63
105234,2024-02-20 02:27:12,1343236864,14673,68,72,42,6,66
116844,2024-02-20 02:27:14,1343236875,41123,34,70,49,3,67
116128,2024-02-20 02:27:17,1343236901,3680,60,60,37,1,59
150698,2024-02-20 02:27:19,1343236908,13242,45,98,60,5,93
160689,2024-02-20 02:27:21,1343236922,58139,250,70,46,9,61
160687,2024-02-20 02:28:51,1343237540,9877,43,29,23,5,24
160687,2024-02-20 02:29:11,1343237657,9877,43,29,23,5,24
150698,2024-02-20 02:29:48,1343237843,13242,45,98,60,5,93
116128,2024-02-20 02:30:46,1343238214,3680,60,60,37,1,59
116844,2024-02-20 02:30:48,1343238235,41123,34,70,49,3,67
105234,2024-02-20 02:30:51,1343238245,14673,68,72,42,6,66
150698,2024-02-20 02:34:08,1343239546,13242,45,98,60,5,93
105234,2024-02-20 02:34:13,1343239582,14673,68,72,42,6,66
98276,2024-02-20 16:20:46,1343437304,62873,144,20,8,6,14
142574,2024-02-20 16:29:38,1343443324,35864,79,71,46,4,67
142677,2024-02-20 16:34:57,1343446930,4280,20,71,42,3,68
142678,2024-02-20 16:35:32,1343447260,12403,14,45,31,3,42
149886,2024-02-20 16:35:57,1343447573,21265,306,51,23,10,41
142677,2024-02-20 16:36:33,1343448037,4280,20,71,42,3,68
169789,2024-02-20 16:36:54,1343448313,2874,27,9,2,2,7
142678,2024-02-20 16:36:57,1343448319,12403,14,45,31,3,42
149886,2024-02-20 16:37:17,1343448617,21265,306,51,23,10,41
169789,2024-02-20 16:37:31,1343448797,2874,27,9,2,2,7
178094,2024-02-20 16:44:20,1343453495,38712,17,27,6,3,24
178094,2024-02-20 16:47:20,1343455706,38712,17,27,6,3,24
178096,2024-02-20 17:10:49,1343472874,58158,167,42,22,4,38
178098,2024-02-20 17:28:42,1343486405,35638,50,11,4,1,10
178099,2024-02-20 17:52:43,1343505909,75000,131,20,10,10,10
178103,2024-02-20 18:09:22,1343518937,19253,76,168,15,9,159
178106,2024-02-20 18:14:54,1343523454,14882,59,18,10,2,16
178106,2024-02-20 18:15:15,1343523706,14882,59,18,10,2,16
177658,2024-02-20 18:21:05,1343528615,201,14,47,16,1,46
105042,2024-02-20 18:24:39,1343531478,34374,256,47,29,9,38
177659,2024-02-20 18:31:08,1343536695,8835,45,31,19,2,29
178109,2024-02-20 18:31:47,1343537272,0,2,17,2,0,17
178111,2024-02-20 18:34:45,1343539677,22476,23,19,15,3,16
177660,2024-02-20 18:38:00,1343542282,21471,200,71,35,6,65
177660,2024-02-20 18:39:04,1343543220,21471,200,71,35,6,65
178112,2024-02-20 18:44:15,1343547555,16633,151,24,16,3,21
178114,2024-02-20 18:48:58,1343551354,126957,17,43,29,3,40
177661,2024-02-20 18:49:18,1343551640,18717,68,52,36,4,48
178115,2024-02-20 18:49:41,1343551926,68055,84,41,28,5,36
177661,2024-02-20 18:49:52,1343552062,18717,68,52,36,4,48
178114,2024-02-20 18:50:30,1343552605,126957,17,43,29,3,40
178114,2024-02-20 18:51:15,1343553095,381,7,38,24,1,37
178115,2024-02-20 18:51:35,1343553499,68055,84,41,28,5,36
177661,2024-02-20 18:51:41,1343553555,18717,68,52,36,4,48
178115,2024-02-20 18:52:23,1343554119,68055,84,41,28,5,36
178117,2024-02-20 18:53:22,1343554930,936,5,6,1,1,5
177662,2024-02-20 18:54:00,1343555431,0,5,27,8,0,27
178117,2024-02-20 18:54:07,1343555548,936,5,6,1,1,5
178118,2024-02-20 18:54:41,1343556023,0,0,17,10,0,17
177662,2024-02-20 18:55:10,1343556425,0,5,27,8,0,27
178117,2024-02-20 18:55:10,1343556426,936,5,6,1,1,5
178118,2024-02-20 18:55:41,1343556831,0,0,17,10,0,17
178117,2024-02-20 18:55:54,1343556993,936,5,6,1,1,5
178117,2024-02-20 18:57:45,1343558453,936,5,6,1,1,5
177663,2024-02-20 18:58:21,1343558961,503,27,89,58,1,88
178116,2024-02-20 19:00:00,1343560276,34702,135,57,15,3,54
178116,2024-02-20 19:00:49,1343561014,34702,135,57,15,3,54
178121,2024-02-20 19:04:09,1343563980,0,0,5,0,0,5
178120,2024-02-20 19:04:51,1343564520,130171,326,57,31,12,45
162535,2024-02-20 19:11:36,1343569857,7951,57,43,26,3,40
178122,2024-02-20 19:11:53,1343570079,64073,143,64,35,3,61
162535,2024-02-20 19:12:03,1343570218,7951,57,43,26,3,40
162354,2024-02-20 19:12:31,1343570587,11736,70,99,56,2,97
162526,2024-02-20 19:13:09,1343571061,0,0,1,0,0,1
162526,2024-02-20 19:13:15,1343571125,0,0,1,0,0,1
178122,2024-02-20 19:14:03,1343571703,64073,143,64,35,3,61
178123,2024-02-20 19:22:36,1343578501,75875,208,49,33,4,45
178129,2024-02-20 19:47:08,1343597984,141804,175,86,50,9,77
178138,2024-02-20 21:08:33,1343661437,4579,10,46,37,1,45
178147,2024-02-20 21:30:46,1343678349,0,0,4,1,0,4
178130,2024-02-20 21:46:46,1343690675,18390,67,21,10,3,18
178143,2024-02-20 21:55:01,1343696962,18608,516,127,35,8,119
178137,2024-02-20 21:55:39,1343697444,239412,99,47,18,7,40
178148,2024-02-20 21:57:54,1343699054,74411,262,58,38,12,46
178151,2024-02-20 22:03:53,1343703415,42625,62,62,36,7,55
178155,2024-02-20 22:09:22,1343707490,5649,24,19,7,3,16
178154,2024-02-20 22:14:07,1343710928,55226,160,41,17,8,33
178156,2024-02-20 22:14:13,1343711004,146261,698,65,24,23,42
178157,2024-02-20 22:20:14,1343715271,0,3,5,2,0,5
178158,2024-02-20 22:28:00,1343721057,142360,263,52,30,11,41
178158,2024-02-20 22:28:27,1343721380,142360,263,52,30,11,41
178160,2024-02-20 22:39:27,1343729498,6707,20,11,1,1,10
178161,2024-02-20 22:39:42,1343729628,1238,8,19,15,1,18
178163,2024-02-20 22:39:52,1343729791,4126,6,12,7,1,11
178162,2024-02-20 22:40:11,1343730039,19495,61,9,5,4,5
178167,2024-02-20 22:40:19,1343730105,44222,220,36,16,11,25
178159,2024-02-20 22:41:55,1343731285,1379,17,23,9,1,22
178125,2024-02-20 22:47:53,1343735509,142077,191,52,21,11,41
174129,2024-02-20 22:48:54,1343736156,69220,122,11,9,5,6
178125,2024-02-20 22:48:54,1343736157,142077,191,52,21,11,41
178139,2024-02-20 22:49:38,1343736687,15387,89,42,24,2,40
178081,2024-02-20 22:50:33,1343737324,13614,51,9,0,5,4
178135,2024-02-20 22:50:53,1343737589,8929,61,58,44,1,57
178168,2024-02-20 22:51:29,1343738027,12684,35,12,3,6,6
178084,2024-02-20 22:52:51,1343739013,5087,63,14,6,5,9
178085,2024-02-20 22:53:43,1343739608,18705,161,38,13,7,31
178179,2024-02-20 23:27:47,1343762923,51471,55,16,9,4,12
178179,2024-02-20 23:29:08,1343763763,51471,55,16,9,4,12
177983,2024-02-20 23:49:46,1343778402,6837,91,16,11,1,15
178182,2024-02-21 14:28:11,1343996296,18848,262,57,34,5,52
177995,2024-02-21 14:44:07,1344000979,44464,76,62,52,1,61
177996,2024-02-21 14:44:49,1344001187,754,8,35,29,1,34
177997,2024-02-21 14:45:45,1344001507,18493,159,87,35,5,82
177998,2024-02-21 14:47:45,1344002215,161113,79,126,81,9,117
177999,2024-02-21 14:47:55,1344002278,7634,14,12,7,3,9
178192,2024-02-21 14:48:03,1344002335,2544,5,11,4,1,10
178193,2024-02-21 14:48:12,1344002387,91494,62,84,54,5,79
178194,2024-02-21 14:48:22,1344002421,183915,362,148,34,17,131
178195,2024-02-21 14:50:24,1344003130,63095,278,83,67,13,70
178196,2024-02-21 14:52:11,1344003767,4591,34,35,19,1,34
177999,2024-02-21 14:55:53,1344005003,7634,14,12,7,3,9
178192,2024-02-21 14:56:17,1344005155,2544,5,11,4,1,10
178192,2024-02-21 14:57:36,1344005617,2544,5,11,4,1,10
178190,2024-02-21 15:09:42,1344010468,7889,99,26,5,7,19
178181,2024-02-21 15:24:57,1344017623,91065,110,109,31,4,105
178210,2024-02-21 15:46:44,1344029203,199,1,2,0,1,1
178214,2024-02-21 15:47:42,1344029747,149,1,7,1,1,6
178207,2024-02-21 15:51:38,1344031968,68061,72,12,5,6,6
178213,2024-02-21 15:51:52,1344032099,42347,214,80,39,12,68
127166,2024-02-21 15:59:51,1344036778,89868,108,30,16,6,24
178219,2024-02-21 16:04:18,1344039488,41708,72,64,51,6,58
178222,2024-02-21 16:35:06,1344060774,45965,88,52,37,6,46
178211,2024-02-21 16:52:57,1344073623,698,2,2,0,1,1
74349,2024-02-21 16:56:25,1344076115,46879,67,56,25,4,52
178244,2024-02-21 19:09:23,1344181690,51284,38,8,4,2,6
178247,2024-02-21 19:09:34,1344181827,7163,14,2,1,2,0
178250,2024-02-21 19:09:45,1344182001,9664,51,23,10,1,22
178250,2024-02-21 19:09:56,1344182132,9664,51,23,10,1,22
178251,2024-02-21 19:11:03,1344182994,24501,40,22,17,2,20
178254,2024-02-21 19:11:18,1344183187,0,3,31,15,0,31
178257,2024-02-21 19:16:24,1344187180,51036,205,57,36,6,51
178258,2024-02-21 19:16:35,1344187313,14465,183,70,40,7,63
178259,2024-02-21 19:16:46,1344187445,2836,84,21,13,2,19
178260,2024-02-21 19:16:59,1344187633,38323,150,31,23,5,26
178264,2024-02-21 19:30:53,1344198834,44854,132,43,33,6,37
178266,2024-02-21 19:35:28,1344202537,36356,84,27,24,5,22
158696,2024-02-21 20:16:47,1344235426,60738,204,26,16,4,22
158694,2024-02-21 20:25:58,1344242624,67294,172,33,16,5,28
158694,2024-02-21 20:27:11,1344243633,67294,172,33,16,5,28
168590,2024-02-21 20:27:35,1344243990,4624,33,10,7,1,9
158700,2024-02-21 20:27:55,1344244281,59009,204,16,7,4,12
168590,2024-02-21 20:28:42,1344244940,4624,33,10,7,1,9
168590,2024-02-21 20:28:44,1344244961,4624,33,10,7,1,9
158700,2024-02-21 20:29:22,1344245510,59009,204,16,7,4,12
158669,2024-02-21 20:29:53,1344245937,79343,83,13,7,6,7
158697,2024-02-21 20:30:31,1344246504,103119,45,14,6,3,11
178280,2024-02-21 20:47:40,1344260351,10660,65,18,6,3,15
178277,2024-02-21 20:55:50,1344266765,0,0,2,2,0,2
178278,2024-02-21 20:56:05,1344266975,28654,201,44,14,10,34
178279,2024-02-21 20:56:27,1344267281,23042,23,6,4,4,2
178281,2024-02-21 20:56:47,1344267507,15380,60,15,8,4,11
178286,2024-02-21 21:00:25,1344270427,186567,658,87,37,25,62
178298,2024-02-21 21:24:55,1344289560,23984,172,22,6,5,17
178293,2024-02-21 21:40:49,1344301729,252,5,47,38,1,46
178304,2024-02-21 21:55:03,1344313214,25441,135,20,8,2,18
178308,2024-02-21 22:14:06,1344329442,4175,4,110,68,1,109
178302,2024-02-21 22:15:56,1344330732,1042,3,4,2,2,2
178318,2024-02-21 22:28:45,1344339601,12608,17,40,16,3,37
178303,2024-02-21 22:29:34,1344340202,18848,262,57,34,5,52
178319,2024-02-21 22:32:21,1344342208,8982,34,13,6,3,10
178301,2024-02-21 22:33:33,1344343023,44829,52,26,4,4,22
178255,2024-02-21 22:44:24,1344350196,98611,51,75,32,11,64
178255,2024-02-21 22:44:39,1344350377,98611,51,75,32,11,64
178255,2024-02-21 22:44:45,1344350434,98611,51,75,32,11,64
178255,2024-02-21 22:45:08,1344350725,98611,51,75,32,11,64
178305,2024-02-21 22:48:07,1344352738,5561,75,47,24,4,43
178310,2024-02-21 22:52:34,1344355688,44577,165,60,20,11,49
178322,2024-02-21 22:56:10,1344357975,60841,269,52,27,15,37
178322,2024-02-21 22:56:29,1344358216,60841,269,52,27,15,37
178323,2024-02-21 22:56:45,1344358391,0,0,5,4,0,5
178321,2024-02-21 23:12:34,1344369112,293252,180,112,57,16,96
112961,2024-02-21 23:33:47,1344384232,24925,47,99,83,1,98
178320,2024-02-21 23:34:51,1344384949,8502,24,4,4,2,2
178326,2024-02-21 23:35:18,1344385241,35237,25,104,54,2,102
178327,2024-02-21 23:35:41,1344385516,21602,137,38,23,7,31
178328,2024-02-21 23:35:48,1344385617,33640,21,3,1,2,1
178331,2024-02-21 23:36:38,1344386200,26859,72,29,20,4,25
178329,2024-02-21 23:42:25,1344390048,1099,35,25,10,1,24
111206,2024-02-21 23:49:02,1344394591,45745,167,88,66,9,79
147596,2024-02-21 23:49:05,1344394649,27477,61,16,13,5,11
147603,2024-02-21 23:49:11,1344394740,14236,89,79,59,4,75
147596,2024-02-21 23:50:38,1344395732,27477,61,16,13,5,11
147603,2024-02-21 23:50:42,1344395767,14236,89,79,59,4,75
178311,2024-02-22 14:27:15,1344619430,17417,212,78,18,12,66
178312,2024-02-22 14:27:21,1344619457,46369,70,60,35,3,57
178312,2024-02-22 14:27:28,1344619488,46369,70,60,35,3,57
178313,2024-02-22 14:28:15,1344619717,6150,23,27,10,1,26
178314,2024-02-22 14:28:54,1344619868,34363,34,68,28,2,66
178316,2024-02-22 14:29:31,1344620046,6150,75,37,9,1,36
178317,2024-02-22 14:29:37,1344620073,428632,374,74,30,8,66
178311,2024-02-22 14:30:22,1344620267,17417,212,78,18,12,66
178317,2024-02-22 14:30:36,1344620357,428632,374,74,30,8,66
178324,2024-02-22 14:42:03,1344624040,70013,146,35,10,8,27
178355,2024-02-22 14:53:56,1344628201,11570,3,21,10,2,19
157491,2024-02-22 14:54:08,1344628274,942,8,28,12,1,27
158134,2024-02-22 14:56:01,1344628970,93801,63,35,26,6,29
147428,2024-02-22 15:06:19,1344633053,2103,47,116,91,1,115
178356,2024-02-22 15:19:40,1344639392,91601,105,25,13,6,19
158143,2024-02-22 15:24:14,1344641605,153305,127,69,24,10,59
157487,2024-02-22 15:28:06,1344643611,1626,11,48,19,2,46
158666,2024-02-22 15:30:46,1344644967,33481,20,43,30,5,38
178364,2024-02-22 15:35:44,1344647552,0,0,29,26,0,29
178365,2024-02-22 15:42:29,1344651450,65845,40,23,16,3,20
178367,2024-02-22 15:51:27,1344656701,59765,61,41,32,3,38
178367,2024-02-22 15:52:13,1344657172,59765,61,41,32,3,38
178343,2024-02-22 15:52:57,1344657579,0,0,13,12,0,13
178344,2024-02-22 16:36:47,1344685346,12283,31,14,12,2,12
178379,2024-02-22 16:44:59,1344691126,26731,42,25,19,3,22
178378,2024-02-22 16:45:22,1344691370,22848,193,62,36,6,56
178377,2024-02-22 16:45:30,1344691475,7075,20,46,39,2,44
178376,2024-02-22 16:45:41,1344691591,172060,150,102,65,15,87
178374,2024-02-22 16:46:07,1344691838,102877,212,188,104,14,174
178374,2024-02-22 16:46:40,1344692198,102877,212,188,104,14,174
178376,2024-02-22 16:48:24,1344693378,172060,150,102,65,15,87
178346,2024-02-22 16:55:28,1344698354,34949,169,73,36,9,64
178375,2024-02-22 17:00:46,1344702062,36770,86,34,19,5,29
178388,2024-02-22 17:32:01,1344720827,39691,206,16,9,2,14
178370,2024-02-22 17:32:11,1344720954,90319,124,79,44,9,70
178369,2024-02-22 17:32:21,1344721086,0,0,22,14,0,22
178368,2024-02-22 17:32:31,1344721190,747,10,7,7,1,6
178390,2024-02-22 17:55:06,1344738055,108412,91,39,24,11,28
178393,2024-02-22 18:00:08,1344741885,13966,81,39,20,2,37
178402,2024-02-22 18:08:44,1344748314,56488,63,14,6,3,11
178410,2024-02-22 18:58:39,1344787329,150534,304,71,18,16,55
178413,2024-02-22 18:58:49,1344787472,53813,271,65,26,7,58
178414,2024-02-22 18:58:56,1344787566,62234,113,33,20,6,27
178423,2024-02-22 18:59:02,1344787643,54354,37,3,2,3,0
178397,2024-02-22 19:10:55,1344796979,70228,191,49,17,7,42
178391,2024-02-22 19:10:58,1344797027,4555,81,21,10,2,19
178426,2024-02-22 19:18:18,1344802649,109897,105,36,10,11,25
178438,2024-02-22 20:08:20,1344840855,38092,54,59,35,5,54
147911,2024-02-22 20:20:02,1344849332,6747,46,72,60,3,69
147910,2024-02-22 20:20:22,1344849583,0,0,47,38,0,47
148007,2024-02-22 20:21:49,1344850572,0,1,48,42,0,48
158746,2024-02-22 20:22:37,1344851127,365,13,111,76,1,110
148002,2024-02-22 20:24:47,1344852721,0,6,69,59,0,69
178467,2024-02-22 20:43:05,1344865956,68255,126,25,18,6,19
178467,2024-02-22 20:43:09,1344866013,68255,126,25,18,6,19
178466,2024-02-22 20:43:23,1344866174,65972,104,29,18,6,23
178465,2024-02-22 20:43:31,1344866250,71632,99,33,18,6,27
178464,2024-02-22 20:43:38,1344866332,1416,16,21,13,1,20
178463,2024-02-22 20:45:00,1344867275,0,1,9,5,0,9
178463,2024-02-22 20:45:02,1344867300,0,1,9,5,0,9
178463,2024-02-22 20:45:04,1344867335,0,1,9,5,0,9
178461,2024-02-22 20:47:33,1344869123,0,0,1,0,0,1
178461,2024-02-22 20:47:37,1344869156,0,0,1,0,0,1
178446,2024-02-22 20:47:49,1344869284,25611,213,28,8,7,21
178447,2024-02-22 20:48:05,1344869428,0,1,7,5,0,7
178447,2024-02-22 20:48:07,1344869466,0,1,17,13,0,17
178449,2024-02-22 20:49:39,1344870620,55165,103,26,17,4,22
178450,2024-02-22 20:50:04,1344870867,89642,116,46,31,9,37
178315,2024-02-22 20:55:22,1344874679,6150,23,17,10,1,16
178462,2024-02-22 21:25:18,1344896958,3204,115,15,7,3,12
178484,2024-02-22 21:37:48,1344905678,2786,150,68,54,3,65
178484,2024-02-22 21:38:11,1344905965,2786,150,68,54,3,65
178493,2024-02-22 21:43:45,1344909891,20151,88,27,10,2,25
178494,2024-02-22 21:48:58,1344913552,19588,18,19,9,4,15
178495,2024-02-22 21:49:32,1344913975,798,38,106,27,2,104
178500,2024-02-22 22:31:02,1345006263,0,0,1,1,0,1
178496,2024-02-22 22:53:18,1345125993,3885,149,36,31,3,33
178496,2024-02-22 22:53:25,1345126603,3885,149,36,31,3,33
178496,2024-02-22 22:53:43,1345128187,3885,149,36,31,3,33
178496,2024-02-22 22:54:08,1345130388,3885,149,36,31,3,33
178496,2024-02-22 22:54:38,1345133023,3885,149,36,31,3,33
178515,2024-02-23 14:34:57,1346608559,4175,4,110,68,1,109
178520,2024-02-23 14:35:22,1346608724,0,1,14,11,0,14
178452,2024-02-23 14:55:29,1346615795,53581,129,35,23,4,31
178451,2024-02-23 14:55:48,1346615895,37576,82,64,35,10,54
178448,2024-02-23 14:56:41,1346616243,3011,45,22,7,1,21
178448,2024-02-23 14:56:47,1346616283,3011,45,22,7,1,21
178519,2024-02-23 15:37:54,1346636135,43294,128,43,31,9,34
159068,2024-02-23 15:47:22,1346641457,146869,66,44,31,4,40
160829,2024-02-23 15:47:42,1346641671,5689,100,34,29,1,33
160392,2024-02-23 15:48:10,1346641943,0,0,8,1,0,8
159070,2024-02-23 15:48:30,1346642105,73697,161,81,34,21,60
159069,2024-02-23 15:48:58,1346642371,0,9,29,19,0,29
160829,2024-02-23 15:49:48,1346642910,5689,100,34,29,1,33
178525,2024-02-23 16:26:38,1346665335,0,25,55,2,0,55
178526,2024-02-23 16:31:21,1346668526,38239,197,47,32,6,41
178382,2024-02-23 16:40:56,1346674764,30555,247,46,27,11,35
178383,2024-02-23 16:41:04,1346674859,76482,172,39,32,11,28
178384,2024-02-23 16:41:10,1346674953,59523,60,99,54,3,96
178385,2024-02-23 16:41:18,1346675046,6320,15,32,12,2,30
178386,2024-02-23 16:41:26,1346675140,30557,48,24,15,2,22
178387,2024-02-23 16:43:12,1346676289,122886,115,58,38,8,50
178540,2024-02-23 17:38:34,1346714771,1410,4,12,11,1,11
178540,2024-02-23 17:38:52,1346714986,1410,4,12,11,1,11
178540,2024-02-23 17:39:33,1346715534,1410,4,12,11,1,11
178540,2024-02-23 17:39:58,1346715836,1410,4,12,11,1,11
178540,2024-02-23 17:40:00,1346715857,1410,4,12,11,1,11
178540,2024-02-23 17:40:12,1346716020,1410,4,12,11,1,11
178422,2024-02-23 18:06:36,1346735487,33601,86,30,9,5,25
178544,2024-02-23 18:25:31,1346815716,58766,192,22,11,8,14
178569,2024-02-23 18:29:21,1346835550,159458,156,29,19,5,24
178567,2024-02-23 18:31:18,1346844855,1391,7,30,14,1,29
178503,2024-02-23 18:48:11,1346928234,0,0,5,5,0,5
178570,2024-02-23 19:19:17,1347039750,41030,139,33,19,11,22
178581,2024-02-23 19:19:22,1347040096,0,3,14,11,0,14
178584,2024-02-23 19:36:59,1347107989,3645,4,5,2,2,3
178584,2024-02-23 19:38:20,1347113440,3645,4,5,2,2,3
178562,2024-02-23 19:39:21,1347117225,42593,164,76,46,4,72
178563,2024-02-23 19:39:53,1347119169,29211,15,20,15,2,18
178564,2024-02-23 19:40:34,1347121846,103705,139,46,27,8,38
178565,2024-02-23 19:40:52,1347123014,35181,185,38,12,7,31
178566,2024-02-23 19:41:04,1347123722,2363,19,7,4,2,5
178598,2024-02-23 22:26:12,1347338861,14798,59,16,10,5,11
178602,2024-02-23 23:15:59,1347399362,52916,97,34,26,9,25
178610,2024-02-24 14:41:37,1347756961,5117,147,23,9,3,20
178611,2024-02-24 14:50:01,1347759038,313109,184,105,50,8,97
178632,2024-02-24 15:06:45,1347763248,3816,32,10,4,1,9
178633,2024-02-24 15:06:49,1347763267,63366,168,48,25,7,41
178634,2024-02-24 15:06:52,1347763281,103130,58,17,10,3,14
178635,2024-02-24 15:06:56,1347763298,177394,153,36,24,10,26
178636,2024-02-24 15:07:03,1347763338,20580,40,15,8,6,9
178608,2024-02-24 15:08:13,1347763703,90097,156,18,12,9,9
178609,2024-02-24 15:08:22,1347763738,13477,23,19,15,1,18
178626,2024-02-24 15:08:28,1347763766,47279,162,36,16,6,30
178628,2024-02-24 15:08:37,1347763809,30567,167,38,6,8,30
178608,2024-02-24 15:10:06,1347764250,90097,156,18,12,9,9
178609,2024-02-24 15:10:16,1347764294,13477,23,19,15,1,18
178626,2024-02-24 15:10:23,1347764323,47279,162,36,16,6,30
178638,2024-02-24 15:10:44,1347764412,152201,95,31,13,6,25
178638,2024-02-24 15:12:35,1347764937,152201,95,31,13,6,25
143731,2024-02-24 15:16:27,1347766233,19834,2,25,16,1,24
143349,2024-02-24 15:16:31,1347766257,26719,15,76,38,2,74
142171,2024-02-24 15:19:42,1347767284,32531,43,66,39,2,64
143361,2024-02-24 15:19:44,1347767289,19834,13,90,70,1,89
143340,2024-02-24 15:19:47,1347767309,7127,65,58,27,6,52
143381,2024-02-24 15:19:49,1347767326,25744,13,64,42,1,63
151740,2024-02-24 15:19:52,1347767347,20809,19,54,45,2,52
143380,2024-02-24 15:21:21,1347767872,50873,44,56,42,3,53
143361,2024-02-24 15:22:26,1347768227,19834,13,90,70,1,89
143381,2024-02-24 15:22:32,1347768265,25744,13,64,42,1,63
143361,2024-02-24 15:22:38,1347768295,19834,13,90,70,1,89
178640,2024-02-24 15:27:42,1347770125,58005,193,30,21,7,23
178642,2024-02-24 16:17:48,1347790562,14378,29,20,17,1,19
178643,2024-02-24 16:18:03,1347790688,55214,51,36,22,2,34
178645,2024-02-24 16:18:10,1347790742,4300,35,15,10,2,13
178642,2024-02-24 16:19:05,1347791185,14378,29,20,17,1,19
178643,2024-02-24 16:19:15,1347791262,55214,51,36,22,2,34
169315,2024-02-24 16:22:52,1347792843,36770,86,34,19,5,29
168720,2024-02-24 16:23:47,1347793291,45675,56,27,11,6,21
178646,2024-02-24 16:28:14,1347795484,0,101,42,19,0,42
178606,2024-02-24 16:43:35,1347802919,54661,43,19,11,6,13
178612,2024-02-24 16:45:26,1347803853,12083,30,9,3,5,4
178622,2024-02-24 16:49:39,1347805825,3858,235,12,3,6,6
178624,2024-02-24 16:51:00,1347806407,1833,14,29,14,1,28
178625,2024-02-24 16:52:01,1347806870,73292,82,23,13,5,18
178652,2024-02-24 17:27:25,1347824410,23332,81,63,42,5,58
178652,2024-02-24 17:27:34,1347824491,23332,81,63,42,5,58
132334,2024-02-24 17:42:57,1347833013,1655,87,41,36,2,39
132810,2024-02-24 17:44:13,1347833679,21390,26,12,9,3,9
128953,2024-02-24 17:45:32,1347834362,13124,44,48,27,3,45
178653,2024-02-24 17:49:10,1347836387,4402,10,62,15,2,60
168322,2024-02-24 18:08:29,1347850292,2561,15,60,39,1,59
166115,2024-02-24 18:11:31,1347854541,1613,11,9,7,1,8
167302,2024-02-24 18:13:10,1347856900,183,59,14,8,1,13
166116,2024-02-24 18:15:24,1347859901,32599,65,41,30,5,36
178666,2024-02-24 19:40:48,1347923227,37196,106,35,15,3,32
178667,2024-02-24 20:46:04,1347958509,12889,6,4,3,2,2
178668,2024-02-24 20:46:11,1347958568,44996,70,27,21,5,22
147802,2024-02-26 02:47:19,1348507625,15341,90,35,26,12,23
147827,2024-02-26 02:47:40,1348507736,10613,6,50,29,1,49
148070,2024-02-26 02:47:56,1348507797,0,0,20,18,0,20
160905,2024-02-26 02:48:12,1348507892,258951,254,113,78,17,96
160910,2024-02-26 02:48:22,1348507931,0,7,21,11,0,21
160911,2024-02-26 02:49:11,1348508158,34985,135,100,71,5,95
160913,2024-02-26 02:49:34,1348508288,50419,100,25,19,7,18
169241,2024-02-26 02:49:56,1348508387,130523,33,46,30,2,44
178664,2024-02-26 14:27:16,1348625928,0,10,7,4,0,7
178665,2024-02-26 14:34:54,1348628151,0,0,4,0,0,4
178663,2024-02-26 14:37:06,1348628894,11501,10,21,8,3,18
100546,2024-02-26 14:46:20,1348632335,92098,124,64,24,4,60
110572,2024-02-26 14:46:21,1348632343,62173,85,25,5,5,20
110573,2024-02-26 14:46:26,1348632366,11746,55,86,51,5,81
116673,2024-02-26 14:46:26,1348632374,17610,76,50,34,5,45
167956,2024-02-26 14:51:05,1348634911,0,1,15,13,0,15
167956,2024-02-26 14:52:20,1348635752,0,1,15,13,0,15
168869,2024-02-26 14:52:50,1348636066,11571,56,73,44,6,67
168907,2024-02-26 14:55:18,1348637516,23075,95,62,52,3,59
143242,2024-02-26 14:55:51,1348637846,0,0,7,3,0,7
157534,2024-02-26 14:56:18,1348638094,470,13,49,32,2,47
116673,2024-02-26 14:56:31,1348638249,17610,76,50,34,5,45
110572,2024-02-26 14:56:37,1348638323,62173,85,25,5,5,20
100546,2024-02-26 14:56:42,1348638363,92098,124,64,24,4,60
147476,2024-02-26 14:57:32,1348638982,9617,98,27,13,4,23
126698,2024-02-26 14:58:42,1348639973,6389,209,55,26,2,53
126698,2024-02-26 14:59:17,1348640456,6389,209,55,26,2,53
126668,2024-02-26 15:02:42,1348643288,9399,63,96,85,2,94
126668,2024-02-26 15:03:08,1348643671,9399,63,96,85,2,94
116673,2024-02-26 15:03:09,1348643700,17610,76,50,34,5,45
116673,2024-02-26 15:03:58,1348644381,17610,76,50,34,5,45
126668,2024-02-26 15:04:32,1348644852,9399,63,96,85,2,94
159063,2024-02-26 15:07:38,1348647453,25224,137,43,27,9,34
159063,2024-02-26 15:08:19,1348648079,25224,137,43,27,9,34
158819,2024-02-26 15:09:09,1348648726,154149,384,77,35,21,56
178715,2024-02-26 15:12:20,1348651429,34338,196,40,17,5,35
178716,2024-02-26 15:20:25,1348658894,12949,23,16,7,2,14
169428,2024-02-26 15:23:49,1348661526,0,11,68,52,0,68
178717,2024-02-26 15:28:08,1348663779,2853,19,5,2,1,4
178717,2024-02-26 15:29:22,1348664486,2853,19,5,2,1,4
178719,2024-02-26 15:31:54,1348665950,29415,49,31,18,2,29
169429,2024-02-26 15:35:46,1348668147,17267,191,91,44,3,88
169430,2024-02-26 15:36:41,1348668639,6513,31,91,58,1,90
169430,2024-02-26 15:37:00,1348668801,6513,31,91,58,1,90
169430,2024-02-26 15:37:03,1348668834,6513,31,91,58,1,90
169430,2024-02-26 15:37:04,1348668849,6513,31,91,58,1,90
169431,2024-02-26 15:38:29,1348669665,11846,48,87,70,3,84
169431,2024-02-26 15:38:31,1348669684,11846,48,87,70,3,84
169431,2024-02-26 15:38:41,1348669760,11846,48,87,70,3,84
169431,2024-02-26 15:38:43,1348669778,11846,48,87,70,3,84
169431,2024-02-26 15:38:45,1348669795,11846,48,87,70,3,84
169432,2024-02-26 15:40:28,1348670784,1628,47,56,39,2,54
178720,2024-02-26 16:37:14,1348709184,99323,218,41,23,8,33
158981,2024-02-26 16:47:50,1348717300,25433,220,44,27,6,38
178722,2024-02-26 16:49:47,1348718823,979,25,13,7,3,10
178726,2024-02-26 17:13:05,1348737005,8990,20,24,7,2,22
178736,2024-02-26 17:27:15,1348748529,9463,48,65,37,5,60
178739,2024-02-26 17:39:37,1348758814,84930,133,72,53,3,69
178740,2024-02-26 17:47:36,1348765322,9889,103,75,38,5,70
178746,2024-02-26 18:23:43,1348795541,38556,119,51,25,11,40
178746,2024-02-26 18:23:54,1348795698,38556,119,51,25,11,40
168910,2024-02-26 19:14:13,1348838291,0,0,3,2,0,3
168910,2024-02-26 19:15:13,1348839140,0,0,3,2,0,3
178750,2024-02-26 19:38:44,1348858387,0,7,7,1,0,7
178751,2024-02-26 19:38:51,1348858468,15025,56,10,6,4,6
167884,2024-02-26 19:58:25,1348874310,2701,18,63,26,2,61
178764,2024-02-26 19:59:53,1348875443,35534,308,67,26,12,55
167867,2024-02-26 20:01:06,1348876391,16538,157,14,8,2,12
167870,2024-02-26 20:02:55,1348877930,93985,205,41,18,10,31
168024,2024-02-26 20:04:58,1348879457,55557,104,81,51,6,75
178724,2024-02-26 20:13:31,1348886442,24192,211,86,24,10,76
178769,2024-02-26 20:25:41,1348895934,14198,24,9,3,1,8
178770,2024-02-26 20:25:56,1348896110,36620,202,21,11,8,13
178771,2024-02-26 20:26:09,1348896253,1445,17,8,2,2,6
178772,2024-02-26 20:26:19,1348896429,984,1,4,0,1,3
178773,2024-02-26 20:26:36,1348896661,67234,119,45,17,13,32
178774,2024-02-26 20:27:30,1348897392,64107,147,77,45,12,65
178775,2024-02-26 20:27:40,1348897528,10899,28,23,7,2,21
178775,2024-02-26 20:29:09,1348898745,10899,28,23,7,2,21
178774,2024-02-26 20:31:04,1348900233,64107,147,77,45,12,65
178777,2024-02-26 21:01:41,1348923278,9987,208,30,4,1,29
178776,2024-02-26 21:07:42,1348927726,188295,291,116,90,9,107
178785,2024-02-26 21:09:15,1348928908,23162,123,53,40,6,47
178786,2024-02-26 21:36:56,1348949574,77993,327,51,18,10,41
178789,2024-02-26 21:37:42,1348950162,108271,241,59,35,9,50
178789,2024-02-26 21:38:12,1348950563,108271,241,59,35,9,50
178789,2024-02-26 21:38:30,1348950794,108271,241,59,35,9,50
178791,2024-02-26 21:39:11,1348951340,0,0,10,10,0,10
178789,2024-02-26 21:39:16,1348951397,108271,241,59,35,9,50
178791,2024-02-26 21:39:22,1348951473,0,0,10,10,0,10
178789,2024-02-26 21:39:55,1348951892,108271,241,59,35,9,50
178791,2024-02-26 21:40:10,1348952129,0,0,10,10,0,10
178789,2024-02-26 21:41:00,1348952758,108271,241,59,35,9,50
178793,2024-02-26 21:41:54,1348953462,22557,0,8,4,1,7
178801,2024-02-26 21:51:07,1348960493,30904,69,33,18,7,26
178767,2024-02-26 22:06:29,1348971908,20137,41,18,13,3,15
178765,2024-02-26 22:16:02,1348978762,0,8,59,42,0,59
178807,2024-02-26 22:17:15,1348979644,1628,47,56,39,2,54
178808,2024-02-26 22:17:28,1348979777,11846,48,87,70,3,84
178809,2024-02-26 22:17:40,1348979912,6513,31,91,58,1,90
178810,2024-02-26 22:17:50,1348980021,17267,191,91,44,3,88
178811,2024-02-26 22:17:59,1348980121,0,11,68,52,0,68
178817,2024-02-26 22:37:57,1348994336,3952,37,25,18,2,23
178818,2024-02-26 22:44:20,1348998920,28654,201,44,14,10,34
178790,2024-02-26 22:45:09,1348999456,77350,327,155,67,12,143
166547,2024-02-26 22:54:33,1349005717,489,19,54,25,1,53
170137,2024-02-26 22:55:58,1349006659,0,21,10,0,0,10
166598,2024-02-26 22:56:16,1349006878,129718,97,19,7,3,16
170049,2024-02-26 22:57:44,1349007893,68970,60,65,28,4,61
178839,2024-02-27 14:32:57,1349274244,0,0,5,3,0,5
178840,2024-02-27 14:33:14,1349274351,1379,8,12,4,1,11
178841,2024-02-27 14:33:43,1349274489,7033,170,78,37,3,75
178842,2024-02-27 14:34:01,1349274573,5942,108,22,9,2,20
178843,2024-02-27 14:34:20,1349274693,66375,234,96,32,9,87
178843,2024-02-27 14:36:25,1349275508,66375,234,96,32,9,87
178826,2024-02-27 14:40:37,1349277011,53914,82,20,9,4,16
178827,2024-02-27 14:41:16,1349277250,30231,50,15,9,3,12
178828,2024-02-27 14:41:29,1349277306,0,0,3,1,0,3
178828,2024-02-27 14:41:32,1349277323,0,0,3,1,0,3
178849,2024-02-27 14:41:43,1349277389,24593,28,6,2,2,4
178849,2024-02-27 14:42:05,1349277519,24593,28,6,2,2,4
178850,2024-02-27 14:45:11,1349278697,202522,307,99,52,12,87
178850,2024-02-27 14:46:34,1349279250,202522,307,99,52,12,87
178853,2024-02-27 14:58:08,1349283865,29985,38,18,13,3,15
178853,2024-02-27 14:59:16,1349284340,29985,38,18,13,3,15
178861,2024-02-27 15:36:41,1349303362,0,5,11,3,0,11
162311,2024-02-27 15:54:52,1349314615,3478,21,43,27,2,41
162099,2024-02-27 15:55:08,1349314818,2886,3,9,3,1,8
169470,2024-02-27 16:08:37,1349323230,2686,22,5,1,2,3
168716,2024-02-27 16:31:43,1349339139,28264,157,15,9,4,11
168433,2024-02-27 16:32:11,1349339461,6036,91,25,9,3,22
168395,2024-02-27 16:32:36,1349339757,45605,118,21,8,7,14
168721,2024-02-27 16:32:59,1349340038,55635,176,40,10,9,31
159518,2024-02-27 16:41:45,1349346381,75822,28,71,40,9,62
158884,2024-02-27 16:42:05,1349346647,0,38,35,34,0,35
158889,2024-02-27 16:42:37,1349347065,1480,50,46,30,1,45
158881,2024-02-27 16:43:10,1349347538,9076,14,10,5,1,9
169173,2024-02-27 16:54:49,1349356104,66375,234,96,32,9,87
178879,2024-02-27 17:06:56,1349364973,4175,4,110,68,1,109
178878,2024-02-27 17:08:59,1349366492,8197,6,9,5,1,8
100474,2024-02-27 17:19:14,1349374696,90589,64,96,44,6,90
100474,2024-02-27 17:20:08,1349375557,90589,64,96,44,6,90
100094,2024-02-27 17:20:11,1349375618,128090,142,99,58,13,86
100087,2024-02-27 17:34:41,1349387805,155240,182,117,39,10,107
166574,2024-02-27 17:38:21,1349390745,6882,12,22,3,2,20
166574,2024-02-27 17:39:38,1349391835,6882,12,22,3,2,20
178920,2024-02-27 19:53:02,1349499376,22161,74,18,9,4,14
178922,2024-02-27 19:56:59,1349502527,30748,129,46,28,6,40
178921,2024-02-27 20:06:35,1349510016,28276,67,41,32,3,38
178923,2024-02-27 20:12:17,1349514469,75421,215,37,24,5,32
159747,2024-02-27 21:03:01,1349553516,27007,101,38,12,7,31
159749,2024-02-27 21:04:41,1349554718,26473,39,65,26,1,64
159745,2024-02-27 21:06:27,1349556007,114045,71,116,68,11,105
159750,2024-02-27 21:08:28,1349557594,72357,59,13,4,5,8
168235,2024-02-27 21:11:20,1349559682,0,170,153,74,0,153
168822,2024-02-27 21:13:10,1349561102,35408,33,41,33,3,38
178926,2024-02-27 21:18:46,1349565437,0,14,11,7,0,11
178929,2024-02-27 21:33:16,1349576323,11141,70,40,15,3,37
178837,2024-02-27 21:33:30,1349576491,115594,100,47,35,5,42
178953,2024-02-27 22:20:37,1349610909,128554,236,84,46,10,74
178946,2024-02-27 22:23:53,1349613122,10881,26,27,17,2,25
178938,2024-02-27 22:24:22,1349613457,12883,26,24,14,2,22
178939,2024-02-27 22:24:48,1349613783,1094,8,8,0,1,7
178942,2024-02-27 22:25:06,1349614000,2724,20,66,55,2,64
178947,2024-02-27 22:25:19,1349614167,31224,40,26,18,4,22
178956,2024-02-27 23:06:25,1349643876,12438,52,28,10,3,25
178960,2024-02-27 23:06:45,1349644110,20123,113,8,3,2,6
178995,2024-02-28 00:07:54,1349686370,34964,49,20,14,3,17
178996,2024-02-28 00:10:49,1349688080,13587,130,25,15,2,23
178996,2024-02-28 00:11:51,1349688727,13587,130,25,15,2,23
178997,2024-02-28 00:15:59,1349691382,21008,142,9,6,3,6
178998,2024-02-28 00:22:50,1349695787,5751,20,14,7,2,12
178999,2024-02-28 00:23:01,1349695900,14416,12,17,13,2,15
178998,2024-02-28 00:23:25,1349696148,5751,20,14,7,2,12
178999,2024-02-28 00:23:28,1349696172,14416,12,17,13,2,15
178998,2024-02-28 00:26:28,1349697825,5751,20,14,7,2,12
178999,2024-02-28 00:26:31,1349697849,14416,12,17,13,2,15
179000,2024-02-28 00:26:52,1349698057,58264,111,26,9,9,17
179000,2024-02-28 00:26:59,1349698128,58264,111,26,9,9,17
178998,2024-02-28 00:27:05,1349698201,5751,20,14,7,2,12
178999,2024-02-28 00:28:09,1349698827,14416,12,17,13,2,15
178998,2024-02-28 00:29:44,1349699743,5751,20,14,7,2,12
178999,2024-02-28 00:29:47,1349699771,14416,12,17,13,2,15
178955,2024-02-28 14:22:50,1350062412,41440,45,29,12,4,25
178991,2024-02-28 14:30:27,1350064625,52746,157,15,3,4,11
178985,2024-02-28 14:33:27,1350065654,14017,127,44,26,4,40
162301,2024-02-28 14:39:11,1350067667,15996,193,20,10,4,16
178992,2024-02-28 14:44:16,1350069638,3695,27,18,9,3,15
179010,2024-02-28 14:54:04,1350073799,11826,216,31,14,3,28
178981,2024-02-28 15:08:02,1350080139,91226,211,18,13,11,7
179005,2024-02-28 15:44:17,1350100668,25531,118,98,64,5,93
179017,2024-02-28 15:56:54,1350108738,98628,58,34,23,4,30
179018,2024-02-28 15:58:03,1350109516,61801,166,33,14,9,24
179020,2024-02-28 15:58:45,1350109904,83177,90,22,10,6,16
179021,2024-02-28 15:59:08,1350110155,2686,22,5,1,2,3
179041,2024-02-28 17:04:53,1350157383,47725,67,27,12,6,21
179048,2024-02-28 17:24:43,1350172367,25121,26,166,20,2,164
179057,2024-02-28 17:49:45,1350192461,0,14,11,7,0,11
179059,2024-02-28 17:57:27,1350198751,1821,48,4,1,2,2
178917,2024-02-28 17:58:32,1350199577,12381,90,32,15,3,29
178918,2024-02-28 18:00:03,1350200751,4608,50,12,10,2,10
179054,2024-02-28 18:07:31,1350206790,15677,54,21,13,4,17
179060,2024-02-28 18:49:34,1350240813,125067,57,22,17,4,18
179086,2024-02-28 18:50:15,1350241410,63999,74,71,34,8,63
179105,2024-02-28 19:09:33,1350257614,11417,41,12,10,5,7
179107,2024-02-28 19:26:38,1350271495,75620,62,38,30,6,32
179098,2024-02-28 19:28:29,1350272904,42635,183,41,14,8,33
179078,2024-02-28 19:35:19,1350278727,0,8,59,42,0,59
179111,2024-02-28 19:44:42,1350286572,479,3,13,4,1,12
179113,2024-02-28 20:01:17,1350300485,17332,79,26,19,4,22
179117,2024-02-28 20:12:06,1350309107,71169,210,70,23,10,60
179110,2024-02-28 20:26:32,1350320517,29993,38,12,5,2,10
179141,2024-02-28 21:16:50,1350359469,15996,193,20,10,4,16
179123,2024-02-28 22:00:22,1350392352,24671,41,5,0,2,3
179152,2024-02-28 22:26:55,1350411508,23076,55,17,13,3,14
179157,2024-02-28 22:31:26,1350414782,26046,48,31,15,4,27
179157,2024-02-28 22:31:48,1350415067,26046,48,31,15,4,27
179157,2024-02-28 22:31:56,1350415169,26046,48,31,15,4,27
179156,2024-02-28 22:33:38,1350416447,32898,119,32,15,4,28
179160,2024-02-28 22:54:35,1350431634,13971,6,18,11,1,17
179161,2024-02-28 23:00:14,1350435711,31260,77,51,26,5,46
179159,2024-02-28 23:11:45,1350444623,573,6,3,2,1,2
170230,2024-02-28 23:19:09,1350450336,57962,54,78,34,4,74
170230,2024-02-28 23:19:23,1350450531,57962,54,78,34,4,74
170231,2024-02-28 23:19:40,1350450747,0,1,38,17,0,38
170230,2024-02-28 23:20:18,1350451239,57962,54,78,34,4,74
179162,2024-02-28 23:20:49,1350451715,103214,195,60,27,7,53
170232,2024-02-28 23:23:36,1350453980,81154,84,50,37,4,46
170233,2024-02-28 23:23:56,1350454185,0,0,7,1,0,7
179169,2024-02-28 23:24:22,1350454555,22175,62,37,14,9,28
170234,2024-02-28 23:24:22,1350454572,14897,30,19,11,2,17
179178,2024-02-28 23:38:12,1350465453,14993,107,17,14,4,13
179181,2024-02-28 23:48:03,1350473295,2737,29,25,13,5,20
179183,2024-02-29 00:24:53,1350499507,13626,91,17,7,3,14
179199,2024-02-29 02:13:55,1350560689,49658,189,51,8,9,42
179191,2024-02-29 14:12:31,1350683052,0,308,25,9,0,25
179180,2024-02-29 16:35:54,1350754672,13803,13,4,2,2,2
179201,2024-02-29 16:36:21,1350755109,20785,59,6,4,2,4
179197,2024-02-29 17:06:36,1350777101,8117,8,9,2,2,7
179196,2024-02-29 17:06:38,1350777122,83371,280,16,4,6,10
179225,2024-02-29 17:16:08,1350783933,79703,67,53,15,15,38
179234,2024-02-29 17:16:22,1350784100,16905,8,24,14,1,23
179235,2024-02-29 17:16:32,1350784212,8570,203,137,30,5,132
179238,2024-02-29 17:17:17,1350784925,43644,38,10,4,3,7
179241,2024-02-29 17:51:01,1350810504,6083,7,21,17,1,20
179243,2024-02-29 17:51:08,1350810625,0,0,40,32,0,40
179245,2024-02-29 17:51:15,1350810730,52220,102,27,16,8,19
179207,2024-02-29 17:58:11,1350815652,63546,76,12,5,6,6
178940,2024-02-29 18:15:50,1350829991,10881,26,30,17,2,28
178941,2024-02-29 18:16:07,1350830244,31224,40,26,18,4,22
169061,2024-02-29 18:28:27,1350840247,13398,171,144,70,2,142
169067,2024-02-29 18:30:15,1350841654,0,10,53,37,0,53
169062,2024-02-29 18:31:56,1350843036,0,8,86,46,0,86
169064,2024-02-29 18:33:34,1350844413,9872,33,55,38,1,54
169070,2024-02-29 18:35:13,1350845848,6149,22,45,30,1,44
179264,2024-02-29 18:48:01,1350856236,69079,198,48,35,9,39
179266,2024-02-29 18:55:45,1350862433,18608,516,128,36,8,120
179133,2024-02-29 19:18:39,1350880486,13044,44,47,19,2,45
179133,2024-02-29 19:18:54,1350880716,13044,44,47,19,2,45
179134,2024-02-29 19:18:59,1350880763,28458,142,37,24,6,31
179135,2024-02-29 19:19:05,1350880857,0,4,301,28,0,301
179136,2024-02-29 19:19:13,1350880993,0,6,56,31,0,56
179138,2024-02-29 19:20:18,1350881985,0,14,58,26,0,58
179137,2024-02-29 19:24:59,1350885893,0,0,18,8,0,18
179296,2024-02-29 20:40:08,1350942786,857,34,27,21,2,25
179296,2024-02-29 20:40:39,1350943137,857,34,27,21,2,25
179135,2024-02-29 21:01:11,1350957774,0,4,301,28,0,301
179317,2024-02-29 22:12:37,1351010013,51564,63,29,21,4,25
179317,2024-02-29 22:13:33,1351010653,51564,63,29,21,4,25
179324,2024-02-29 22:44:24,1351032188,2129,283,87,19,2,85
179324,2024-02-29 22:47:41,1351034676,2129,283,87,19,2,85
179343,2024-02-29 23:21:48,1351060796,21842,47,26,11,3,23
179344,2024-02-29 23:22:02,1351060969,2160,33,18,9,1,17
179345,2024-02-29 23:22:14,1351061136,51084,36,25,8,3,22
179346,2024-02-29 23:22:28,1351061304,72760,241,66,32,13,53
179347,2024-02-29 23:22:43,1351061501,3354,25,17,11,1,16
179348,2024-02-29 23:23:42,1351062217,12053,39,8,4,2,6
179318,2024-02-29 23:31:11,1351067542,5649,24,20,8,3,17
179154,2024-03-01 14:20:52,1351294827,92124,90,61,37,17,44
179154,2024-03-01 14:21:10,1351294916,92124,90,61,37,17,44
179380,2024-03-01 14:44:32,1351302354,3710,6,10,5,2,8
179384,2024-03-01 14:44:40,1351302417,23162,123,53,40,6,47
179352,2024-03-01 15:34:37,1351328427,11499,24,45,15,2,43
179412,2024-03-01 15:58:52,1351342339,267326,160,57,27,9,48
179412,2024-03-01 15:59:09,1351342494,267326,160,57,27,9,48
179412,2024-03-01 15:59:48,1351342813,267326,160,57,27,9,48
179412,2024-03-01 16:00:18,1351343077,267326,160,57,27,9,48
179410,2024-03-01 16:32:23,1351362310,49513,167,48,27,10,38
179421,2024-03-01 18:12:28,1351434474,254100,275,49,31,15,34
179424,2024-03-01 18:48:07,1351461848,342,21,45,37,1,44
179426,2024-03-01 18:48:11,1351461901,33442,10,21,18,1,20
179428,2024-03-01 18:48:16,1351461980,0,0,22,17,0,22
179427,2024-03-01 18:56:16,1351468191,20991,25,240,79,1,239
179425,2024-03-01 18:56:18,1351468219,0,1,79,48,0,79
179430,2024-03-01 19:52:46,1351511005,31835,125,18,8,4,14
179436,2024-03-01 19:56:51,1351513850,49194,235,16,5,5,11
179441,2024-03-01 20:18:40,1351529463,22496,65,15,7,2,13
179443,2024-03-01 20:23:36,1351532976,0,6,27,14,0,27
179442,2024-03-01 20:39:08,1351543753,77350,327,155,67,12,143
179446,2024-03-01 21:06:33,1351562857,11782,135,10,4,2,8
179447,2024-03-01 21:07:27,1351563471,10700,6,5,2,1,4
179447,2024-03-01 21:08:19,1351563999,10700,6,5,2,1,4
179449,2024-03-01 21:09:07,1351564580,94412,88,31,16,6,25
43288,2024-03-01 21:12:17,1351566765,239303,397,63,33,17,46
43288,2024-03-01 21:12:23,1351566833,239303,397,63,33,17,46
43288,2024-03-01 21:12:55,1351567195,239303,397,63,33,17,46
43288,2024-03-01 21:13:01,1351567284,239303,397,63,33,17,46
43288,2024-03-01 21:13:21,1351567505,239303,397,63,33,17,46
179450,2024-03-01 21:17:01,1351570126,11939,47,51,18,3,48
179354,2024-03-01 21:26:07,1351576869,40491,155,20,2,2,18
179356,2024-03-01 21:26:28,1351577111,23663,68,34,17,4,30
179451,2024-03-01 21:28:19,1351578424,540,1,20,17,1,19
179451,2024-03-01 21:28:43,1351578670,540,1,20,17,1,19
179454,2024-03-01 22:01:57,1351601593,43361,50,18,11,2,16
179456,2024-03-01 22:05:33,1351604212,1958,42,41,15,2,39
179051,2024-03-01 22:08:43,1351606392,41931,176,52,31,4,48
179457,2024-03-01 22:10:03,1351607205,34829,1,22,14,2,20
179452,2024-03-01 22:10:14,1351607326,82472,199,42,23,9,33
179356,2024-03-01 22:13:18,1351609322,23663,68,34,17,4,30
179444,2024-03-01 22:21:20,1351615414,52050,25,5,2,2,3
179445,2024-03-01 22:22:33,1351616349,0,150,10,5,0,10
179455,2024-03-01 22:23:57,1351617327,4691,1,4,0,1,3
179455,2024-03-01 22:25:01,1351618110,4691,1,4,0,1,3
179460,2024-03-01 22:36:04,1351626386,22707,23,30,19,2,28
179461,2024-03-01 22:42:36,1351631234,0,74,63,39,0,63
179458,2024-03-01 22:53:52,1351639801,51074,338,39,31,10,29
179469,2024-03-01 23:08:38,1351650194,488,8,6,2,1,5
179502,2024-03-02 16:17:34,1352081694,42378,122,32,21,7,25
179510,2024-03-02 17:25:45,1352134480,97808,190,48,22,11,37
179511,2024-03-02 17:58:26,1352162946,76264,349,37,17,13,24
179511,2024-03-02 17:58:46,1352163209,76264,349,37,17,13,24
179511,2024-03-02 17:59:39,1352163901,76264,349,37,17,13,24
179514,2024-03-04 15:06:38,1353332202,32720,40,25,11,4,21
179518,2024-03-04 15:10:01,1353334133,0,0,23,5,0,23
179524,2024-03-04 15:15:09,1353337185,18959,134,15,7,5,10
179526,2024-03-04 15:21:02,1353341180,19139,77,6,2,4,2
179463,2024-03-04 15:24:59,1353343831,57561,142,51,45,5,46
179464,2024-03-04 15:25:00,1353343858,808,5,5,2,1,4
179465,2024-03-04 15:25:06,1353343909,12735,52,17,12,3,14
179466,2024-03-04 15:25:08,1353343949,15640,53,16,13,3,13
179467,2024-03-04 15:25:13,1353344000,82465,231,74,54,10,64
179476,2024-03-04 15:44:06,1353357726,0,29,12,1,0,12
179477,2024-03-04 15:44:14,1353357790,0,11,51,3,0,51
179478,2024-03-04 15:44:17,1353357841,44319,176,32,11,8,24
179479,2024-03-04 15:44:31,1353358020,0,1,3,0,0,3
179541,2024-03-04 16:02:38,1353372401,6152,104,44,30,2,42
179480,2024-03-04 16:04:30,1353373934,0,1,54,21,0,54
179478,2024-03-04 16:04:41,1353374114,44319,176,32,11,8,24
179481,2024-03-04 16:04:50,1353374197,1851,18,21,7,1,20
179482,2024-03-04 16:04:56,1353374264,1954,13,78,19,4,74
179483,2024-03-04 16:05:15,1353374529,115244,178,69,30,10,59
179484,2024-03-04 16:06:56,1353375866,23846,146,48,25,5,43
179531,2024-03-04 16:08:13,1353376881,42228,104,24,9,8,16
179532,2024-03-04 16:11:11,1353379209,18803,161,26,14,7,19
179549,2024-03-04 16:42:13,1353407053,27847,158,57,25,6,51
179551,2024-03-04 16:42:17,1353407118,23071,45,18,8,5,13
179552,2024-03-04 16:42:20,1353407155,0,11,86,69,0,86
179550,2024-03-04 16:42:20,1353407163,8587,114,117,47,2,115
179553,2024-03-04 16:42:22,1353407205,307959,158,32,18,9,23
179562,2024-03-04 18:11:22,1353494923,51947,142,25,17,9,16
179564,2024-03-04 18:11:30,1353495055,46826,83,16,8,6,10
179565,2024-03-04 18:22:21,1353506214,9649,68,7,2,4,3
179574,2024-03-04 18:23:55,1353507933,23450,40,6,0,5,1
179577,2024-03-04 18:42:40,1353526715,56554,36,6,3,4,2
179578,2024-03-04 18:51:18,1353535171,16264,203,23,14,3,20
179581,2024-03-04 18:53:14,1353536928,15410,67,23,8,3,20
179582,2024-03-04 18:53:17,1353536970,1394,5,4,1,1,3
179583,2024-03-04 18:53:20,1353537015,64354,146,29,22,5,24
179584,2024-03-04 18:53:23,1353537046,38542,174,35,26,6,29
179585,2024-03-04 18:53:25,1353537077,40378,71,32,21,6,26
179586,2024-03-04 18:54:59,1353538421,16967,135,34,25,7,27
179593,2024-03-04 20:04:15,1353600175,288760,301,62,8,20,42
179594,2024-03-04 20:04:27,1353600380,754906,238,20,10,10,10
179595,2024-03-04 20:04:37,1353600568,140226,297,33,22,13,20
138904,2024-03-04 20:04:47,1353600704,11120,27,57,39,1,56
179604,2024-03-04 20:38:43,1353629714,10950,48,22,17,1,21
179606,2024-03-04 20:40:59,1353631612,0,0,1,0,0,1
179612,2024-03-04 20:42:37,1353632974,27072,72,36,26,3,33
179614,2024-03-04 21:12:27,1353658291,27274,185,21,12,8,13
179614,2024-03-04 21:13:24,1353659067,27274,185,21,12,8,13
179633,2024-03-04 21:37:15,1353679332,97808,191,48,22,11,37
179633,2024-03-04 21:37:48,1353679807,97808,191,48,22,11,37
179607,2024-03-04 21:56:02,1353694914,92825,56,88,60,4,84
179636,2024-03-04 22:33:23,1353724664,22889,74,52,25,2,50
179637,2024-03-04 23:09:22,1353752822,103352,71,21,16,3,18
179645,2024-03-05 14:38:28,1354030769,87006,335,37,15,11,26
168691,2024-03-05 14:53:11,1354037000,26219,95,27,6,9,18
169239,2024-03-05 14:53:37,1354037198,0,0,3,2,0,3
179652,2024-03-05 14:54:45,1354037681,0,24,41,30,0,41
179653,2024-03-05 14:54:51,1354037726,145594,141,82,59,6,76
179650,2024-03-05 14:54:59,1354037787,348,9,41,33,1,40
179647,2024-03-05 14:55:19,1354037969,84096,19,11,6,2,9
179638,2024-03-05 14:55:31,1354038063,0,2,95,43,0,95
179599,2024-03-05 15:06:26,1354043174,20203,158,38,22,8,30
179622,2024-03-05 15:07:28,1354043690,4104,7,10,10,1,9
179605,2024-03-05 15:07:36,1354043771,0,0,2,0,0,2
179613,2024-03-05 15:07:57,1354043931,16520,40,2,1,1,1
169433,2024-03-05 16:09:30,1354082688,22750,49,26,11,4,22
179688,2024-03-05 16:52:09,1354116433,27358,71,25,20,4,21
131638,2024-03-05 16:54:26,1354118222,23189,37,28,25,6,22
131815,2024-03-05 16:54:54,1354118532,6930,22,44,11,4,40
131633,2024-03-05 16:56:22,1354119803,7342,21,23,20,2,21
131629,2024-03-05 16:56:43,1354120090,16291,71,9,7,4,5
131614,2024-03-05 16:58:15,1354121365,3571,7,14,5,1,13
131599,2024-03-05 16:58:33,1354121620,14176,13,6,4,3,3
163926,2024-03-05 17:00:01,1354122751,10372,32,22,8,2,20
132482,2024-03-05 17:00:10,1354122850,45417,51,93,66,5,88
12168,2024-03-05 17:12:38,1354133172,8939,91,55,19,5,50
179693,2024-03-05 17:54:05,1354168232,3491,26,12,9,2,10
179693,2024-03-05 17:54:19,1354168466,3491,26,12,9,2,10
179693,2024-03-05 17:54:55,1354168964,3491,26,12,9,2,10
179693,2024-03-05 17:55:31,1354169473,3491,26,12,9,2,10
179697,2024-03-05 18:08:41,1354180796,268286,284,190,40,19,171
179626,2024-03-05 18:20:07,1354191099,30574,147,15,9,6,9
179626,2024-03-05 18:21:30,1354192312,30574,147,15,9,6,9
179689,2024-03-05 18:26:58,1354197106,8939,91,55,19,5,50
179716,2024-03-05 19:27:36,1354250140,241203,236,82,29,18,64
179716,2024-03-05 19:28:07,1354250591,241203,236,82,29,18,64
179720,2024-03-05 19:38:42,1354259613,156453,146,63,31,5,58
179722,2024-03-05 19:43:54,1354263782,24538,8,40,36,2,38
179729,2024-03-05 19:45:53,1354265541,228454,116,57,16,10,47
179732,2024-03-05 20:03:32,1354281054,295,3,17,6,1,16
179732,2024-03-05 20:03:33,1354281076,295,3,17,6,1,16
179736,2024-03-05 20:04:02,1354281569,30222,120,10,4,4,6
179733,2024-03-05 20:08:49,1354289075,67208,119,20,10,10,10
179738,2024-03-05 20:09:06,1354289468,150948,98,51,18,6,45
179740,2024-03-05 20:36:29,1354329549,3422,30,33,16,2,31
179744,2024-03-05 20:37:30,1354330987,17768,40,58,32,4,54
179740,2024-03-05 20:37:45,1354331296,3422,30,33,16,2,31
179744,2024-03-05 20:38:20,1354332148,17768,40,58,32,4,54
179737,2024-03-05 20:54:28,1354355662,73985,229,78,52,6,72
179737,2024-03-05 20:55:10,1354356662,73985,229,78,52,6,72
179713,2024-03-05 20:55:21,1354356932,71270,58,38,16,18,20
179761,2024-03-05 20:58:04,1354360685,286502,171,40,35,7,33
179761,2024-03-05 20:59:23,1354362675,286502,172,41,36,7,34
179747,2024-03-05 20:59:55,1354363473,950,15,19,15,2,17
179748,2024-03-05 21:00:04,1354363723,149,11,21,19,1,20
179749,2024-03-05 21:00:14,1354363974,82046,110,42,21,4,38
179752,2024-03-05 21:00:17,1354364050,0,3,5,1,0,5
179750,2024-03-05 21:00:22,1354364162,28403,30,69,64,2,67
179752,2024-03-05 21:01:35,1354366041,0,3,5,1,0,5
179752,2024-03-05 21:01:49,1354366427,0,3,5,1,0,5
179752,2024-03-05 21:02:24,1354367418,0,3,5,1,0,5
179752,2024-03-05 21:03:06,1354368540,0,3,5,1,0,5
179751,2024-03-05 21:05:35,1354372661,9191,13,19,13,1,18
179752,2024-03-05 21:06:23,1354374058,0,3,5,1,0,5
179760,2024-03-05 21:06:36,1354374442,2074,26,4,2,1,3
179752,2024-03-05 21:06:38,1354374471,0,3,5,1,0,5
179759,2024-03-05 21:06:56,1354374967,29172,42,19,12,2,17
179760,2024-03-05 21:07:44,1354376367,2074,26,4,2,1,3
179752,2024-03-05 21:07:52,1354376552,0,3,5,1,0,5
179760,2024-03-05 21:08:17,1354377208,2074,26,4,2,1,3
179760,2024-03-05 21:08:37,1354377801,2074,26,4,2,1,3
179752,2024-03-05 21:09:27,1354379191,0,3,5,1,0,5
179664,2024-03-05 21:11:30,1354382641,13116,79,50,23,10,40
179664,2024-03-05 21:11:32,1354382674,13116,79,50,23,10,40
179664,2024-03-05 21:11:45,1354383068,13116,79,50,23,10,40
179664,2024-03-05 21:11:47,1354383110,13116,79,50,23,10,40
179664,2024-03-05 21:11:51,1354383219,13116,79,50,23,10,40
179664,2024-03-05 21:13:14,1354385422,13116,79,50,23,10,40
179664,2024-03-05 21:13:17,1354385482,13116,79,50,23,10,40
179734,2024-03-05 21:14:37,1354387368,40448,42,17,8,5,12
179756,2024-03-05 21:18:14,1354391104,26669,23,11,9,1,10
179756,2024-03-05 21:18:17,1354391164,26669,23,11,9,1,10
179756,2024-03-05 21:18:22,1354391244,26669,23,11,9,1,10
179756,2024-03-05 21:18:34,1354391448,26669,23,11,9,1,10
179756,2024-03-05 21:18:46,1354391628,26669,23,11,9,1,10
179756,2024-03-05 21:19:54,1354392647,26669,23,11,9,1,10
179734,2024-03-05 21:21:46,1354394251,40448,42,17,8,5,12
179667,2024-03-05 21:23:16,1354395433,31577,41,16,3,2,14
179668,2024-03-05 21:23:46,1354395809,45722,116,63,38,6,57
179762,2024-03-05 21:24:05,1354396102,31903,153,17,9,3,14
179754,2024-03-05 21:24:22,1354396338,39368,54,29,18,2,27
179757,2024-03-05 21:26:07,1354397733,26669,27,45,36,1,44
179765,2024-03-05 21:26:09,1354397761,87898,177,26,14,5,21
179755,2024-03-05 21:30:04,1354400878,18878,46,35,17,4,31
179755,2024-03-05 21:31:11,1354401800,18878,46,35,17,4,31
179666,2024-03-05 21:32:26,1354402810,11899,9,14,9,3,11
179665,2024-03-05 21:32:45,1354403033,23849,202,28,16,6,22
179794,2024-03-05 22:28:26,1354449998,57158,38,65,45,3,62
179794,2024-03-05 22:28:33,1354450075,57158,38,65,45,3,62
179798,2024-03-05 22:55:28,1354471801,5709,156,16,7,2,14
179798,2024-03-05 22:55:34,1354471884,5709,156,16,7,2,14
179799,2024-03-05 23:00:32,1354475686,51300,101,62,29,8,54
179799,2024-03-05 23:01:18,1354476280,51300,101,62,29,8,54
179802,2024-03-05 23:06:51,1354480996,1330,24,3,2,1,2
179802,2024-03-05 23:07:18,1354481335,1330,24,3,2,1,2
179805,2024-03-05 23:18:23,1354489705,44311,170,19,14,6,13
179810,2024-03-05 23:33:33,1354501548,0,0,5,3,0,5
179810,2024-03-05 23:33:38,1354501645,0,0,5,3,0,5
179811,2024-03-05 23:37:37,1354504877,38711,110,66,53,6,60
179812,2024-03-05 23:47:33,1354512307,102220,105,61,26,8,53
179812,2024-03-05 23:48:01,1354512673,102220,105,61,26,8,53
179815,2024-03-05 23:54:38,1354517742,32322,21,8,4,2,6
179818,2024-03-05 23:54:44,1354517798,115429,66,203,31,3,200
179818,2024-03-05 23:54:59,1354517984,115429,66,203,31,3,200
179815,2024-03-05 23:55:01,1354518020,32322,21,8,4,2,6
179815,2024-03-05 23:56:17,1354519015,32322,21,8,4,2,6
179818,2024-03-05 23:56:21,1354519046,115429,66,203,31,3,200
179819,2024-03-05 23:59:14,1354521130,0,15,51,8,0,51
179819,2024-03-05 23:59:51,1354521560,0,15,51,8,0,51
179821,2024-03-06 00:04:06,1354524721,13639,110,94,66,6,88
179824,2024-03-06 00:18:46,1354535905,0,0,8,4,0,8
179834,2024-03-06 00:45:23,1354554450,75195,19,6,4,3,3
179834,2024-03-06 00:45:35,1354554592,75195,19,6,4,3,3
179837,2024-03-06 00:53:38,1354560141,26391,68,12,7,6,6
179838,2024-03-06 00:53:42,1354560184,10956,81,15,14,1,14
179839,2024-03-06 00:58:40,1354563605,13486,62,18,11,5,13
179841,2024-03-06 01:05:15,1354568330,115712,73,30,17,4,26
179841,2024-03-06 01:06:30,1354569300,115712,73,30,17,4,26
179841,2024-03-06 01:06:58,1354569632,115712,73,30,17,4,26
151973,2024-03-06 03:25:20,1354635837,50237,223,111,59,12,99
96812,2024-03-06 03:25:22,1354635850,18212,8,51,37,5,46
95170,2024-03-06 03:25:26,1354635864,39095,183,156,59,5,151
132218,2024-03-06 03:25:30,1354635884,82230,290,266,37,7,259
151973,2024-03-06 03:25:46,1354635985,50237,223,111,59,12,99
132218,2024-03-06 03:27:07,1354636443,82230,290,266,37,7,259
151973,2024-03-06 03:27:12,1354636490,50237,223,111,59,12,99
132218,2024-03-06 03:28:42,1354637009,82230,290,266,37,7,259
132218,2024-03-06 03:29:01,1354637092,82230,290,266,37,7,259
132218,2024-03-06 03:29:15,1354637177,82230,290,266,37,7,259
132218,2024-03-06 03:29:26,1354637224,82230,290,266,37,7,259
95170,2024-03-06 03:29:29,1354637235,39095,183,156,59,5,151
151973,2024-03-06 03:29:36,1354637270,50237,223,111,59,12,99
95170,2024-03-06 03:29:46,1354637320,39095,183,156,59,5,151
132218,2024-03-06 03:29:50,1354637334,82230,290,266,37,7,259
95170,2024-03-06 03:30:54,1354637748,39095,183,156,59,5,151
96812,2024-03-06 03:31:08,1354637874,18212,8,51,37,5,46
151973,2024-03-06 03:31:17,1354637942,50237,223,111,59,12,99
95170,2024-03-06 03:31:27,1354637986,39095,183,156,59,5,151
151973,2024-03-06 03:32:33,1354638362,50237,223,111,59,12,99
132218,2024-03-06 03:34:29,1354639013,82230,290,266,37,7,259
132218,2024-03-06 03:37:01,1354639848,82230,290,266,37,7,259
179770,2024-03-06 14:36:01,1354760569,59983,72,11,9,7,4
179774,2024-03-06 14:36:11,1354760631,29923,35,21,3,4,17
179776,2024-03-06 14:36:19,1354760708,64139,106,26,6,8,18
179778,2024-03-06 14:36:33,1354760791,115417,187,22,9,12,10
179779,2024-03-06 14:36:46,1354760880,6251,13,29,22,4,25
179782,2024-03-06 14:48:41,1354765647,85869,186,40,25,18,22
179822,2024-03-06 14:52:01,1354766942,0,0,2,1,0,2
179788,2024-03-06 14:55:05,1354768204,127022,102,38,33,8,30
179792,2024-03-06 14:55:21,1354768305,12934,77,12,6,3,9
179803,2024-03-06 14:56:00,1354768601,43392,108,20,6,4,16
179816,2024-03-06 14:56:18,1354768740,114100,170,27,8,5,22
179823,2024-03-06 14:57:25,1354769221,42282,434,55,2,26,29
179825,2024-03-06 15:00:52,1354770793,9034,13,3,0,1,2
179827,2024-03-06 15:02:32,1354771621,3487,14,5,3,2,3
179827,2024-03-06 15:02:44,1354771701,3487,14,5,3,2,3
179832,2024-03-06 15:02:52,1354771754,26698,24,6,2,1,5
179700,2024-03-06 15:27:27,1354784305,24556,81,49,27,4,45
179701,2024-03-06 15:27:31,1354784336,34715,101,48,21,5,43
179702,2024-03-06 15:27:35,1354784375,12373,127,36,9,3,33
179703,2024-03-06 15:27:43,1354784418,15041,122,8,5,4,4
179704,2024-03-06 15:27:44,1354784439,111653,111,67,24,5,62
179783,2024-03-06 15:30:34,1354786063,582,107,44,25,3,41
179735,2024-03-06 15:32:34,1354787342,86164,327,34,22,9,25
179739,2024-03-06 15:32:48,1354787498,18839,134,54,38,6,48
179763,2024-03-06 15:33:01,1354787612,89407,195,26,19,9,17
179767,2024-03-06 15:33:14,1354787773,179792,278,59,22,5,54
179769,2024-03-06 15:33:23,1354787879,63135,65,30,21,10,20
179769,2024-03-06 15:34:18,1354788380,63135,65,30,21,10,20
179771,2024-03-06 15:34:30,1354788499,136228,144,26,11,11,15
179773,2024-03-06 15:34:38,1354788574,28342,38,14,9,3,11
179777,2024-03-06 15:34:51,1354788703,77777,48,22,4,5,17
169725,2024-03-06 15:54:56,1354801522,7824,111,29,13,4,25
160616,2024-03-06 15:55:14,1354801716,73205,184,107,70,9,98
161524,2024-03-06 15:55:33,1354801910,7104,3,34,18,1,33
160613,2024-03-06 15:55:53,1354802130,71041,184,76,46,9,67
161538,2024-03-06 15:56:11,1354802329,94922,99,60,39,10,50
179766,2024-03-06 16:15:10,1354815347,0,1,10,4,0,10
179768,2024-03-06 16:17:05,1354816765,19123,41,17,5,4,13
179850,2024-03-06 16:18:12,1354817626,15043,59,11,5,5,6
179770,2024-03-06 16:31:40,1354827607,59983,72,11,9,7,4
179788,2024-03-06 16:32:22,1354828176,127022,102,38,33,8,30
179874,2024-03-06 16:40:05,1354834157,41931,176,52,31,4,48
179875,2024-03-06 17:19:23,1354864874,47067,64,15,6,6,9
179887,2024-03-06 17:27:44,1354871878,0,24,4,2,0,4
179895,2024-03-06 17:33:01,1354876188,28993,93,36,19,3,33
179896,2024-03-06 17:34:25,1354877356,39243,100,85,41,4,81
179897,2024-03-06 17:34:46,1354877523,126030,161,766,74,10,756
179898,2024-03-06 17:34:54,1354877741,43092,41,72,45,2,70
179897,2024-03-06 17:38:33,1354880627,126030,161,766,74,10,756
179893,2024-03-06 17:54:15,1354893961,72705,133,26,16,10,16
179886,2024-03-06 18:11:31,1354908316,24227,85,19,9,11,8
179911,2024-03-06 18:18:37,1354914467,17999,61,85,43,4,81
179912,2024-03-06 18:23:17,1354918577,20205,45,69,39,7,62
179914,2024-03-06 18:26:38,1354921462,10450,44,39,29,4,35
179914,2024-03-06 18:27:05,1354921860,10450,44,39,29,4,35
179916,2024-03-06 18:36:50,1354930206,7461,30,26,8,2,24
179919,2024-03-06 18:37:57,1354931099,97290,114,58,31,4,54
179920,2024-03-06 18:40:27,1354933159,67286,97,27,21,10,17
179921,2024-03-06 18:44:28,1354936465,29605,158,63,45,5,58
179924,2024-03-06 18:52:17,1354943281,27457,51,41,26,6,35
179903,2024-03-06 18:52:46,1354943622,31010,27,60,38,5,55
179891,2024-03-06 18:54:27,1354945036,55079,59,23,8,3,20
179923,2024-03-06 18:55:34,1354945924,90683,192,28,7,10,18
179925,2024-03-06 18:58:28,1354948432,13113,32,12,5,4,8
179925,2024-03-06 18:59:10,1354949043,13113,32,12,5,4,8
179927,2024-03-06 19:11:04,1354959390,5795,43,42,31,2,40
179929,2024-03-06 19:35:22,1354979603,32863,153,34,11,3,31
179943,2024-03-06 20:17:44,1355014619,19236,123,8,3,4,4
179945,2024-03-06 20:26:33,1355021739,1195350,286,81,42,9,72
179945,2024-03-06 20:27:52,1355022765,1195350,286,81,42,9,72
169466,2024-03-06 20:27:53,1355022788,34047,140,14,4,3,11
179945,2024-03-06 20:27:58,1355022830,1195350,286,81,42,9,72
179942,2024-03-06 20:28:16,1355023064,0,0,9,7,0,9
179901,2024-03-06 20:30:04,1355024451,23525,89,70,32,6,64
179942,2024-03-06 20:30:10,1355024561,0,0,9,7,0,9
169466,2024-03-06 20:30:53,1355025134,34047,140,14,4,3,11
179942,2024-03-06 20:31:35,1355025724,0,0,9,7,0,9
169466,2024-03-06 20:31:37,1355025753,34047,140,14,4,3,11
179901,2024-03-06 20:31:39,1355025765,23525,89,70,32,6,64
179901,2024-03-06 20:31:49,1355025933,23525,89,70,32,6,64
169466,2024-03-06 20:32:42,1355026676,34047,140,14,4,3,11
169466,2024-03-06 20:32:52,1355026797,34047,140,14,4,3,11
169498,2024-03-06 20:33:37,1355027471,21750,85,20,15,3,17
179901,2024-03-06 20:33:45,1355027591,23525,89,70,32,6,64
169498,2024-03-06 20:34:34,1355028288,21750,85,20,15,3,17
179901,2024-03-06 20:34:54,1355028469,23525,89,70,32,6,64
179901,2024-03-06 20:35:56,1355029369,23525,89,70,32,6,64
169466,2024-03-06 20:37:36,1355030656,34047,140,14,4,3,11
169466,2024-03-06 20:38:21,1355031213,34047,140,14,4,3,11
169466,2024-03-06 20:38:30,1355031319,34047,140,14,4,3,11
169498,2024-03-06 20:39:18,1355031903,21750,85,20,15,3,17
169498,2024-03-06 20:40:41,1355032919,21750,85,20,15,3,17
169537,2024-03-06 20:41:13,1355033313,1381,21,36,28,1,35
169541,2024-03-06 20:42:43,1355034415,38541,182,23,10,3,20
169541,2024-03-06 20:43:05,1355034710,38541,182,23,10,3,20
169541,2024-03-06 20:44:04,1355035441,38541,182,23,10,3,20
169487,2024-03-06 21:39:28,1355082937,15282,5,5,3,3,2
169487,2024-03-06 21:39:46,1355083144,15282,5,5,3,3,2
169487,2024-03-06 21:40:42,1355083929,15282,5,5,3,3,2
179960,2024-03-06 22:06:13,1355106048,13665,134,36,13,4,32
179842,2024-03-06 22:13:27,1355112129,21492,233,55,25,3,52
179959,2024-03-06 22:16:18,1355114568,64377,163,30,25,7,23
179842,2024-03-06 22:18:12,1355116308,21492,233,55,25,3,52
179961,2024-03-06 22:20:47,1355118501,107013,178,15,13,8,7
179956,2024-03-06 22:32:59,1355128612,31395,86,19,10,4,15
179968,2024-03-06 22:48:07,1355141188,0,0,38,12,0,38
179963,2024-03-06 22:49:08,1355142012,141883,208,28,20,10,18
179965,2024-03-06 22:56:23,1355147810,4201,59,23,13,3,20
179973,2024-03-06 23:05:17,1355155050,22295,77,19,9,5,14
179974,2024-03-06 23:09:43,1355158540,40711,106,35,26,8,27
179974,2024-03-06 23:09:48,1355158605,40711,106,35,26,8,27
179974,2024-03-06 23:10:20,1355159048,40711,106,35,26,8,27
179993,2024-03-07 14:28:16,1355516822,62143,89,14,11,7,7
179975,2024-03-07 14:47:45,1355525708,11760,30,16,5,2,14
180004,2024-03-07 14:49:41,1355526683,41479,201,40,17,5,35
179976,2024-03-07 14:51:30,1355527583,30840,257,28,18,6,22
179978,2024-03-07 14:57:03,1355530335,23609,16,12,2,2,10
179952,2024-03-07 15:00:10,1355531932,9197,13,8,4,3,5
179966,2024-03-07 15:00:59,1355532390,329412,244,76,55,15,61
180005,2024-03-07 15:01:03,1355532436,83171,198,37,24,6,31
180022,2024-03-07 15:08:07,1355536414,2240,26,27,7,2,25
180022,2024-03-07 15:08:56,1355536870,2240,26,27,7,2,25
180022,2024-03-07 15:09:21,1355537110,2240,26,27,7,2,25
180022,2024-03-07 15:09:42,1355537293,2240,26,27,7,2,25
180024,2024-03-07 15:33:43,1355552627,82472,199,42,23,9,33
180027,2024-03-07 15:34:05,1355552886,6595,27,37,16,3,34
179977,2024-03-07 15:34:17,1355553055,6499,21,14,11,3,11
179913,2024-03-07 15:47:56,1355563150,53623,156,32,10,11,21
30153,2024-03-07 15:54:58,1355568274,15308,87,121,54,4,117
179918,2024-03-07 15:58:43,1355571001,934,71,16,3,4,12
179948,2024-03-07 16:01:29,1355573225,484,1,1,0,1,0
179987,2024-03-07 16:05:13,1355576030,176414,139,348,21,12,336
179986,2024-03-07 16:05:25,1355576200,33075,156,58,27,8,50
179985,2024-03-07 16:05:33,1355576298,1956,53,14,9,1,13
179984,2024-03-07 16:05:50,1355576499,48129,159,41,17,7,34
179983,2024-03-07 16:05:59,1355576638,0,0,53,21,0,53
179983,2024-03-07 16:06:52,1355577283,0,0,53,21,0,53
179982,2024-03-07 16:07:26,1355577714,11595,19,14,9,2,12
179980,2024-03-07 16:08:02,1355578170,15890,22,33,4,7,26
179917,2024-03-07 16:20:45,1355588602,17979,27,9,5,2,7
148528,2024-03-07 16:22:15,1355589800,15308,87,121,54,4,117
180028,2024-03-07 16:27:49,1355594173,42014,85,22,11,5,17
180030,2024-03-07 16:29:12,1355595330,3840,6,3,0,1,2
180042,2024-03-07 16:29:26,1355595485,59353,51,85,5,5,80
180050,2024-03-07 16:29:36,1355595593,7925,40,48,25,5,43
180056,2024-03-07 16:29:39,1355595653,30819,41,14,7,3,11
180051,2024-03-07 16:29:46,1355595727,29160,226,30,9,8,22
180057,2024-03-07 16:35:51,1355600687,857,7,18,5,3,15
179985,2024-03-07 16:38:26,1355602806,1956,53,14,9,1,13
180058,2024-03-07 16:47:48,1355610485,0,0,8,7,0,8
180072,2024-03-07 17:48:36,1355664077,27182,115,35,13,8,27
180073,2024-03-07 17:48:46,1355664252,0,0,64,39,0,64
180074,2024-03-07 17:48:55,1355664401,3991,38,19,15,1,18
180075,2024-03-07 17:49:05,1355664550,32911,130,32,21,2,30
180076,2024-03-07 17:49:16,1355664759,26027,86,89,48,7,82
180079,2024-03-07 17:50:28,1355665887,27182,115,35,13,8,27
180080,2024-03-07 17:50:41,1355666088,0,0,64,39,0,64
180081,2024-03-07 17:51:06,1355666450,3991,38,19,15,1,18
180082,2024-03-07 17:51:24,1355666695,32911,130,32,21,2,30
180064,2024-03-07 17:56:35,1355671302,178273,83,46,13,5,41
180088,2024-03-07 18:32:14,1355705867,57103,61,23,8,3,20
180098,2024-03-07 19:26:18,1355761014,116752,79,28,20,7,21
180101,2024-03-07 19:27:53,1355762472,3074,9,3,1,2,1
75965,2024-03-07 19:28:40,1355763227,42853,103,74,32,16,58
180101,2024-03-07 19:29:05,1355763591,3074,9,3,1,2,1
180100,2024-03-07 19:29:44,1355764198,28755,139,26,18,6,20
180100,2024-03-07 19:29:54,1355764317,28755,139,26,18,6,20
180100,2024-03-07 19:30:08,1355764522,28755,139,26,18,6,20
180100,2024-03-07 19:30:21,1355764717,28755,139,26,18,6,20
180100,2024-03-07 19:30:54,1355765239,28755,139,26,18,6,20
180100,2024-03-07 19:37:19,1355771225,28755,139,26,18,6,20
180100,2024-03-07 19:37:23,1355771274,28755,139,26,18,6,20
180100,2024-03-07 19:37:36,1355771506,28755,139,26,18,6,20
179899,2024-03-07 19:39:49,1355773439,118196,284,66,38,13,53
180102,2024-03-07 19:46:55,1355779975,61261,35,43,32,6,37
85363,2024-03-07 19:52:25,1355785085,29964,61,38,6,2,36
179843,2024-03-07 19:53:02,1355785598,116998,217,136,34,13,123
179843,2024-03-07 19:53:36,1355786099,116998,217,136,34,13,123
179843,2024-03-07 19:54:22,1355786798,116998,217,136,34,13,123
179843,2024-03-07 19:55:12,1355787515,116998,217,136,34,13,123
170247,2024-03-07 20:07:07,1355798280,12242,17,19,4,3,16
170247,2024-03-07 20:07:29,1355798651,12242,17,19,4,3,16
170247,2024-03-07 20:08:36,1355799655,12242,17,19,4,3,16
170479,2024-03-07 20:12:35,1355803147,1763,1,13,4,1,12
169631,2024-03-07 20:15:30,1355805792,63621,88,16,4,4,12
169624,2024-03-07 20:23:01,1355812589,0,3,58,9,0,58
169624,2024-03-07 20:23:06,1355812660,0,3,58,9,0,58
180124,2024-03-07 20:39:43,1355827032,3792,15,11,6,6,5
180124,2024-03-07 20:40:41,1355827788,3792,15,11,6,6,5
180097,2024-03-07 21:00:06,1355844424,898,22,18,11,1,17
180097,2024-03-07 21:00:56,1355845164,898,22,18,11,1,17
180112,2024-03-07 21:01:58,1355846052,189641,186,80,40,9,71
180113,2024-03-07 21:02:07,1355846197,32585,79,44,27,4,40
180114,2024-03-07 21:02:18,1355846351,90150,269,73,31,6,67
180115,2024-03-07 21:02:26,1355846459,195776,30,108,58,4,104
180096,2024-03-07 21:04:39,1355848291,302550,124,36,22,4,32
180096,2024-03-07 21:04:43,1355848353,302550,124,36,22,4,32
180128,2024-03-07 21:05:33,1355849101,12949,23,16,7,2,14
180095,2024-03-07 21:05:49,1355849320,318361,60,171,23,7,164
180112,2024-03-07 21:05:59,1355849485,189641,186,80,40,9,71
180094,2024-03-07 21:06:33,1355849958,0,4,10,3,0,10
180113,2024-03-07 21:07:07,1355850404,32585,79,44,27,4,40
180094,2024-03-07 21:07:12,1355850465,0,4,10,3,0,10
180094,2024-03-07 21:07:55,1355851041,0,4,10,3,0,10
180129,2024-03-07 21:09:32,1355852365,34373,161,63,17,13,50
179996,2024-03-07 21:09:53,1355852693,7551,6,14,6,2,12
180087,2024-03-07 21:11:40,1355854196,0,31,12,5,0,12
180091,2024-03-07 21:15:33,1355857392,51712,95,26,17,5,21
180128,2024-03-07 21:15:34,1355857415,12949,23,16,7,2,14
180091,2024-03-07 21:15:41,1355857510,51712,95,26,17,5,21
180091,2024-03-07 21:15:48,1355857618,51712,95,26,17,5,21
180089,2024-03-07 21:18:44,1355860178,1077,53,27,15,1,26
180089,2024-03-07 21:19:01,1355860422,1077,53,27,15,1,26
180089,2024-03-07 21:19:25,1355860787,1077,53,27,15,1,26
180087,2024-03-07 21:19:55,1355861191,0,31,12,5,0,12
180087,2024-03-07 21:19:56,1355861213,0,31,12,5,0,12
180087,2024-03-07 21:20:43,1355861857,0,31,12,5,0,12
180087,2024-03-07 21:20:45,1355861877,0,31,12,5,0,12
180087,2024-03-07 21:21:37,1355862571,0,31,12,5,0,12
180129,2024-03-07 21:22:32,1355863240,34373,179,64,17,13,51
180089,2024-03-07 21:23:06,1355863693,1077,53,27,15,1,26
180132,2024-03-07 21:28:50,1355868323,97097,154,37,17,7,30
180132,2024-03-07 21:28:51,1355868344,97097,154,37,17,7,30
180132,2024-03-07 21:28:55,1355868408,97097,154,37,17,7,30
180132,2024-03-07 21:32:19,1355871470,97097,154,37,17,7,30
180132,2024-03-07 21:32:20,1355871491,97097,154,37,17,7,30
180132,2024-03-07 21:32:38,1355871703,97097,154,37,17,7,30
180136,2024-03-07 21:40:10,1355878181,70412,84,43,20,6,37
180136,2024-03-07 21:40:11,1355878210,70412,84,43,20,6,37
180136,2024-03-07 21:40:37,1355878570,70412,84,43,20,6,37
180136,2024-03-07 21:41:50,1355879588,70412,84,43,20,6,37
180136,2024-03-07 21:41:52,1355879614,70412,84,43,20,6,37
180136,2024-03-07 21:42:17,1355879963,70412,84,43,20,6,37
179972,2024-03-07 21:49:19,1355885989,86497,74,16,7,5,11
180129,2024-03-07 22:04:31,1355898689,34373,179,64,17,13,51
180145,2024-03-07 22:07:26,1355901220,115417,187,22,9,12,10
180128,2024-03-07 22:13:49,1355906275,12949,23,16,7,2,14
180148,2024-03-07 22:22:47,1355913463,45576,145,39,8,4,35
179932,2024-03-07 22:27:13,1355916911,1553,11,8,2,1,7
179933,2024-03-07 22:27:20,1355916982,24544,71,10,4,3,7
179934,2024-03-07 22:27:29,1355917032,58917,85,807,35,6,801
179935,2024-03-07 22:27:29,1355917080,0,0,2,0,0,2
179936,2024-03-07 22:27:35,1355917125,88194,45,31,1,3,28
179849,2024-03-07 23:02:05,1355943538,11064,70,2,2,2,0
179849,2024-03-07 23:03:25,1355944571,11064,70,2,2,2,0
180167,2024-03-07 23:20:49,1355957877,21745,42,35,26,5,30
180168,2024-03-07 23:20:50,1355957886,60382,354,45,25,6,39
180169,2024-03-07 23:20:52,1355957914,22227,218,35,20,3,32
180170,2024-03-07 23:20:57,1355957950,81129,442,154,54,9,145
180171,2024-03-07 23:22:15,1355958922,6229,36,59,48,2,57
180172,2024-03-07 23:22:31,1355959094,125899,171,46,29,9,37
180108,2024-03-07 23:35:25,1355969014,0,6,16,10,0,16
180174,2024-03-08 14:11:40,1356323389,0,27,29,16,0,29
180174,2024-03-08 14:11:46,1356323416,0,27,29,16,0,29
180174,2024-03-08 14:11:48,1356323428,0,27,29,16,0,29
180174,2024-03-08 14:12:33,1356323695,0,27,29,16,0,29
180174,2024-03-08 14:13:20,1356323963,0,27,29,16,0,29
180174,2024-03-08 14:13:26,1356324002,0,27,29,16,0,29
180174,2024-03-08 14:13:29,1356324017,0,27,29,16,0,29
180174,2024-03-08 14:13:52,1356324162,0,27,29,16,0,29
180174,2024-03-08 14:14:05,1356324246,0,27,29,16,0,29
180174,2024-03-08 14:14:15,1356324301,0,27,29,16,0,29
180140,2024-03-08 14:14:33,1356324402,26374,43,5,3,4,1
180140,2024-03-08 14:14:56,1356324538,26374,43,5,3,4,1
180174,2024-03-08 14:15:53,1356324927,0,27,29,16,0,29
180140,2024-03-08 14:16:57,1356325293,26374,43,5,3,4,1
180174,2024-03-08 14:17:05,1356325344,0,27,29,16,0,29
180174,2024-03-08 14:17:07,1356325361,0,27,29,16,0,29
180140,2024-03-08 14:17:20,1356325437,26374,43,5,3,4,1
180190,2024-03-08 14:23:29,1356327558,15819,9,6,4,1,5
180154,2024-03-08 14:23:45,1356327670,57676,127,20,7,7,13
180179,2024-03-08 14:24:03,1356327761,4503,13,30,22,3,27
180190,2024-03-08 14:24:14,1356327865,15819,9,6,4,1,5
180191,2024-03-08 14:24:43,1356327996,0,0,4,2,0,4
180192,2024-03-08 14:25:15,1356328159,19628,100,30,11,6,24
180193,2024-03-08 14:25:28,1356328239,0,0,2,0,0,2
180195,2024-03-08 14:26:25,1356328556,16747,40,18,15,3,15
180196,2024-03-08 14:26:41,1356328653,94898,97,41,19,3,38
180062,2024-03-08 14:32:20,1356330811,7297,142,27,14,3,24
180062,2024-03-08 14:33:12,1356331100,7297,142,27,14,3,24
180137,2024-03-08 14:40:01,1356333967,3491,27,12,9,2,10
180137,2024-03-08 14:40:12,1356334071,3491,27,12,9,2,10
180060,2024-03-08 14:42:08,1356334921,54787,110,14,8,5,9
180203,2024-03-08 14:47:08,1356337212,24926,37,27,25,2,25
180205,2024-03-08 14:49:11,1356338112,4548,59,12,3,4,8
180206,2024-03-08 14:50:06,1356338553,0,0,15,10,0,15
180207,2024-03-08 14:50:16,1356338610,30400,101,51,40,4,47
180208,2024-03-08 14:50:24,1356338676,16661,51,48,31,3,45
180209,2024-03-08 14:50:37,1356338760,0,0,11,8,0,11
180198,2024-03-08 15:03:39,1356344814,24538,8,40,36,2,38
180211,2024-03-08 15:04:09,1356345061,6253,19,12,3,2,10
180166,2024-03-08 15:52:27,1356374173,7967,375,22,7,2,20
180165,2024-03-08 15:52:30,1356374190,36111,166,16,4,5,11
180184,2024-03-08 15:54:43,1356375663,21854,52,63,6,1,62
180154,2024-03-08 16:10:53,1356386771,57676,127,20,7,7,13
180222,2024-03-08 16:12:09,1356387649,32582,32,73,45,7,66
180223,2024-03-08 16:12:19,1356387770,80539,152,41,28,8,33
180226,2024-03-08 16:12:29,1356387885,2231,162,54,36,5,49
180231,2024-03-08 16:34:56,1356404280,213943,170,59,36,5,54
10713,2024-03-08 16:39:30,1356407753,165235,151,27,7,7,20
180233,2024-03-08 16:41:35,1356409352,9399,26,14,8,4,10
180229,2024-03-08 16:57:51,1356422302,57595,45,52,45,4,48
170619,2024-03-08 17:13:18,1356435195,74740,283,82,47,14,68
149906,2024-03-08 17:13:35,1356435421,157362,268,129,64,8,121
150331,2024-03-08 17:13:37,1356435450,6559,262,57,19,3,54
161799,2024-03-08 17:13:42,1356435467,13455,120,83,63,4,79
99151,2024-03-08 17:13:39,1356435477,83275,123,44,21,10,34
112988,2024-03-08 17:13:45,1356435523,5625,82,66,17,2,64
149906,2024-03-08 17:14:00,1356435724,157362,268,129,64,8,121
161787,2024-03-08 17:14:01,1356435755,14746,45,19,13,2,17
161747,2024-03-08 17:14:27,1356436108,0,0,6,4,0,6
161749,2024-03-08 17:15:15,1356436750,129001,186,81,60,8,73
180185,2024-03-08 17:40:23,1356458864,857,7,18,5,3,15
180116,2024-03-08 17:45:18,1356463291,229296,239,27,20,11,16
180106,2024-03-08 17:45:20,1356463318,53152,122,84,70,5,79
180109,2024-03-08 17:45:22,1356463352,22146,201,14,6,12,2
180119,2024-03-08 17:45:23,1356463382,43513,61,18,13,5,13
180119,2024-03-08 17:45:26,1356463417,43513,61,18,13,5,13
180069,2024-03-08 17:46:55,1356464855,19133,63,17,5,3,14
180117,2024-03-08 17:46:58,1356464885,33146,146,7,6,5,2
180123,2024-03-08 17:47:02,1356464935,63162,63,24,19,5,19
180180,2024-03-08 17:47:04,1356464982,946,13,21,14,2,19
180194,2024-03-08 17:49:49,1356467527,4142,107,28,22,2,26
180258,2024-03-08 18:04:57,1356480607,4574,42,9,6,2,7
180261,2024-03-08 18:05:06,1356480773,49763,60,14,8,3,11
180269,2024-03-08 18:21:56,1356495683,50748,201,15,7,3,12
180270,2024-03-08 18:21:57,1356495693,129339,200,44,31,8,36
180271,2024-03-08 18:21:59,1356495727,52730,99,56,36,5,51
180272,2024-03-08 18:22:01,1356495754,6515,12,18,12,1,17
180273,2024-03-08 18:22:03,1356495800,40022,73,49,27,4,45
180274,2024-03-08 18:23:37,1356497172,26712,45,14,11,2,12
180273,2024-03-08 18:29:13,1356502159,40022,73,49,27,4,45
180275,2024-03-08 19:02:43,1356531165,12089,58,129,8,3,126
180275,2024-03-08 19:04:03,1356532460,12089,58,129,8,3,126
180260,2024-03-08 19:05:23,1356533636,28890,229,104,73,5,99
180260,2024-03-08 19:05:27,1356533711,28890,229,104,73,5,99
180260,2024-03-08 19:06:23,1356534527,28890,229,104,73,5,99
180259,2024-03-08 19:07:29,1356535476,30738,343,61,19,5,56
180259,2024-03-08 19:08:22,1356536269,30738,343,61,19,5,56
151575,2024-03-08 19:09:08,1356537020,296100,54,29,20,5,24
180241,2024-03-08 19:09:59,1356537719,79618,273,54,29,14,40
180241,2024-03-08 19:10:07,1356537834,79618,273,54,29,14,40
180241,2024-03-08 19:10:54,1356538523,79618,273,54,29,14,40
180241,2024-03-08 19:10:55,1356538547,79618,273,54,29,14,40
180241,2024-03-08 19:11:20,1356538911,79618,273,54,29,14,40
180281,2024-03-08 19:33:30,1356559552,13340,160,55,19,7,48
35738,2024-03-08 19:43:38,1356577723,106686,201,91,34,7,84
47135,2024-03-08 19:43:48,1356578101,140856,182,61,42,5,56
180243,2024-03-08 19:43:59,1356578456,40188,42,20,11,3,17
180244,2024-03-08 19:44:01,1356578491,18721,156,44,19,3,41
180245,2024-03-08 19:44:08,1356578745,13234,31,24,14,2,22
180246,2024-03-08 19:44:59,1356580338,1678,12,20,8,2,18
180247,2024-03-08 19:45:04,1356580544,17559,25,11,6,1,10
180247,2024-03-08 19:45:45,1356581949,17559,25,11,6,1,10
180248,2024-03-08 19:45:48,1356582003,63085,135,96,56,9,87
180278,2024-03-08 20:04:14,1356621862,14937,49,4,3,1,3
180163,2024-03-08 20:04:41,1356622903,69297,93,23,20,3,20
180291,2024-03-08 20:17:29,1356649015,69022,220,58,42,9,49
180133,2024-03-08 20:19:07,1356652478,11249,283,40,1,6,34
180133,2024-03-08 20:19:51,1356653916,11249,283,40,1,6,34
180134,2024-03-08 20:26:34,1356666612,15110,121,79,14,5,74
180135,2024-03-08 20:29:02,1356671474,1100,20,13,4,1,12
179758,2024-03-08 21:09:48,1356745864,26669,26,39,25,1,38
180312,2024-03-08 21:24:05,1356778183,115417,187,22,9,12,10
179946,2024-03-08 21:26:18,1356785027,87057,40,28,6,3,25
179950,2024-03-08 21:26:30,1356785729,2398,8,4,3,1,3
179953,2024-03-08 21:26:50,1356786879,21579,32,11,8,2,9
179946,2024-03-08 21:28:44,1356792778,87057,40,28,6,3,25
179950,2024-03-08 21:28:54,1356793452,2398,8,4,3,1,3
180315,2024-03-08 21:37:06,1356824630,35903,19,18,7,1,17
180316,2024-03-08 21:37:14,1356825173,225546,305,87,23,6,81
180317,2024-03-08 21:37:17,1356825342,663,2,127,25,1,126
180318,2024-03-08 21:37:23,1356825731,35903,17,11,6,1,10
180318,2024-03-08 21:37:29,1356826194,35903,17,11,6,1,10
180116,2024-03-08 21:39:56,1356835784,229296,239,27,20,11,16
180320,2024-03-08 21:40:21,1356837494,63131,53,71,37,4,67
180319,2024-03-08 21:41:05,1356840076,11845,241,58,26,5,53
180264,2024-03-08 21:48:26,1356847212,167709,144,25,18,3,22
180279,2024-03-08 21:48:44,1356847630,38655,46,4,1,4,0
180321,2024-03-08 21:52:24,1356860746,437262,327,63,29,8,55
180235,2024-03-08 21:53:22,1356863452,28244,47,67,40,3,64
180236,2024-03-08 21:53:37,1356863800,528,47,90,45,1,89
180237,2024-03-08 21:53:44,1356863927,42239,87,106,42,7,99
180238,2024-03-08 21:53:53,1356864166,23427,93,195,63,7,188
180239,2024-03-08 21:53:58,1356864296,698,11,20,9,1,19
180244,2024-03-08 22:00:21,1356867610,18721,156,44,19,3,41
180246,2024-03-08 22:01:24,1356868056,1678,12,20,8,2,18
170622,2024-03-08 22:05:01,1356870143,97097,154,37,17,7,30
167959,2024-03-08 22:09:03,1356872158,26669,26,39,25,1,38
180315,2024-03-08 22:09:26,1356872326,35903,19,18,7,1,17
180317,2024-03-08 22:09:38,1356872413,663,2,127,25,1,126
180317,2024-03-08 22:10:25,1356872678,663,2,127,25,1,126
180315,2024-03-08 22:10:35,1356872712,35903,19,18,7,1,17
179991,2024-03-08 22:20:08,1356877664,2538,12,5,0,1,4
179957,2024-03-08 22:20:20,1356877724,92371,175,57,33,11,46
179991,2024-03-08 22:20:43,1356877857,2538,12,5,0,1,4
179957,2024-03-08 22:20:45,1356877863,92371,175,57,33,11,46
180327,2024-03-08 22:23:56,1356879383,22282,199,55,27,4,51
180328,2024-03-08 22:23:58,1356879406,0,38,59,37,0,59
180330,2024-03-08 22:25:31,1356879922,31318,261,21,7,5,16
180331,2024-03-08 22:25:34,1356879943,89139,79,42,22,5,37
180323,2024-03-08 22:38:46,1356884294,99450,354,63,29,12,51
180323,2024-03-08 22:39:07,1356884414,99450,354,63,29,12,51
180297,2024-03-08 22:39:10,1356884435,2774,24,5,3,1,4
180297,2024-03-08 22:40:07,1356884731,2774,24,5,3,1,4
180323,2024-03-08 22:40:28,1356884832,99450,354,63,29,12,51
180298,2024-03-08 22:43:18,1356887439,2127,55,25,17,2,23
180299,2024-03-08 22:45:10,1356889361,33004,22,22,5,5,17
180299,2024-03-08 22:47:31,1356891506,40649,32,26,6,6,20
180300,2024-03-08 22:49:07,1356893080,25026,86,18,11,6,12
180301,2024-03-08 22:51:24,1356895005,1494,31,12,10,2,10
180302,2024-03-08 22:53:55,1356896879,13905,85,15,10,2,13
180295,2024-03-09 05:07:06,1357055470,2683,57,104,87,3,101
180355,2024-03-09 05:15:24,1357057825,91883,336,169,119,3,166
180354,2024-03-09 05:15:28,1357057836,9366,220,93,71,4,89
180357,2024-03-09 05:19:43,1357058964,10663,170,84,67,4,80
180356,2024-03-09 05:22:25,1357059663,8115,46,63,29,7,56
180356,2024-03-09 05:23:08,1357059864,8115,46,63,29,7,56
180356,2024-03-09 05:23:28,1357059931,8115,46,63,29,7,56
180358,2024-03-09 05:38:11,1357063695,74217,211,108,70,7,101
180358,2024-03-09 05:38:49,1357063865,74217,211,108,70,7,101
161747,2024-03-09 14:53:37,1357138512,0,0,6,4,0,6
180350,2024-03-09 15:19:06,1357145716,90503,107,49,16,12,37
180363,2024-03-09 15:28:17,1357148301,44854,132,43,33,6,37
180353,2024-03-09 17:04:13,1357192059,47611,123,7,3,3,4
180345,2024-03-09 18:52:39,1357255204,20753,86,27,9,4,23
180304,2024-03-09 18:55:54,1357257079,137190,236,83,64,12,71
170055,2024-03-11 14:49:04,1357995449,10065,30,30,8,4,26
170060,2024-03-11 14:50:26,1357995984,28795,112,47,20,8,39
170053,2024-03-11 14:51:14,1357996265,6742,6,36,6,1,35
170135,2024-03-11 14:51:52,1357996481,5550,39,223,7,7,216
180389,2024-03-11 14:52:15,1357996663,10611,52,39,6,2,37
180388,2024-03-11 14:52:20,1357996691,8882,25,11,4,3,8
170057,2024-03-11 14:52:24,1357996713,37395,71,54,20,3,51
180387,2024-03-11 14:52:50,1357996888,16672,67,27,10,2,25
170052,2024-03-11 14:53:31,1357997161,18054,68,66,40,2,64
180385,2024-03-11 14:54:09,1357997394,8823,73,81,27,4,77
180381,2024-03-11 15:04:12,1358001332,63146,67,52,30,4,48
180382,2024-03-11 15:04:20,1358001368,220902,170,88,24,8,80
180383,2024-03-11 15:04:25,1358001402,17116,77,18,12,4,14
180383,2024-03-11 15:04:37,1358001489,17116,77,18,12,4,14
96657,2024-03-11 15:24:00,1358010787,18804,113,29,8,4,25
180380,2024-03-11 15:32:06,1358015412,100616,142,38,21,10,28
180380,2024-03-11 15:32:58,1358015901,100616,142,38,21,10,28
170135,2024-03-11 15:33:09,1358016015,5550,39,223,7,7,216
180386,2024-03-11 15:45:45,1358023406,0,4,37,8,0,37
169195,2024-03-11 15:45:45,1358023410,3354,25,18,11,1,17
180413,2024-03-11 16:08:13,1358038095,43597,160,40,7,2,38
180411,2024-03-11 16:08:17,1358038126,32386,78,16,13,4,12
180409,2024-03-11 16:08:19,1358038163,202361,85,35,26,6,29
180408,2024-03-11 16:08:21,1358038191,5199,38,8,3,3,5
180407,2024-03-11 16:08:23,1358038220,26751,41,22,16,6,16
180413,2024-03-11 16:09:49,1358039408,43597,160,40,7,2,38
180413,2024-03-11 16:09:57,1358039491,43597,160,40,7,2,38
180411,2024-03-11 16:09:57,1358039500,32386,78,16,13,4,12
180409,2024-03-11 16:10:00,1358039525,202361,85,35,26,6,29
180407,2024-03-11 16:10:05,1358039601,26751,41,22,16,6,16
180413,2024-03-11 16:10:38,1358040072,43597,160,40,7,2,38
180408,2024-03-11 16:10:47,1358040198,5199,38,8,3,3,5
180411,2024-03-11 16:11:09,1358040479,32386,78,16,13,4,12
180413,2024-03-11 16:12:24,1358041360,43597,160,40,7,2,38
180411,2024-03-11 16:12:27,1358041393,32386,78,16,13,4,12
180411,2024-03-11 16:12:34,1358041490,32386,78,16,13,4,12
180411,2024-03-11 16:12:56,1358041783,32386,78,16,13,4,12
180413,2024-03-11 16:12:58,1358041806,43597,160,40,7,2,38
180240,2024-03-11 16:41:31,1358063803,32911,131,32,21,2,30
180420,2024-03-11 18:03:47,1358133299,16578,22,5,0,2,3
180425,2024-03-11 18:04:26,1358133865,30392,61,25,18,4,21
180433,2024-03-11 18:04:36,1358133998,28606,118,12,2,5,7
180439,2024-03-11 18:04:49,1358134162,319826,461,155,51,25,130
180451,2024-03-11 18:04:58,1358134283,64932,463,61,40,11,50
180423,2024-03-11 18:11:49,1358140665,9837,87,33,23,1,32
180437,2024-03-11 18:12:00,1358140832,49660,165,78,34,6,72
180307,2024-03-11 18:22:43,1358151203,148242,97,35,23,4,31
180308,2024-03-11 18:22:50,1358151334,11211,21,17,3,3,14
180309,2024-03-11 18:23:00,1358151494,75790,126,38,22,8,30
180310,2024-03-11 18:23:09,1358151641,14349,92,32,15,4,28
180311,2024-03-11 18:23:18,1358151801,4608,52,13,10,2,11
180436,2024-03-11 18:44:34,1358171855,13772,127,22,13,5,17
180434,2024-03-11 18:46:05,1358173234,49656,68,22,22,4,18
180428,2024-03-11 18:47:09,1358174330,26268,60,66,44,4,62
180428,2024-03-11 18:47:35,1358174750,26268,60,66,44,4,62
180428,2024-03-11 18:48:07,1358175206,26268,60,66,44,4,62
180445,2024-03-11 18:48:50,1358175930,59824,156,55,42,7,48
180445,2024-03-11 18:49:00,1358176107,59824,156,55,42,7,48
180445,2024-03-11 18:49:31,1358176620,59824,156,55,42,7,48
180445,2024-03-11 18:50:15,1358177361,59824,156,55,42,7,48
180446,2024-03-11 18:51:39,1358178749,39451,171,79,63,8,71
180445,2024-03-11 18:51:48,1358178885,59824,156,55,42,7,48
180446,2024-03-11 18:52:17,1358179371,39451,171,79,63,8,71
180446,2024-03-11 18:52:22,1358179442,39451,171,79,63,8,71
180445,2024-03-11 18:52:26,1358179471,59824,156,55,42,7,48
180445,2024-03-11 18:53:23,1358180406,59824,156,55,42,7,48
180446,2024-03-11 18:53:24,1358180429,39451,171,79,63,8,71
180446,2024-03-11 18:55:21,1358182411,39451,171,79,63,8,71
180446,2024-03-11 18:55:42,1358182790,39451,171,79,63,8,71
180446,2024-03-11 18:56:17,1358183391,39451,171,79,63,8,71
180446,2024-03-11 18:56:41,1358183706,39451,171,79,63,8,71
180420,2024-03-11 19:35:11,1358218546,16578,22,5,0,2,3
163049,2024-03-11 19:36:42,1358219940,0,0,4,2,0,4
180487,2024-03-11 19:41:28,1358223958,100710,199,37,18,11,26
180501,2024-03-11 19:48:35,1358230293,93781,207,59,42,9,50
180509,2024-03-11 19:57:09,1358237691,50841,131,71,44,9,62
180511,2024-03-11 19:58:11,1358238636,8921,94,32,23,3,29
180489,2024-03-11 20:07:01,1358247149,162948,154,71,36,4,67
180490,2024-03-11 20:07:51,1358247876,77114,68,37,16,5,32
180491,2024-03-11 20:08:38,1358248520,58266,82,92,41,4,88
180489,2024-03-11 20:11:03,1358250528,162948,154,71,36,4,67
180489,2024-03-11 20:14:37,1358253699,162948,154,71,36,4,67
180489,2024-03-11 20:16:19,1358255262,162948,154,71,36,4,67
180491,2024-03-11 20:17:20,1358256206,58266,82,92,41,4,88
180522,2024-03-11 20:19:47,1358258442,37909,117,15,8,5,10
180523,2024-03-11 20:22:46,1358261056,24983,57,53,25,8,45
180492,2024-03-11 20:24:31,1358262504,43386,102,93,60,8,85
180493,2024-03-11 20:27:17,1358264846,41358,108,46,30,4,42
180534,2024-03-11 20:43:15,1358278139,15071,82,17,10,4,13
180534,2024-03-11 20:43:38,1358278452,15071,82,17,10,4,13
180485,2024-03-11 21:01:01,1358292943,7663,4,17,17,2,15
180500,2024-03-11 21:07:48,1358298624,52555,40,44,7,3,41
180528,2024-03-11 21:21:22,1358309880,9815,25,30,20,2,28
180515,2024-03-11 21:24:21,1358312385,23317,108,51,35,5,46
180521,2024-03-11 21:26:33,1358314147,11091,21,56,44,2,54
180520,2024-03-11 21:26:57,1358314494,31375,35,73,35,2,71
180520,2024-03-11 21:27:45,1358315193,31375,35,73,35,2,71
180372,2024-03-11 21:46:10,1358330098,37395,71,54,20,3,51
180553,2024-03-11 22:37:02,1358369604,94860,71,160,132,7,153
180554,2024-03-11 22:39:39,1358371595,49824,184,154,126,7,147
180568,2024-03-11 22:46:40,1358376746,91792,213,87,62,10,77
180557,2024-03-11 22:46:51,1358376866,192276,405,48,41,14,34
180570,2024-03-12 14:20:13,1358647752,15968,49,6,3,4,2
180571,2024-03-12 14:20:27,1358647804,9700,50,92,58,2,90
180559,2024-03-12 14:22:23,1358648341,7158,69,14,11,1,13
180560,2024-03-12 14:23:02,1358648539,0,8,68,38,0,68
180561,2024-03-12 14:23:19,1358648642,3980,25,86,41,1,85
180562,2024-03-12 14:23:42,1358648745,6379,166,38,24,2,36
180563,2024-03-12 14:24:11,1358648905,199,3,5,4,1,4
180562,2024-03-12 14:25:56,1358649325,6379,166,38,24,2,36
180562,2024-03-12 14:27:02,1358649670,6379,166,38,24,2,36
180581,2024-03-12 14:35:07,1358652183,0,0,8,0,0,8
180613,2024-03-12 14:48:03,1358656622,61816,75,47,31,5,42
169534,2024-03-12 15:28:22,1358675585,87062,249,56,18,9,47
169536,2024-03-12 15:28:43,1358675736,0,0,39,24,0,39
156718,2024-03-12 15:29:08,1358675994,15254,143,70,53,5,65
159837,2024-03-12 15:29:37,1358676259,22483,169,31,13,7,24
159830,2024-03-12 15:30:13,1358676634,21505,254,37,31,11,26
180598,2024-03-12 16:05:08,1358698900,0,1,2,2,0,2
180598,2024-03-12 16:08:23,1358701068,0,1,2,2,0,2
180379,2024-03-12 16:13:16,1358704572,101339,221,17,8,8,9
180637,2024-03-12 16:19:15,1358708957,47067,64,15,6,6,9
180657,2024-03-12 17:44:13,1358776996,0,0,23,18,0,23
180659,2024-03-12 17:44:22,1358777102,35107,93,40,12,8,32
180661,2024-03-12 17:44:34,1358777267,9421,75,40,8,6,34
180674,2024-03-12 17:49:25,1358781570,24649,40,3,1,1,2
180653,2024-03-12 17:56:22,1358787480,56698,32,71,32,1,70
180654,2024-03-12 17:56:51,1358787873,23428,105,55,30,4,51
180655,2024-03-12 17:57:02,1358788041,160604,52,89,59,3,86
180651,2024-03-12 18:05:08,1358795281,16471,116,35,26,3,32
180652,2024-03-12 18:08:02,1358797634,0,269,122,33,0,122
180651,2024-03-12 18:18:53,1358806668,16471,116,35,26,3,32
180687,2024-03-12 18:19:19,1358807010,0,0,32,26,0,32
180687,2024-03-12 18:19:36,1358807238,0,0,32,26,0,32
180687,2024-03-12 18:20:06,1358807657,0,0,32,26,0,32
180687,2024-03-12 18:20:07,1358807679,0,0,32,26,0,32
180700,2024-03-12 18:29:44,1358815526,63131,53,71,37,4,67
180699,2024-03-12 18:51:21,1358834180,11845,242,58,26,5,53
180698,2024-03-12 18:51:25,1358834232,35903,17,11,6,1,10
180697,2024-03-12 18:51:31,1358834313,663,2,127,25,1,126
180696,2024-03-12 18:51:36,1358834381,225546,305,87,23,6,81
180695,2024-03-12 18:51:42,1358834449,35903,19,18,7,1,17
112832,2024-03-12 19:11:15,1358851279,114003,102,108,24,7,101
112832,2024-03-12 19:11:26,1358851404,114003,102,108,24,7,101
112834,2024-03-12 19:11:46,1358851687,38208,95,41,9,16,25
112834,2024-03-12 19:11:51,1358851744,38208,95,41,9,16,25
112834,2024-03-12 19:11:53,1358851779,38208,95,41,9,16,25
112831,2024-03-12 19:13:06,1358852888,23503,51,62,15,2,60
112832,2024-03-12 19:13:39,1358853362,114003,102,108,24,7,101
180716,2024-03-12 19:38:52,1358875553,19451,104,51,27,4,47
180716,2024-03-12 19:39:09,1358875849,19451,104,51,27,4,47
180716,2024-03-12 19:39:41,1358876337,19451,104,51,27,4,47
180708,2024-03-12 19:41:51,1358878294,32181,142,57,29,5,52
180709,2024-03-12 19:41:59,1358878412,145620,131,124,69,15,109
180706,2024-03-12 19:50:05,1358886074,44713,44,114,86,2,112
180707,2024-03-12 19:50:10,1358886138,2033,173,38,1,1,37
180716,2024-03-12 19:50:37,1358886487,19451,104,51,27,4,47
180706,2024-03-12 19:53:33,1358888779,44713,44,114,86,2,112
180707,2024-03-12 19:53:35,1358888802,2033,173,38,1,1,37
180726,2024-03-12 20:03:35,1358896914,4116,50,15,10,4,11
180670,2024-03-12 20:03:49,1358897114,43636,101,21,13,9,12
180726,2024-03-12 20:06:47,1358899518,4116,50,15,10,4,11
180601,2024-03-12 20:14:14,1358905296,0,13,7,7,0,7
180601,2024-03-12 20:14:16,1358905311,0,13,7,7,0,7
180740,2024-03-12 20:21:26,1358911238,12235,43,26,13,6,20
180664,2024-03-12 20:22:14,1358911834,22468,46,15,2,4,11
180665,2024-03-12 20:22:30,1358912050,76742,163,32,23,8,24
180665,2024-03-12 20:24:10,1358913312,76742,163,32,23,8,24
180666,2024-03-12 20:29:05,1358917111,29877,67,23,8,9,14
180666,2024-03-12 20:29:28,1358917413,29877,67,23,8,9,14
180666,2024-03-12 20:30:21,1358918088,29877,67,23,8,9,14
180667,2024-03-12 20:30:54,1358918529,20994,50,4,0,4,0
180667,2024-03-12 20:31:12,1358918805,20994,50,4,0,4,0
180667,2024-03-12 20:32:39,1358919963,20994,50,4,0,4,0
180667,2024-03-12 20:33:18,1358920474,20994,50,4,0,4,0
35738,2024-03-12 20:35:25,1358922196,106686,201,91,34,7,84
180668,2024-03-12 20:35:49,1358922433,48471,91,22,7,7,15
180668,2024-03-12 20:35:51,1358922481,48471,91,22,7,7,15
180583,2024-03-12 20:35:52,1358922505,12940,9,19,10,1,18
180668,2024-03-12 20:35:56,1358922572,48471,91,22,7,7,15
180668,2024-03-12 20:37:12,1358923593,48471,91,22,7,7,15
180715,2024-03-12 20:40:13,1358925902,49763,60,14,8,3,11
180668,2024-03-12 20:42:58,1358927917,48471,91,22,7,7,15
180668,2024-03-12 20:43:01,1358927948,48471,91,22,7,7,15
180741,2024-03-12 20:45:44,1358930071,72012,236,75,52,11,64
170279,2024-03-12 20:57:51,1358939743,75790,130,38,22,8,30
170282,2024-03-12 21:01:12,1358942386,14349,92,32,15,4,28
170678,2024-03-12 21:03:27,1358944224,148242,97,35,23,4,31
180643,2024-03-12 21:11:14,1358950283,75251,78,44,35,3,41
180640,2024-03-12 21:11:26,1358950436,0,0,2,1,0,2
180639,2024-03-12 21:11:46,1358950667,71845,74,35,19,4,31
180636,2024-03-12 21:12:09,1358950951,61827,127,68,30,2,66
180636,2024-03-12 21:14:34,1358952908,61827,127,68,30,2,66
180754,2024-03-12 21:18:43,1358956359,212434,283,45,17,10,35
180754,2024-03-12 21:21:51,1358958861,212434,283,45,17,10,35
180585,2024-03-12 21:23:17,1358960001,27995,43,6,0,2,4
180585,2024-03-12 21:24:53,1358961170,27995,43,6,0,2,4
35738,2024-03-12 21:47:08,1358978435,106686,201,91,34,7,84
180735,2024-03-12 21:51:20,1358981819,0,25,47,2,0,47
180736,2024-03-12 21:51:28,1358981890,0,13,11,0,0,11
180737,2024-03-12 21:51:35,1358981995,0,0,2,0,0,2
180739,2024-03-12 21:51:52,1358982213,20697,147,70,20,3,67
180735,2024-03-12 21:53:14,1358983240,0,25,47,2,0,47
180738,2024-03-12 21:53:47,1358983614,26506,120,29,14,5,24
180739,2024-03-12 21:54:31,1358984161,20697,147,70,20,3,67
180584,2024-03-12 21:55:38,1358984972,7866,29,14,7,3,11
180587,2024-03-12 21:56:03,1358985320,11497,4,33,6,1,32
180589,2024-03-12 21:58:31,1358987107,16332,44,25,15,3,22
180588,2024-03-12 21:59:15,1358987671,4491,7,20,9,1,19
180678,2024-03-12 22:02:40,1358990281,12655,20,29,18,2,27
180679,2024-03-12 22:02:54,1358990483,828,74,23,14,2,21
180680,2024-03-12 22:03:06,1358990646,44715,40,50,36,2,48
180681,2024-03-12 22:03:23,1358990879,72179,342,68,43,4,64
180682,2024-03-12 22:03:31,1358990963,31080,117,26,23,3,23
180683,2024-03-12 22:04:23,1358991643,2216,13,37,20,4,33
180684,2024-03-12 22:04:27,1358991687,48522,72,74,33,3,71
180684,2024-03-12 22:04:28,1358991703,48522,72,74,33,3,71
180679,2024-03-12 22:07:08,1358993654,828,74,23,14,2,21
180682,2024-03-12 22:08:03,1358994306,31080,117,26,23,3,23
180683,2024-03-12 22:08:48,1358994825,2216,13,37,20,4,33
180684,2024-03-12 22:09:31,1358995374,48522,72,74,33,3,71
180682,2024-03-12 22:10:30,1358996085,31080,117,26,23,3,23
180682,2024-03-12 22:10:42,1358996265,31080,117,26,23,3,23
180680,2024-03-12 22:11:13,1358996691,44715,40,50,36,2,48
180681,2024-03-12 22:11:39,1358996984,72179,342,68,43,4,64
180681,2024-03-12 22:12:41,1358997720,72179,342,68,43,4,64
180681,2024-03-12 22:13:02,1358997936,72179,342,68,43,4,64
180681,2024-03-12 22:14:08,1358998762,72179,342,68,43,4,64
180681,2024-03-12 22:19:57,1359003125,72179,342,68,43,4,64
180775,2024-03-12 22:23:39,1359005715,0,0,37,28,0,37
180809,2024-03-13 14:35:14,1359316357,124394,78,55,31,4,51
123192,2024-03-13 14:57:33,1359330101,21623,105,126,42,16,110
123195,2024-03-13 15:14:51,1359341515,0,0,16,6,0,16
123198,2024-03-13 15:15:14,1359341786,4804,9,109,8,1,108
123195,2024-03-13 15:19:41,1359345124,0,0,16,6,0,16
180827,2024-03-13 15:20:16,1359345548,4398,27,97,68,2,95
180830,2024-03-13 15:22:05,1359346912,53661,132,82,38,7,75
180833,2024-03-13 15:25:01,1359349160,43078,192,31,9,8,23
180838,2024-03-13 15:27:52,1359351427,19214,41,14,8,4,10
180838,2024-03-13 15:29:02,1359352357,19214,41,14,8,4,10
180839,2024-03-13 15:30:52,1359353813,15205,3,41,31,2,39
180839,2024-03-13 15:32:42,1359355397,15205,3,41,31,2,39
171762,2024-03-13 15:34:38,1359356938,4674,123,14,3,6,8
171750,2024-03-13 15:36:52,1359358763,58854,74,48,34,5,43
171761,2024-03-13 15:37:31,1359359262,225388,93,79,56,7,72
171750,2024-03-13 15:39:54,1359361031,55599,52,39,29,4,35
171761,2024-03-13 15:40:13,1359361329,225388,93,79,56,7,72
171750,2024-03-13 15:44:52,1359365180,58854,74,48,34,5,43
180717,2024-03-13 16:18:46,1359395208,691,108,44,25,4,40
180829,2024-03-13 16:49:20,1359424645,37418,51,54,41,5,49
171751,2024-03-13 17:12:33,1359447859,35511,155,73,48,9,64
180861,2024-03-13 17:16:30,1359452019,274251,116,67,50,9,58
180875,2024-03-13 17:30:37,1359466630,189006,141,70,42,4,66
180881,2024-03-13 17:58:14,1359496019,74761,287,62,48,8,54
180882,2024-03-13 17:59:41,1359497605,171813,296,65,38,10,55
180883,2024-03-13 18:04:45,1359503083,0,0,1,0,0,1
180882,2024-03-13 18:04:50,1359503143,171813,296,65,38,10,55
180881,2024-03-13 18:08:35,1359506968,74761,289,62,48,8,54
180882,2024-03-13 18:08:44,1359507113,171813,296,65,38,10,55
180366,2024-03-13 18:17:05,1359515871,120958,103,35,20,11,24
180366,2024-03-13 18:17:33,1359516358,120958,103,35,20,11,24
180469,2024-03-13 18:49:18,1359548772,56044,200,122,45,11,111
180469,2024-03-13 18:50:37,1359550045,56044,200,122,45,11,111
180590,2024-03-13 18:57:40,1359557360,61148,381,49,27,12,37
180590,2024-03-13 19:00:39,1359560489,61148,381,49,27,12,37
180590,2024-03-13 19:11:58,1359572933,61148,381,49,27,12,37
180590,2024-03-13 19:12:05,1359573105,61148,381,49,27,12,37
169439,2024-03-13 19:15:48,1359575541,36545,90,96,54,5,91
169313,2024-03-13 19:18:31,1359577900,234028,106,128,80,9,119
169313,2024-03-13 19:23:44,1359582069,234028,106,128,80,9,119
180880,2024-03-13 19:24:02,1359582313,34032,61,18,11,3,15
180899,2024-03-13 19:24:36,1359582800,129001,186,81,60,8,73
180895,2024-03-13 19:25:14,1359583377,74740,283,82,47,14,68
180902,2024-03-13 19:40:32,1359595812,0,1,20,18,0,20
180902,2024-03-13 19:40:37,1359595876,0,1,20,18,0,20
180896,2024-03-13 19:43:32,1359598177,13455,120,83,63,4,79
180897,2024-03-13 19:45:19,1359599626,14746,45,19,13,2,17
180897,2024-03-13 19:45:31,1359599820,14746,45,19,13,2,17
180898,2024-03-13 19:45:39,1359599946,0,0,6,4,0,6
180898,2024-03-13 19:45:51,1359600115,0,0,6,4,0,6
180913,2024-03-13 19:47:09,1359601259,1668,40,8,3,1,7
180835,2024-03-13 19:48:51,1359602733,89182,393,63,39,11,52
180835,2024-03-13 19:48:53,1359602764,89182,393,63,39,11,52
180835,2024-03-13 19:52:28,1359605779,89182,393,63,39,11,52
180835,2024-03-13 19:52:40,1359605920,89182,393,63,39,11,52
180835,2024-03-13 19:54:05,1359607127,89182,393,63,39,11,52
180835,2024-03-13 19:54:15,1359607250,89182,393,63,39,11,52
21204,2024-03-13 19:59:16,1359611521,9289,22,115,13,3,112
21204,2024-03-13 20:00:38,1359612710,9289,22,115,13,3,112
180736,2024-03-13 20:09:51,1359620308,0,13,11,0,0,11
180819,2024-03-13 20:17:56,1359626795,198115,109,127,22,8,119
180823,2024-03-13 20:19:27,1359628112,113273,81,31,16,4,27
180586,2024-03-13 20:21:30,1359629767,292,293,384,25,1,383
180872,2024-03-13 20:37:50,1359643255,6769,25,33,23,6,27
180876,2024-03-13 20:37:58,1359643353,848682,733,138,82,32,106
180876,2024-03-13 20:43:02,1359647259,848682,733,138,82,32,106
180920,2024-03-13 20:48:35,1359651797,19773,131,34,7,8,26
180922,2024-03-13 20:48:42,1359651891,546,8,5,4,1,4
180854,2024-03-13 20:48:53,1359652042,28954,142,14,6,6,8
180854,2024-03-13 20:50:04,1359653122,28954,142,14,6,6,8
180854,2024-03-13 20:51:08,1359653971,28954,142,14,6,6,8
180854,2024-03-13 20:52:14,1359654774,28954,142,14,6,6,8
180933,2024-03-13 22:02:49,1359725759,42218,44,14,10,4,10
180936,2024-03-13 22:09:40,1359732688,63385,43,44,31,6,38
180936,2024-03-13 22:12:42,1359735608,63385,43,44,31,6,38
180936,2024-03-13 22:12:55,1359735826,63385,43,44,31,6,38
180930,2024-03-13 23:03:36,1359785634,5065,31,14,8,3,11
180616,2024-03-13 23:14:11,1359795208,13547,8,74,29,3,71
180617,2024-03-13 23:14:24,1359795372,55521,124,91,25,3,88
180619,2024-03-13 23:14:39,1359795597,107938,209,199,51,20,179
180620,2024-03-13 23:16:08,1359797047,39458,136,66,29,2,64
180620,2024-03-13 23:17:38,1359798443,39458,136,66,29,2,64
180621,2024-03-13 23:17:45,1359798557,29486,99,69,25,8,61
180618,2024-03-13 23:19:06,1359799861,190586,354,129,54,27,102
180621,2024-03-13 23:19:54,1359800626,29486,99,69,25,8,61
180618,2024-03-13 23:21:09,1359801750,190586,354,129,54,27,102
180618,2024-03-13 23:21:23,1359801982,190586,354,129,54,27,102
180672,2024-03-13 23:22:40,1359803180,1146,15,34,18,1,33
180788,2024-03-13 23:24:21,1359804682,19252,93,8,3,5,3
180790,2024-03-13 23:24:33,1359804851,12546,222,137,56,9,128
180788,2024-03-13 23:26:07,1359806336,19252,93,8,3,5,3
,,1324645055,55224,83,46,19,7,39
180790,2024-03-13 23:26:12,1359806412,12546,222,137,56,9,128
180789,2024-03-13 23:34:53,1359814707,0,6,10,7,0,10
180791,2024-03-13 23:34:59,1359814800,0,0,24,3,0,24
180000,2024-03-13 23:37:38,1359817296,21858,72,17,13,3,14
179998,2024-03-13 23:38:10,1359817830,84352,208,45,16,7,38
180001,2024-03-13 23:59:59,1359837878,29447,69,21,16,3,18
179992,2024-03-14 00:00:02,1359837929,15778,13,29,26,2,27
180001,2024-03-14 00:00:21,1359838275,29447,69,21,16,3,18
180001,2024-03-14 00:01:42,1359839599,29447,69,21,16,3,18
180001,2024-03-14 00:01:50,1359839698,29447,69,21,16,3,18
179992,2024-03-14 00:02:11,1359840031,15778,13,29,26,2,27
179992,2024-03-14 00:03:35,1359841281,15778,13,29,26,2,27
180953,2024-03-14 14:34:25,1360079306,32334,206,53,11,5,48
180953,2024-03-14 14:34:33,1360079348,32334,206,53,11,5,48
180943,2024-03-14 15:18:06,1360096267,51498,141,34,26,5,29
180944,2024-03-14 15:29:07,1360102053,30230,143,34,22,6,28
180945,2024-03-14 15:34:13,1360104901,7692,96,31,13,4,27
180946,2024-03-14 15:36:43,1360106186,21453,119,58,28,6,52
151738,2024-03-14 15:59:47,1360120315,240284,134,50,28,8,42
181013,2024-03-14 16:03:42,1360123116,7154,29,15,3,3,12
180983,2024-03-14 16:09:39,1360127103,17960,18,22,19,3,19
180960,2024-03-14 16:10:30,1360127699,220902,171,88,24,8,80
180953,2024-03-14 16:23:15,1360137367,32334,207,53,11,5,48
180954,2024-03-14 16:25:38,1360139156,100616,142,38,21,10,28
180960,2024-03-14 16:31:45,1360144863,220902,171,88,24,8,80
180999,2024-03-14 16:35:18,1360148352,90623,292,64,46,10,54
180869,2024-03-14 16:40:09,1360153118,83606,132,30,15,7,23
180816,2024-03-14 16:47:11,1360160013,41528,97,51,18,7,44
180849,2024-03-14 17:04:26,1360177457,14974,44,61,44,2,59
181011,2024-03-14 17:09:29,1360182381,0,0,1,0,0,1
181009,2024-03-14 17:10:03,1360182882,10425,41,30,19,2,28
181008,2024-03-14 17:10:38,1360183580,0,1,7,6,0,7
181007,2024-03-14 17:11:14,1360184133,0,25,13,3,0,13
181006,2024-03-14 17:11:49,1360184718,0,27,40,7,0,40
181005,2024-03-14 17:14:52,1360187825,2254,27,8,6,1,7
181058,2024-03-14 17:22:56,1360196540,21264,122,17,6,7,10
181014,2024-03-14 17:26:54,1360200796,2873,224,15,8,2,13
181050,2024-03-14 17:33:43,1360208127,0,0,2,0,0,2
180810,2024-03-14 17:36:52,1360211300,76821,88,20,12,10,10
181004,2024-03-14 17:37:05,1360211465,0,1,8,0,0,8
181003,2024-03-14 17:37:36,1360212030,1385,1,5,2,1,4
181001,2024-03-14 17:38:33,1360213027,2575,7,38,26,1,37
181000,2024-03-14 17:38:54,1360213409,0,0,1,0,0,1
180786,2024-03-14 17:55:29,1360230899,6499,21,14,11,3,11
181084,2024-03-14 18:11:03,1360247564,37734,64,169,16,3,166
181088,2024-03-14 18:22:28,1360259852,124892,150,115,66,7,108
181091,2024-03-14 18:41:07,1360280303,77914,100,52,36,6,46
181094,2024-03-14 18:50:06,1360290173,34043,124,46,24,9,37
181095,2024-03-14 18:51:36,1360291824,75638,139,58,41,6,52
180956,2024-03-14 18:57:14,1360297702,63163,68,52,30,4,48
180957,2024-03-14 18:57:38,1360298146,17116,77,18,12,4,14
180477,2024-03-14 19:27:38,1360330070,0,2,5,5,0,5
180502,2024-03-14 19:27:41,1360330106,124561,84,43,24,6,37
181115,2024-03-14 19:36:32,1360339567,21712,47,54,11,3,51
181117,2024-03-14 19:48:54,1360352778,1524,14,7,5,2,5
181117,2024-03-14 19:51:01,1360355002,1524,14,7,5,2,5
181124,2024-03-14 20:38:37,1360401804,14655,73,13,9,3,10
181087,2024-03-14 20:47:36,1360410557,27083,59,15,7,2,13
181018,2024-03-14 21:15:03,1360432031,69204,97,60,44,8,52
181096,2024-03-14 21:17:56,1360434041,0,0,4,2,0,4
181096,2024-03-14 21:20:12,1360435610,0,0,4,2,0,4
180958,2024-03-14 21:25:58,1360439594,10950,48,22,17,1,21
180962,2024-03-14 21:27:30,1360440697,0,0,8,7,0,8
180947,2024-03-14 21:30:31,1360442934,80556,197,43,17,18,25
169640,2024-03-14 21:37:45,1360448307,42817,65,113,68,6,107
181017,2024-03-14 21:38:43,1360448963,6089,12,32,15,3,29
181016,2024-03-14 21:38:45,1360448982,3202,35,34,27,3,31
181015,2024-03-14 21:38:46,1360449000,0,2,35,28,0,35
181017,2024-03-14 21:41:25,1360450928,6089,12,32,15,3,29
181044,2024-03-14 21:42:30,1360451744,6662,240,13,3,7,6
181063,2024-03-14 21:43:41,1360452570,4214,39,35,13,1,34
181017,2024-03-14 21:44:32,1360453119,6089,12,32,15,3,29
181044,2024-03-14 21:54:19,1360460233,6662,240,13,3,7,6
180658,2024-03-14 21:57:19,1360462296,2623,14,40,18,2,38
180660,2024-03-14 21:57:42,1360462533,137264,368,60,17,17,43
180662,2024-03-14 21:57:54,1360462637,57210,89,195,51,4,191
181029,2024-03-14 21:59:11,1360463524,24394,136,73,44,5,68
181031,2024-03-14 21:59:41,1360463890,23054,42,51,31,4,47
181109,2024-03-14 22:05:43,1360468105,32411,67,12,3,4,8
181108,2024-03-14 22:05:48,1360468165,1991,110,29,10,9,20
181107,2024-03-14 22:06:01,1360468300,0,0,3,1,0,3
181119,2024-03-14 22:13:03,1360472964,6642,26,15,11,7,8
181027,2024-03-14 22:35:12,1360492194,9586,12,4,1,2,2
181028,2024-03-14 22:35:17,1360492264,37,67,51,14,1,50
181030,2024-03-14 22:35:33,1360492525,823,38,16,6,1,15
181103,2024-03-14 22:35:44,1360492758,21951,131,6,0,5,1
181104,2024-03-14 22:35:51,1360492877,6792,137,20,8,2,18
181131,2024-03-14 22:36:16,1360493287,0,81,24,5,0,24
181132,2024-03-14 22:36:26,1360493446,12723,12,16,10,4,12
181133,2024-03-14 22:36:42,1360493678,37052,95,93,36,12,81
181134,2024-03-14 22:36:54,1360493886,52437,153,40,13,9,31
181135,2024-03-14 22:37:40,1360494622,15373,29,16,9,4,12
181161,2024-03-14 22:42:50,1360499487,1409,30,4,0,3,1
181161,2024-03-14 22:43:17,1360499960,1409,30,4,0,3,1
181162,2024-03-14 22:43:30,1360500163,29208,63,40,10,9,31
181163,2024-03-14 22:43:40,1360500299,25462,34,84,30,4,80
181164,2024-03-14 22:43:44,1360500386,72610,243,110,39,9,101
181060,2024-03-14 23:08:38,1360523464,29542,49,23,19,2,21
181056,2024-03-14 23:08:49,1360523661,96268,166,26,12,11,15
181053,2024-03-14 23:09:01,1360523851,104101,294,61,20,14,47
181043,2024-03-14 23:09:58,1360524714,227260,540,127,84,21,106
181133,2024-03-14 23:37:04,1360549581,37052,95,93,36,12,81
181169,2024-03-14 23:42:44,1360554803,313387,288,105,56,17,88
181165,2024-03-14 23:42:58,1360555049,133010,150,56,16,9,47
181190,2024-03-15 14:14:13,1360809514,51712,95,26,17,5,21
181176,2024-03-15 14:14:30,1360809587,34412,161,27,12,5,22
181175,2024-03-15 14:15:12,1360809763,42558,137,18,8,6,12
180904,2024-03-15 15:46:42,1360848454,36545,90,96,54,5,91
180906,2024-03-15 15:50:06,1360850700,0,0,1,0,0,1
180905,2024-03-15 15:52:24,1360852075,42817,65,113,68,6,107
180908,2024-03-15 15:54:24,1360853368,234028,106,128,80,9,119
181183,2024-03-15 17:24:36,1360957572,67168,87,22,13,7,15
181168,2024-03-15 17:53:06,1360998410,20753,89,27,9,4,23
180686,2024-03-15 17:53:13,1360998605,9128,6,6,1,1,5
181217,2024-03-15 18:04:46,1361016552,18915,25,11,5,1,10
180907,2024-03-15 18:20:52,1361035897,0,2,22,3,0,22
180909,2024-03-15 18:23:59,1361038288,0,0,1,0,0,1
181150,2024-03-15 18:33:19,1361045853,59072,192,55,20,11,44
181151,2024-03-15 18:33:39,1361046103,50038,293,66,23,19,47
181149,2024-03-15 18:35:23,1361047471,34389,149,76,40,8,68
181151,2024-03-15 18:35:30,1361047552,50038,293,66,23,19,47
181246,2024-03-15 18:40:12,1361051101,62943,74,21,14,3,18
181148,2024-03-15 18:43:53,1361053804,0,51,97,67,0,97
181152,2024-03-15 18:44:37,1361054392,159693,147,143,54,9,134
181153,2024-03-15 18:44:43,1361054453,80852,69,140,57,5,135
181153,2024-03-15 18:44:46,1361054488,80852,69,140,57,5,135
181148,2024-03-15 18:44:52,1361054554,0,51,97,67,0,97
181230,2024-03-15 19:08:50,1361073556,93746,216,64,45,10,54
181233,2024-03-15 19:18:55,1361081064,0,173,91,45,0,91
181234,2024-03-15 19:19:02,1361081152,4550,20,77,37,1,76
181235,2024-03-15 19:19:04,1361081183,13470,38,57,45,3,54
181236,2024-03-15 19:19:08,1361081240,36698,64,25,19,4,21
181237,2024-03-15 19:19:11,1361081283,0,20,33,24,0,33
181218,2024-03-15 19:19:54,1361081821,78396,148,134,66,7,127
181254,2024-03-15 19:41:58,1361098241,4384,58,51,13,1,50
181258,2024-03-15 19:53:41,1361107158,0,0,7,4,0,7
181260,2024-03-15 20:04:15,1361114993,15355,60,20,4,2,18
181264,2024-03-15 20:16:13,1361123693,56205,187,51,14,6,45
181263,2024-03-15 20:21:09,1361127538,4836,28,88,20,2,86
181268,2024-03-15 20:32:11,1361135508,52960,273,63,51,6,57
181267,2024-03-15 20:40:47,1361141903,0,1,51,0,0,51
181270,2024-03-15 20:50:22,1361148770,12927,30,66,9,4,62
181285,2024-03-15 20:51:03,1361149257,50905,191,34,21,6,28
181271,2024-03-15 20:51:40,1361149721,87517,83,35,5,5,30
181287,2024-03-15 20:54:28,1361151621,43732,281,25,3,7,18
181263,2024-03-15 21:09:08,1361161693,4836,28,88,20,2,86
181289,2024-03-15 21:20:27,1361169816,12911,138,13,4,2,11
181292,2024-03-15 21:22:53,1361171596,68072,170,54,32,12,42
181289,2024-03-15 21:23:01,1361171677,12911,138,13,4,2,11
181136,2024-03-15 21:23:33,1361172065,15047,121,8,3,4,4
181137,2024-03-15 21:25:02,1361173055,12243,102,53,37,2,51
181289,2024-03-15 21:25:30,1361173391,12911,138,13,4,2,11
181292,2024-03-15 21:27:43,1361174995,68072,170,54,32,12,42
181292,2024-03-15 21:35:03,1361180362,68072,170,54,32,12,42
181284,2024-03-15 21:37:14,1361181997,81881,111,36,19,6,30
181284,2024-03-15 21:38:00,1361182490,81881,111,36,19,6,30
181284,2024-03-15 21:38:26,1361182798,81881,111,36,19,6,30
181292,2024-03-15 21:39:44,1361183688,68072,170,54,32,12,42
181284,2024-03-15 21:41:36,1361184988,81881,111,36,19,6,30
181284,2024-03-15 21:41:57,1361185223,81881,111,36,19,6,30
181292,2024-03-15 21:44:55,1361187205,68072,170,54,32,12,42
181292,2024-03-15 21:53:22,1361193452,68072,170,54,32,12,42
180964,2024-03-15 21:53:50,1361193738,5471,53,52,37,6,46
180965,2024-03-15 21:55:29,1361194837,20295,216,64,38,2,62
180966,2024-03-15 21:55:34,1361194890,155108,171,108,82,11,97
180967,2024-03-15 21:55:39,1361194936,48905,126,49,44,5,44
180968,2024-03-15 21:55:43,1361194984,4977,7,18,14,2,16
181273,2024-03-15 21:55:47,1361195040,0,13,31,6,0,31
181274,2024-03-15 21:56:03,1361195264,68814,73,11,6,2,9
181275,2024-03-15 21:56:30,1361195560,76302,166,18,12,5,13
181276,2024-03-15 21:56:41,1361195644,10800,73,31,13,1,30
181277,2024-03-15 21:57:21,1361196133,74313,49,18,11,5,13
181289,2024-03-15 22:01:09,1361198830,12911,138,13,4,2,11
181263,2024-03-15 22:07:43,1361203349,4836,28,88,20,2,86
181326,2024-03-15 23:28:24,1361255794,0,6,16,10,0,16
181284,2024-03-15 23:28:29,1361255816,81881,111,36,19,6,30
154278,2024-03-15 23:33:24,1361258714,142895,103,85,38,11,74
154281,2024-03-15 23:33:44,1361258907,103992,133,27,17,8,19
155287,2024-03-15 23:34:22,1361259276,106901,273,84,31,16,68
154279,2024-03-15 23:34:53,1361259601,70035,33,36,15,2,34
172455,2024-03-15 23:35:19,1361259879,70783,92,110,53,6,104
181136,2024-03-15 23:37:40,1361261330,15047,121,8,3,4,4
181137,2024-03-15 23:37:53,1361261440,12243,102,53,37,2,51
181293,2024-03-16 14:40:59,1361509108,57209,293,67,49,12,55
181308,2024-03-16 14:41:01,1361509115,5926,30,44,28,2,42
181265,2024-03-16 14:43:53,1361509783,22910,32,55,48,2,53
181261,2024-03-16 14:47:21,1361510636,16305,30,36,31,2,34
181335,2024-03-16 14:48:56,1361510992,0,0,8,7,0,8
181338,2024-03-16 14:55:58,1361512617,16044,23,6,4,2,4
181337,2024-03-16 15:09:26,1361516329,10950,49,22,17,1,21
181336,2024-03-16 15:47:18,1361529360,0,0,5,5,0,5
181368,2024-03-16 17:18:07,1361570122,16653,44,61,38,4,57
181369,2024-03-16 17:38:56,1361581591,42440,74,23,17,3,20
170888,2024-03-16 17:53:11,1361589430,74465,50,18,11,5,13
170889,2024-03-16 17:54:29,1361590119,10800,73,31,13,1,30
181370,2024-03-16 17:59:05,1361592559,3061,152,36,26,2,34
181354,2024-03-16 18:00:50,1361593498,0,1,20,18,0,20
181356,2024-03-16 18:01:23,1361593775,14974,44,61,44,2,59
181357,2024-03-16 18:01:41,1361593920,90623,292,64,46,10,54
181358,2024-03-16 18:01:58,1361594022,4398,27,97,68,2,95
181373,2024-03-16 18:02:12,1361594203,37570,52,54,41,5,49
181374,2024-03-16 18:07:01,1361596941,7321,63,30,22,4,26
181376,2024-03-16 18:15:37,1361602144,0,29,33,11,0,33
181027,2024-03-16 18:39:07,1361617101,9586,12,4,1,2,2
181380,2024-03-16 18:39:12,1361617126,45123,60,34,26,2,32
181375,2024-03-16 18:46:04,1361621404,5872,249,55,30,2,53
181030,2024-03-16 18:47:59,1361622561,823,38,16,6,1,15
181378,2024-03-16 18:48:51,1361623140,40642,282,46,27,6,40
181105,2024-03-16 18:50:06,1361623921,49593,199,46,15,7,39
181106,2024-03-16 18:50:22,1361624097,73188,265,129,15,25,104
181110,2024-03-16 18:52:12,1361625244,48186,94,49,5,5,44
181111,2024-03-16 18:52:22,1361625359,29737,91,58,8,8,50
181112,2024-03-16 18:52:32,1361625455,20389,84,25,9,6,19
181160,2024-03-16 18:52:43,1361625598,118020,128,135,61,18,117
181379,2024-03-16 18:58:09,1361628795,45959,73,35,26,5,30
181383,2024-03-16 19:01:01,1361630436,0,186,31,17,0,31
